index,Date_reported,Country_code,Country,WHO_region,New_cases,Cumulative_cases,New_deaths,Cumulative_deaths
222,2020-02-25T00:00:00Z,DZ,Algeria,AFRO,1,1,0,0
223,2020-02-26T00:00:00Z,DZ,Algeria,AFRO,0,1,0,0
224,2020-02-27T00:00:00Z,DZ,Algeria,AFRO,0,1,0,0
225,2020-02-28T00:00:00Z,DZ,Algeria,AFRO,0,1,0,0
226,2020-02-29T00:00:00Z,DZ,Algeria,AFRO,0,1,0,0
227,2020-03-01T00:00:00Z,DZ,Algeria,AFRO,0,1,0,0
228,2020-03-02T00:00:00Z,DZ,Algeria,AFRO,2,3,0,0
229,2020-03-03T00:00:00Z,DZ,Algeria,AFRO,2,5,0,0
230,2020-03-04T00:00:00Z,DZ,Algeria,AFRO,7,12,0,0
231,2020-03-05T00:00:00Z,DZ,Algeria,AFRO,0,12,0,0
232,2020-03-06T00:00:00Z,DZ,Algeria,AFRO,5,17,0,0
233,2020-03-07T00:00:00Z,DZ,Algeria,AFRO,0,17,0,0
234,2020-03-08T00:00:00Z,DZ,Algeria,AFRO,0,17,0,0
235,2020-03-09T00:00:00Z,DZ,Algeria,AFRO,3,20,0,0
236,2020-03-10T00:00:00Z,DZ,Algeria,AFRO,0,20,0,0
237,2020-03-11T00:00:00Z,DZ,Algeria,AFRO,0,20,0,0
238,2020-03-12T00:00:00Z,DZ,Algeria,AFRO,5,25,1,1
239,2020-03-13T00:00:00Z,DZ,Algeria,AFRO,0,25,0,1
240,2020-03-14T00:00:00Z,DZ,Algeria,AFRO,12,37,1,2
241,2020-03-15T00:00:00Z,DZ,Algeria,AFRO,12,49,1,3
242,2020-03-16T00:00:00Z,DZ,Algeria,AFRO,0,49,1,4
243,2020-03-17T00:00:00Z,DZ,Algeria,AFRO,11,60,0,4
244,2020-03-18T00:00:00Z,DZ,Algeria,AFRO,12,72,2,6
245,2020-03-19T00:00:00Z,DZ,Algeria,AFRO,10,82,1,7
246,2020-03-20T00:00:00Z,DZ,Algeria,AFRO,12,94,3,10
247,2020-03-21T00:00:00Z,DZ,Algeria,AFRO,0,94,5,15
248,2020-03-22T00:00:00Z,DZ,Algeria,AFRO,45,139,0,15
249,2020-03-23T00:00:00Z,DZ,Algeria,AFRO,62,201,2,17
250,2020-03-24T00:00:00Z,DZ,Algeria,AFRO,30,231,0,17
251,2020-03-25T00:00:00Z,DZ,Algeria,AFRO,33,264,0,17
252,2020-03-26T00:00:00Z,DZ,Algeria,AFRO,0,264,0,17
253,2020-03-27T00:00:00Z,DZ,Algeria,AFRO,41,305,4,21
254,2020-03-28T00:00:00Z,DZ,Algeria,AFRO,62,367,4,25
255,2020-03-29T00:00:00Z,DZ,Algeria,AFRO,42,409,1,26
256,2020-03-30T00:00:00Z,DZ,Algeria,AFRO,45,454,3,29
257,2020-03-31T00:00:00Z,DZ,Algeria,AFRO,57,511,2,31
258,2020-04-01T00:00:00Z,DZ,Algeria,AFRO,73,584,4,35
259,2020-04-02T00:00:00Z,DZ,Algeria,AFRO,263,847,23,58
260,2020-04-03T00:00:00Z,DZ,Algeria,AFRO,139,986,25,83
261,2020-04-04T00:00:00Z,DZ,Algeria,AFRO,185,1171,22,105
262,2020-04-05T00:00:00Z,DZ,Algeria,AFRO,80,1251,25,130
263,2020-04-06T00:00:00Z,DZ,Algeria,AFRO,0,1251,0,130
264,2020-04-07T00:00:00Z,DZ,Algeria,AFRO,172,1423,43,173
265,2020-04-08T00:00:00Z,DZ,Algeria,AFRO,45,1468,21,194
266,2020-04-09T00:00:00Z,DZ,Algeria,AFRO,104,1572,11,205
267,2020-04-10T00:00:00Z,DZ,Algeria,AFRO,94,1666,30,235
268,2020-04-11T00:00:00Z,DZ,Algeria,AFRO,95,1761,21,256
269,2020-04-12T00:00:00Z,DZ,Algeria,AFRO,64,1825,19,275
270,2020-04-13T00:00:00Z,DZ,Algeria,AFRO,89,1914,18,293
271,2020-04-14T00:00:00Z,DZ,Algeria,AFRO,69,1983,20,313
272,2020-04-15T00:00:00Z,DZ,Algeria,AFRO,87,2070,13,326
273,2020-04-16T00:00:00Z,DZ,Algeria,AFRO,90,2160,10,336
274,2020-04-17T00:00:00Z,DZ,Algeria,AFRO,108,2268,12,348
275,2020-04-18T00:00:00Z,DZ,Algeria,AFRO,150,2418,16,364
276,2020-04-19T00:00:00Z,DZ,Algeria,AFRO,116,2534,3,367
277,2020-04-20T00:00:00Z,DZ,Algeria,AFRO,95,2629,8,375
278,2020-04-21T00:00:00Z,DZ,Algeria,AFRO,89,2718,9,384
279,2020-04-22T00:00:00Z,DZ,Algeria,AFRO,93,2811,8,392
280,2020-04-23T00:00:00Z,DZ,Algeria,AFRO,99,2910,10,402
281,2020-04-24T00:00:00Z,DZ,Algeria,AFRO,97,3007,5,407
282,2020-04-25T00:00:00Z,DZ,Algeria,AFRO,120,3127,8,415
283,2020-04-26T00:00:00Z,DZ,Algeria,AFRO,129,3256,4,419
284,2020-04-27T00:00:00Z,DZ,Algeria,AFRO,126,3382,6,425
285,2020-04-28T00:00:00Z,DZ,Algeria,AFRO,135,3517,7,432
286,2020-04-29T00:00:00Z,DZ,Algeria,AFRO,132,3649,5,437
287,2020-04-30T00:00:00Z,DZ,Algeria,AFRO,199,3848,7,444
288,2020-05-01T00:00:00Z,DZ,Algeria,AFRO,158,4006,6,450
289,2020-05-02T00:00:00Z,DZ,Algeria,AFRO,148,4154,3,453
290,2020-05-03T00:00:00Z,DZ,Algeria,AFRO,141,4295,6,459
291,2020-05-04T00:00:00Z,DZ,Algeria,AFRO,179,4474,4,463
292,2020-05-05T00:00:00Z,DZ,Algeria,AFRO,174,4648,2,465
293,2020-05-06T00:00:00Z,DZ,Algeria,AFRO,190,4838,5,470
294,2020-05-07T00:00:00Z,DZ,Algeria,AFRO,159,4997,6,476
295,2020-05-08T00:00:00Z,DZ,Algeria,AFRO,185,5182,7,483
296,2020-05-09T00:00:00Z,DZ,Algeria,AFRO,187,5369,5,488
297,2020-05-10T00:00:00Z,DZ,Algeria,AFRO,189,5558,6,494
298,2020-05-11T00:00:00Z,DZ,Algeria,AFRO,165,5723,8,502
299,2020-05-12T00:00:00Z,DZ,Algeria,AFRO,168,5891,5,507
300,2020-05-13T00:00:00Z,DZ,Algeria,AFRO,176,6067,8,515
301,2020-05-14T00:00:00Z,DZ,Algeria,AFRO,186,6253,7,522
302,2020-05-15T00:00:00Z,DZ,Algeria,AFRO,189,6442,7,529
303,2020-05-16T00:00:00Z,DZ,Algeria,AFRO,188,6630,7,536
304,2020-05-17T00:00:00Z,DZ,Algeria,AFRO,191,6821,6,542
305,2020-05-18T00:00:00Z,DZ,Algeria,AFRO,198,7019,6,548
306,2020-05-19T00:00:00Z,DZ,Algeria,AFRO,182,7201,7,555
307,2020-05-20T00:00:00Z,DZ,Algeria,AFRO,176,7377,6,561
308,2020-05-21T00:00:00Z,DZ,Algeria,AFRO,165,7542,7,568
309,2020-05-22T00:00:00Z,DZ,Algeria,AFRO,186,7728,7,575
310,2020-05-23T00:00:00Z,DZ,Algeria,AFRO,190,7918,7,582
311,2020-05-24T00:00:00Z,DZ,Algeria,AFRO,195,8113,10,592
312,2020-05-25T00:00:00Z,DZ,Algeria,AFRO,193,8306,8,600
313,2020-05-26T00:00:00Z,DZ,Algeria,AFRO,197,8503,9,609
314,2020-05-27T00:00:00Z,DZ,Algeria,AFRO,194,8697,8,617
315,2020-05-28T00:00:00Z,DZ,Algeria,AFRO,160,8857,6,623
316,2020-05-29T00:00:00Z,DZ,Algeria,AFRO,140,8997,7,630
317,2020-05-30T00:00:00Z,DZ,Algeria,AFRO,137,9134,8,638
318,2020-05-31T00:00:00Z,DZ,Algeria,AFRO,133,9267,8,646
319,2020-06-01T00:00:00Z,DZ,Algeria,AFRO,127,9394,7,653
320,2020-06-02T00:00:00Z,DZ,Algeria,AFRO,119,9513,8,661
321,2020-06-03T00:00:00Z,DZ,Algeria,AFRO,113,9626,6,667
322,2020-06-04T00:00:00Z,DZ,Algeria,AFRO,107,9733,6,673
323,2020-06-05T00:00:00Z,DZ,Algeria,AFRO,98,9831,8,681
324,2020-06-06T00:00:00Z,DZ,Algeria,AFRO,104,9935,9,690
325,2020-06-07T00:00:00Z,DZ,Algeria,AFRO,115,10050,8,698
326,2020-06-08T00:00:00Z,DZ,Algeria,AFRO,104,10154,9,707
327,2020-06-09T00:00:00Z,DZ,Algeria,AFRO,111,10265,8,715
328,2020-06-10T00:00:00Z,DZ,Algeria,AFRO,117,10382,9,724
329,2020-06-11T00:00:00Z,DZ,Algeria,AFRO,102,10484,8,732
330,2020-06-12T00:00:00Z,DZ,Algeria,AFRO,105,10589,9,741
331,2020-06-13T00:00:00Z,DZ,Algeria,AFRO,109,10698,10,751
332,2020-06-14T00:00:00Z,DZ,Algeria,AFRO,112,10810,9,760
333,2020-06-15T00:00:00Z,DZ,Algeria,AFRO,109,10919,7,767
334,2020-06-16T00:00:00Z,DZ,Algeria,AFRO,112,11031,10,777
335,2020-06-17T00:00:00Z,DZ,Algeria,AFRO,116,11147,11,788
336,2020-06-18T00:00:00Z,DZ,Algeria,AFRO,121,11268,11,799
337,2020-06-19T00:00:00Z,DZ,Algeria,AFRO,117,11385,12,811
338,2020-06-20T00:00:00Z,DZ,Algeria,AFRO,119,11504,14,825
450,2020-03-21T00:00:00Z,AO,Angola,AFRO,2,2,0,0
451,2020-03-22T00:00:00Z,AO,Angola,AFRO,0,2,0,0
452,2020-03-23T00:00:00Z,AO,Angola,AFRO,0,2,0,0
453,2020-03-24T00:00:00Z,AO,Angola,AFRO,0,2,0,0
454,2020-03-25T00:00:00Z,AO,Angola,AFRO,0,2,0,0
455,2020-03-26T00:00:00Z,AO,Angola,AFRO,0,2,0,0
456,2020-03-27T00:00:00Z,AO,Angola,AFRO,0,2,0,0
457,2020-03-28T00:00:00Z,AO,Angola,AFRO,0,2,0,0
458,2020-03-29T00:00:00Z,AO,Angola,AFRO,0,2,0,0
459,2020-03-30T00:00:00Z,AO,Angola,AFRO,0,2,0,0
460,2020-03-31T00:00:00Z,AO,Angola,AFRO,5,7,1,1
461,2020-04-01T00:00:00Z,AO,Angola,AFRO,0,7,1,2
462,2020-04-02T00:00:00Z,AO,Angola,AFRO,1,8,0,2
463,2020-04-03T00:00:00Z,AO,Angola,AFRO,0,8,0,2
464,2020-04-04T00:00:00Z,AO,Angola,AFRO,2,10,0,2
465,2020-04-05T00:00:00Z,AO,Angola,AFRO,0,10,0,2
466,2020-04-06T00:00:00Z,AO,Angola,AFRO,4,14,0,2
467,2020-04-07T00:00:00Z,AO,Angola,AFRO,2,16,0,2
468,2020-04-08T00:00:00Z,AO,Angola,AFRO,1,17,0,2
469,2020-04-09T00:00:00Z,AO,Angola,AFRO,2,19,0,2
470,2020-04-10T00:00:00Z,AO,Angola,AFRO,0,19,0,2
471,2020-04-11T00:00:00Z,AO,Angola,AFRO,0,19,0,2
472,2020-04-12T00:00:00Z,AO,Angola,AFRO,0,19,0,2
473,2020-04-13T00:00:00Z,AO,Angola,AFRO,0,19,0,2
474,2020-04-14T00:00:00Z,AO,Angola,AFRO,0,19,0,2
475,2020-04-15T00:00:00Z,AO,Angola,AFRO,0,19,0,2
476,2020-04-16T00:00:00Z,AO,Angola,AFRO,0,19,0,2
477,2020-04-17T00:00:00Z,AO,Angola,AFRO,0,19,0,2
478,2020-04-18T00:00:00Z,AO,Angola,AFRO,0,19,0,2
479,2020-04-19T00:00:00Z,AO,Angola,AFRO,0,19,0,2
480,2020-04-20T00:00:00Z,AO,Angola,AFRO,0,19,0,2
481,2020-04-21T00:00:00Z,AO,Angola,AFRO,5,24,0,2
482,2020-04-22T00:00:00Z,AO,Angola,AFRO,0,24,0,2
483,2020-04-23T00:00:00Z,AO,Angola,AFRO,0,24,0,2
484,2020-04-24T00:00:00Z,AO,Angola,AFRO,1,25,0,2
485,2020-04-25T00:00:00Z,AO,Angola,AFRO,0,25,0,2
486,2020-04-26T00:00:00Z,AO,Angola,AFRO,0,25,0,2
487,2020-04-27T00:00:00Z,AO,Angola,AFRO,1,26,0,2
488,2020-04-28T00:00:00Z,AO,Angola,AFRO,1,27,0,2
489,2020-04-29T00:00:00Z,AO,Angola,AFRO,0,27,0,2
490,2020-04-30T00:00:00Z,AO,Angola,AFRO,0,27,0,2
491,2020-05-01T00:00:00Z,AO,Angola,AFRO,0,27,0,2
492,2020-05-02T00:00:00Z,AO,Angola,AFRO,2,29,0,2
493,2020-05-03T00:00:00Z,AO,Angola,AFRO,6,35,0,2
494,2020-05-04T00:00:00Z,AO,Angola,AFRO,0,35,0,2
495,2020-05-05T00:00:00Z,AO,Angola,AFRO,0,35,0,2
496,2020-05-06T00:00:00Z,AO,Angola,AFRO,1,36,0,2
497,2020-05-07T00:00:00Z,AO,Angola,AFRO,0,36,0,2
498,2020-05-08T00:00:00Z,AO,Angola,AFRO,0,36,0,2
499,2020-05-09T00:00:00Z,AO,Angola,AFRO,0,36,0,2
500,2020-05-10T00:00:00Z,AO,Angola,AFRO,7,43,0,2
501,2020-05-11T00:00:00Z,AO,Angola,AFRO,2,45,0,2
502,2020-05-12T00:00:00Z,AO,Angola,AFRO,0,45,0,2
503,2020-05-13T00:00:00Z,AO,Angola,AFRO,0,45,0,2
504,2020-05-14T00:00:00Z,AO,Angola,AFRO,0,45,0,2
505,2020-05-15T00:00:00Z,AO,Angola,AFRO,3,48,0,2
506,2020-05-16T00:00:00Z,AO,Angola,AFRO,0,48,0,2
507,2020-05-17T00:00:00Z,AO,Angola,AFRO,0,48,0,2
508,2020-05-18T00:00:00Z,AO,Angola,AFRO,0,48,0,2
509,2020-05-19T00:00:00Z,AO,Angola,AFRO,2,50,0,2
510,2020-05-20T00:00:00Z,AO,Angola,AFRO,2,52,1,3
511,2020-05-21T00:00:00Z,AO,Angola,AFRO,6,58,0,3
512,2020-05-22T00:00:00Z,AO,Angola,AFRO,2,60,0,3
513,2020-05-23T00:00:00Z,AO,Angola,AFRO,0,60,0,3
514,2020-05-24T00:00:00Z,AO,Angola,AFRO,0,60,0,3
515,2020-05-25T00:00:00Z,AO,Angola,AFRO,9,69,1,4
516,2020-05-26T00:00:00Z,AO,Angola,AFRO,0,69,0,4
517,2020-05-27T00:00:00Z,AO,Angola,AFRO,2,71,0,4
518,2020-05-28T00:00:00Z,AO,Angola,AFRO,0,71,0,4
519,2020-05-29T00:00:00Z,AO,Angola,AFRO,2,73,0,4
520,2020-05-30T00:00:00Z,AO,Angola,AFRO,8,81,0,4
521,2020-05-31T00:00:00Z,AO,Angola,AFRO,3,84,0,4
522,2020-06-01T00:00:00Z,AO,Angola,AFRO,2,86,0,4
523,2020-06-02T00:00:00Z,AO,Angola,AFRO,0,86,0,4
524,2020-06-03T00:00:00Z,AO,Angola,AFRO,0,86,0,4
525,2020-06-04T00:00:00Z,AO,Angola,AFRO,0,86,0,4
526,2020-06-05T00:00:00Z,AO,Angola,AFRO,0,86,0,4
527,2020-06-06T00:00:00Z,AO,Angola,AFRO,0,86,0,4
528,2020-06-07T00:00:00Z,AO,Angola,AFRO,0,86,0,4
529,2020-06-08T00:00:00Z,AO,Angola,AFRO,5,91,0,4
530,2020-06-09T00:00:00Z,AO,Angola,AFRO,1,92,0,4
531,2020-06-10T00:00:00Z,AO,Angola,AFRO,4,96,0,4
532,2020-06-11T00:00:00Z,AO,Angola,AFRO,17,113,0,4
533,2020-06-12T00:00:00Z,AO,Angola,AFRO,5,118,1,5
534,2020-06-13T00:00:00Z,AO,Angola,AFRO,12,130,0,5
535,2020-06-14T00:00:00Z,AO,Angola,AFRO,8,138,1,6
536,2020-06-15T00:00:00Z,AO,Angola,AFRO,2,140,0,6
537,2020-06-16T00:00:00Z,AO,Angola,AFRO,2,142,0,6
538,2020-06-17T00:00:00Z,AO,Angola,AFRO,0,142,0,6
539,2020-06-18T00:00:00Z,AO,Angola,AFRO,13,155,1,7
540,2020-06-19T00:00:00Z,AO,Angola,AFRO,11,166,1,8
541,2020-06-20T00:00:00Z,AO,Angola,AFRO,0,166,0,8
2180,2020-03-17T00:00:00Z,BJ,Benin,AFRO,1,1,0,0
2181,2020-03-18T00:00:00Z,BJ,Benin,AFRO,0,1,0,0
2182,2020-03-19T00:00:00Z,BJ,Benin,AFRO,1,2,0,0
2183,2020-03-20T00:00:00Z,BJ,Benin,AFRO,0,2,0,0
2184,2020-03-21T00:00:00Z,BJ,Benin,AFRO,0,2,0,0
2185,2020-03-22T00:00:00Z,BJ,Benin,AFRO,0,2,0,0
2186,2020-03-23T00:00:00Z,BJ,Benin,AFRO,0,2,0,0
2187,2020-03-24T00:00:00Z,BJ,Benin,AFRO,3,5,0,0
2188,2020-03-25T00:00:00Z,BJ,Benin,AFRO,0,5,0,0
2189,2020-03-26T00:00:00Z,BJ,Benin,AFRO,1,6,0,0
2190,2020-03-27T00:00:00Z,BJ,Benin,AFRO,0,6,0,0
2191,2020-03-28T00:00:00Z,BJ,Benin,AFRO,0,6,0,0
2192,2020-03-29T00:00:00Z,BJ,Benin,AFRO,0,6,0,0
2193,2020-03-30T00:00:00Z,BJ,Benin,AFRO,0,6,0,0
2194,2020-03-31T00:00:00Z,BJ,Benin,AFRO,0,6,0,0
2195,2020-04-01T00:00:00Z,BJ,Benin,AFRO,3,9,0,0
2196,2020-04-02T00:00:00Z,BJ,Benin,AFRO,4,13,0,0
2197,2020-04-03T00:00:00Z,BJ,Benin,AFRO,0,13,0,0
2198,2020-04-04T00:00:00Z,BJ,Benin,AFRO,0,13,0,0
2199,2020-04-05T00:00:00Z,BJ,Benin,AFRO,0,13,0,0
2200,2020-04-06T00:00:00Z,BJ,Benin,AFRO,9,22,0,0
2201,2020-04-07T00:00:00Z,BJ,Benin,AFRO,1,23,1,1
2202,2020-04-08T00:00:00Z,BJ,Benin,AFRO,3,26,0,1
2203,2020-04-09T00:00:00Z,BJ,Benin,AFRO,0,26,0,1
2204,2020-04-10T00:00:00Z,BJ,Benin,AFRO,4,30,0,1
2205,2020-04-11T00:00:00Z,BJ,Benin,AFRO,0,30,0,1
2206,2020-04-12T00:00:00Z,BJ,Benin,AFRO,5,35,0,1
2207,2020-04-13T00:00:00Z,BJ,Benin,AFRO,0,35,0,1
2208,2020-04-14T00:00:00Z,BJ,Benin,AFRO,0,35,0,1
2209,2020-04-15T00:00:00Z,BJ,Benin,AFRO,0,35,0,1
2210,2020-04-16T00:00:00Z,BJ,Benin,AFRO,0,35,0,1
2211,2020-04-17T00:00:00Z,BJ,Benin,AFRO,2,37,0,1
2212,2020-04-18T00:00:00Z,BJ,Benin,AFRO,0,37,0,1
2213,2020-04-19T00:00:00Z,BJ,Benin,AFRO,0,37,0,1
2214,2020-04-20T00:00:00Z,BJ,Benin,AFRO,0,37,0,1
2215,2020-04-21T00:00:00Z,BJ,Benin,AFRO,17,54,0,1
2216,2020-04-22T00:00:00Z,BJ,Benin,AFRO,0,54,0,1
2217,2020-04-23T00:00:00Z,BJ,Benin,AFRO,0,54,0,1
2218,2020-04-24T00:00:00Z,BJ,Benin,AFRO,4,58,0,1
2219,2020-04-25T00:00:00Z,BJ,Benin,AFRO,0,58,0,1
2220,2020-04-26T00:00:00Z,BJ,Benin,AFRO,0,58,0,1
2221,2020-04-27T00:00:00Z,BJ,Benin,AFRO,6,64,0,1
2222,2020-04-28T00:00:00Z,BJ,Benin,AFRO,0,64,0,1
2223,2020-04-29T00:00:00Z,BJ,Benin,AFRO,0,64,0,1
2224,2020-04-30T00:00:00Z,BJ,Benin,AFRO,5,69,1,2
2225,2020-05-01T00:00:00Z,BJ,Benin,AFRO,15,84,0,2
2226,2020-05-02T00:00:00Z,BJ,Benin,AFRO,6,90,0,2
2227,2020-05-03T00:00:00Z,BJ,Benin,AFRO,0,90,0,2
2228,2020-05-04T00:00:00Z,BJ,Benin,AFRO,0,90,0,2
2229,2020-05-05T00:00:00Z,BJ,Benin,AFRO,6,96,0,2
2230,2020-05-06T00:00:00Z,BJ,Benin,AFRO,6,102,0,2
2231,2020-05-07T00:00:00Z,BJ,Benin,AFRO,0,102,0,2
2232,2020-05-08T00:00:00Z,BJ,Benin,AFRO,38,140,0,2
2233,2020-05-09T00:00:00Z,BJ,Benin,AFRO,102,242,0,2
2234,2020-05-10T00:00:00Z,BJ,Benin,AFRO,42,284,0,2
2235,2020-05-11T00:00:00Z,BJ,Benin,AFRO,35,319,0,2
2236,2020-05-12T00:00:00Z,BJ,Benin,AFRO,0,319,0,2
2237,2020-05-13T00:00:00Z,BJ,Benin,AFRO,8,327,0,2
2238,2020-05-14T00:00:00Z,BJ,Benin,AFRO,0,327,0,2
2239,2020-05-15T00:00:00Z,BJ,Benin,AFRO,12,339,0,2
2240,2020-05-16T00:00:00Z,BJ,Benin,AFRO,0,339,0,2
2241,2020-05-17T00:00:00Z,BJ,Benin,AFRO,0,339,0,2
2242,2020-05-18T00:00:00Z,BJ,Benin,AFRO,0,339,0,2
2243,2020-05-19T00:00:00Z,BJ,Benin,AFRO,-210,129,0,2
2244,2020-05-20T00:00:00Z,BJ,Benin,AFRO,1,130,0,2
2245,2020-05-21T00:00:00Z,BJ,Benin,AFRO,0,130,0,2
2246,2020-05-22T00:00:00Z,BJ,Benin,AFRO,5,135,1,3
2247,2020-05-23T00:00:00Z,BJ,Benin,AFRO,0,135,0,3
2248,2020-05-24T00:00:00Z,BJ,Benin,AFRO,0,135,0,3
2249,2020-05-25T00:00:00Z,BJ,Benin,AFRO,56,191,0,3
2250,2020-05-26T00:00:00Z,BJ,Benin,AFRO,0,191,0,3
2251,2020-05-27T00:00:00Z,BJ,Benin,AFRO,17,208,0,3
2252,2020-05-28T00:00:00Z,BJ,Benin,AFRO,2,210,0,3
2253,2020-05-29T00:00:00Z,BJ,Benin,AFRO,8,218,0,3
2254,2020-05-30T00:00:00Z,BJ,Benin,AFRO,0,218,0,3
2255,2020-05-31T00:00:00Z,BJ,Benin,AFRO,14,232,0,3
2256,2020-06-01T00:00:00Z,BJ,Benin,AFRO,0,232,0,3
2257,2020-06-02T00:00:00Z,BJ,Benin,AFRO,11,243,0,3
2258,2020-06-03T00:00:00Z,BJ,Benin,AFRO,1,244,0,3
2259,2020-06-04T00:00:00Z,BJ,Benin,AFRO,0,244,0,3
2260,2020-06-05T00:00:00Z,BJ,Benin,AFRO,17,261,0,3
2261,2020-06-06T00:00:00Z,BJ,Benin,AFRO,0,261,0,3
2262,2020-06-07T00:00:00Z,BJ,Benin,AFRO,7,268,1,4
2263,2020-06-08T00:00:00Z,BJ,Benin,AFRO,0,268,0,4
2264,2020-06-09T00:00:00Z,BJ,Benin,AFRO,37,305,0,4
2265,2020-06-10T00:00:00Z,BJ,Benin,AFRO,34,339,0,4
2266,2020-06-11T00:00:00Z,BJ,Benin,AFRO,0,339,0,4
2267,2020-06-12T00:00:00Z,BJ,Benin,AFRO,51,390,1,5
2268,2020-06-13T00:00:00Z,BJ,Benin,AFRO,22,412,1,6
2269,2020-06-14T00:00:00Z,BJ,Benin,AFRO,0,412,0,6
2270,2020-06-15T00:00:00Z,BJ,Benin,AFRO,58,470,1,7
2271,2020-06-16T00:00:00Z,BJ,Benin,AFRO,13,483,2,9
2272,2020-06-17T00:00:00Z,BJ,Benin,AFRO,49,532,0,9
2273,2020-06-18T00:00:00Z,BJ,Benin,AFRO,40,572,0,9
2274,2020-06-19T00:00:00Z,BJ,Benin,AFRO,25,597,2,11
2275,2020-06-20T00:00:00Z,BJ,Benin,AFRO,53,650,0,11
2766,2020-04-01T00:00:00Z,BW,Botswana,AFRO,3,3,0,0
2767,2020-04-02T00:00:00Z,BW,Botswana,AFRO,0,3,1,1
2768,2020-04-03T00:00:00Z,BW,Botswana,AFRO,1,4,0,1
2769,2020-04-04T00:00:00Z,BW,Botswana,AFRO,0,4,0,1
2770,2020-04-05T00:00:00Z,BW,Botswana,AFRO,0,4,0,1
2771,2020-04-06T00:00:00Z,BW,Botswana,AFRO,0,4,0,1
2772,2020-04-07T00:00:00Z,BW,Botswana,AFRO,2,6,0,1
2773,2020-04-08T00:00:00Z,BW,Botswana,AFRO,0,6,0,1
2774,2020-04-09T00:00:00Z,BW,Botswana,AFRO,0,6,0,1
2775,2020-04-10T00:00:00Z,BW,Botswana,AFRO,7,13,0,1
2776,2020-04-11T00:00:00Z,BW,Botswana,AFRO,0,13,0,1
2777,2020-04-12T00:00:00Z,BW,Botswana,AFRO,0,13,0,1
2778,2020-04-13T00:00:00Z,BW,Botswana,AFRO,0,13,0,1
2779,2020-04-14T00:00:00Z,BW,Botswana,AFRO,0,13,0,1
2780,2020-04-15T00:00:00Z,BW,Botswana,AFRO,0,13,0,1
2781,2020-04-16T00:00:00Z,BW,Botswana,AFRO,0,13,0,1
2782,2020-04-17T00:00:00Z,BW,Botswana,AFRO,2,15,0,1
2783,2020-04-18T00:00:00Z,BW,Botswana,AFRO,0,15,0,1
2784,2020-04-19T00:00:00Z,BW,Botswana,AFRO,0,15,0,1
2785,2020-04-20T00:00:00Z,BW,Botswana,AFRO,5,20,0,1
2786,2020-04-21T00:00:00Z,BW,Botswana,AFRO,0,20,0,1
2787,2020-04-22T00:00:00Z,BW,Botswana,AFRO,0,20,0,1
2788,2020-04-23T00:00:00Z,BW,Botswana,AFRO,2,22,0,1
2789,2020-04-24T00:00:00Z,BW,Botswana,AFRO,0,22,0,1
2790,2020-04-25T00:00:00Z,BW,Botswana,AFRO,0,22,0,1
2791,2020-04-26T00:00:00Z,BW,Botswana,AFRO,0,22,0,1
2792,2020-04-27T00:00:00Z,BW,Botswana,AFRO,0,22,0,1
2793,2020-04-28T00:00:00Z,BW,Botswana,AFRO,0,22,0,1
2794,2020-04-29T00:00:00Z,BW,Botswana,AFRO,1,23,0,1
2795,2020-04-30T00:00:00Z,BW,Botswana,AFRO,0,23,0,1
2796,2020-05-01T00:00:00Z,BW,Botswana,AFRO,0,23,0,1
2797,2020-05-02T00:00:00Z,BW,Botswana,AFRO,0,23,0,1
2798,2020-05-03T00:00:00Z,BW,Botswana,AFRO,0,23,0,1
2799,2020-05-04T00:00:00Z,BW,Botswana,AFRO,0,23,0,1
2800,2020-05-05T00:00:00Z,BW,Botswana,AFRO,0,23,0,1
2801,2020-05-06T00:00:00Z,BW,Botswana,AFRO,0,23,0,1
2802,2020-05-07T00:00:00Z,BW,Botswana,AFRO,0,23,0,1
2803,2020-05-08T00:00:00Z,BW,Botswana,AFRO,0,23,0,1
2804,2020-05-09T00:00:00Z,BW,Botswana,AFRO,0,23,0,1
2805,2020-05-10T00:00:00Z,BW,Botswana,AFRO,0,23,0,1
2806,2020-05-11T00:00:00Z,BW,Botswana,AFRO,0,23,0,1
2807,2020-05-12T00:00:00Z,BW,Botswana,AFRO,1,24,0,1
2808,2020-05-13T00:00:00Z,BW,Botswana,AFRO,0,24,0,1
2809,2020-05-14T00:00:00Z,BW,Botswana,AFRO,0,24,0,1
2810,2020-05-15T00:00:00Z,BW,Botswana,AFRO,0,24,0,1
2811,2020-05-16T00:00:00Z,BW,Botswana,AFRO,0,24,0,1
2812,2020-05-17T00:00:00Z,BW,Botswana,AFRO,1,25,0,1
2813,2020-05-18T00:00:00Z,BW,Botswana,AFRO,0,25,0,1
2814,2020-05-19T00:00:00Z,BW,Botswana,AFRO,0,25,0,1
2815,2020-05-20T00:00:00Z,BW,Botswana,AFRO,0,25,0,1
2816,2020-05-21T00:00:00Z,BW,Botswana,AFRO,0,25,0,1
2817,2020-05-22T00:00:00Z,BW,Botswana,AFRO,4,29,0,1
2818,2020-05-23T00:00:00Z,BW,Botswana,AFRO,0,29,0,1
2819,2020-05-24T00:00:00Z,BW,Botswana,AFRO,0,29,0,1
2820,2020-05-25T00:00:00Z,BW,Botswana,AFRO,6,35,0,1
2821,2020-05-26T00:00:00Z,BW,Botswana,AFRO,0,35,0,1
2822,2020-05-27T00:00:00Z,BW,Botswana,AFRO,0,35,0,1
2823,2020-05-28T00:00:00Z,BW,Botswana,AFRO,0,35,0,1
2824,2020-05-29T00:00:00Z,BW,Botswana,AFRO,0,35,0,1
2825,2020-05-30T00:00:00Z,BW,Botswana,AFRO,0,35,0,1
2826,2020-05-31T00:00:00Z,BW,Botswana,AFRO,0,35,0,1
2827,2020-06-01T00:00:00Z,BW,Botswana,AFRO,3,38,0,1
2828,2020-06-02T00:00:00Z,BW,Botswana,AFRO,0,38,0,1
2829,2020-06-03T00:00:00Z,BW,Botswana,AFRO,2,40,0,1
2830,2020-06-04T00:00:00Z,BW,Botswana,AFRO,0,40,0,1
2831,2020-06-05T00:00:00Z,BW,Botswana,AFRO,0,40,0,1
2832,2020-06-06T00:00:00Z,BW,Botswana,AFRO,0,40,0,1
2833,2020-06-07T00:00:00Z,BW,Botswana,AFRO,0,40,0,1
2834,2020-06-08T00:00:00Z,BW,Botswana,AFRO,0,40,0,1
2835,2020-06-09T00:00:00Z,BW,Botswana,AFRO,2,42,0,1
2836,2020-06-10T00:00:00Z,BW,Botswana,AFRO,0,42,0,1
2837,2020-06-11T00:00:00Z,BW,Botswana,AFRO,6,48,0,1
2838,2020-06-12T00:00:00Z,BW,Botswana,AFRO,0,48,0,1
2839,2020-06-13T00:00:00Z,BW,Botswana,AFRO,12,60,0,1
2840,2020-06-14T00:00:00Z,BW,Botswana,AFRO,0,60,0,1
2841,2020-06-15T00:00:00Z,BW,Botswana,AFRO,0,60,0,1
2842,2020-06-16T00:00:00Z,BW,Botswana,AFRO,0,60,0,1
2843,2020-06-17T00:00:00Z,BW,Botswana,AFRO,0,60,0,1
2844,2020-06-18T00:00:00Z,BW,Botswana,AFRO,19,79,0,1
2845,2020-06-19T00:00:00Z,BW,Botswana,AFRO,0,79,0,1
2846,2020-06-20T00:00:00Z,BW,Botswana,AFRO,10,89,0,1
3258,2020-03-11T00:00:00Z,BF,Burkina Faso,AFRO,2,2,0,0
3259,2020-03-12T00:00:00Z,BF,Burkina Faso,AFRO,0,2,0,0
3260,2020-03-13T00:00:00Z,BF,Burkina Faso,AFRO,0,2,0,0
3261,2020-03-14T00:00:00Z,BF,Burkina Faso,AFRO,1,3,0,0
3262,2020-03-15T00:00:00Z,BF,Burkina Faso,AFRO,0,3,0,0
3263,2020-03-16T00:00:00Z,BF,Burkina Faso,AFRO,12,15,0,0
3264,2020-03-17T00:00:00Z,BF,Burkina Faso,AFRO,5,20,0,0
3265,2020-03-18T00:00:00Z,BF,Burkina Faso,AFRO,6,26,1,1
3266,2020-03-19T00:00:00Z,BF,Burkina Faso,AFRO,14,40,0,1
3267,2020-03-20T00:00:00Z,BF,Burkina Faso,AFRO,0,40,0,1
3268,2020-03-21T00:00:00Z,BF,Burkina Faso,AFRO,32,72,2,3
3269,2020-03-22T00:00:00Z,BF,Burkina Faso,AFRO,3,75,0,3
3270,2020-03-23T00:00:00Z,BF,Burkina Faso,AFRO,0,75,0,3
3271,2020-03-24T00:00:00Z,BF,Burkina Faso,AFRO,24,99,0,3
3272,2020-03-25T00:00:00Z,BF,Burkina Faso,AFRO,15,114,0,3
3273,2020-03-26T00:00:00Z,BF,Burkina Faso,AFRO,32,146,0,3
3274,2020-03-27T00:00:00Z,BF,Burkina Faso,AFRO,0,146,0,3
3275,2020-03-28T00:00:00Z,BF,Burkina Faso,AFRO,0,146,0,3
3276,2020-03-29T00:00:00Z,BF,Burkina Faso,AFRO,0,146,0,3
3277,2020-03-30T00:00:00Z,BF,Burkina Faso,AFRO,76,222,9,12
3278,2020-03-31T00:00:00Z,BF,Burkina Faso,AFRO,24,246,0,12
3279,2020-04-01T00:00:00Z,BF,Burkina Faso,AFRO,15,261,2,14
3280,2020-04-02T00:00:00Z,BF,Burkina Faso,AFRO,0,261,0,14
3281,2020-04-03T00:00:00Z,BF,Burkina Faso,AFRO,0,261,1,15
3282,2020-04-04T00:00:00Z,BF,Burkina Faso,AFRO,41,302,0,15
3283,2020-04-05T00:00:00Z,BF,Burkina Faso,AFRO,0,302,0,15
3284,2020-04-06T00:00:00Z,BF,Burkina Faso,AFRO,43,345,2,17
3285,2020-04-07T00:00:00Z,BF,Burkina Faso,AFRO,0,345,0,17
3286,2020-04-08T00:00:00Z,BF,Burkina Faso,AFRO,39,384,1,18
3287,2020-04-09T00:00:00Z,BF,Burkina Faso,AFRO,0,384,1,19
3288,2020-04-10T00:00:00Z,BF,Burkina Faso,AFRO,30,414,0,19
3289,2020-04-11T00:00:00Z,BF,Burkina Faso,AFRO,29,443,0,19
3290,2020-04-12T00:00:00Z,BF,Burkina Faso,AFRO,0,443,0,19
3291,2020-04-13T00:00:00Z,BF,Burkina Faso,AFRO,0,443,0,19
3292,2020-04-14T00:00:00Z,BF,Burkina Faso,AFRO,54,497,8,27
3293,2020-04-15T00:00:00Z,BF,Burkina Faso,AFRO,18,515,1,28
3294,2020-04-16T00:00:00Z,BF,Burkina Faso,AFRO,13,528,0,28
3295,2020-04-17T00:00:00Z,BF,Burkina Faso,AFRO,15,543,4,32
3296,2020-04-18T00:00:00Z,BF,Burkina Faso,AFRO,4,547,0,32
3297,2020-04-19T00:00:00Z,BF,Burkina Faso,AFRO,0,547,0,32
3298,2020-04-20T00:00:00Z,BF,Burkina Faso,AFRO,18,565,4,36
3299,2020-04-21T00:00:00Z,BF,Burkina Faso,AFRO,11,576,0,36
3300,2020-04-22T00:00:00Z,BF,Burkina Faso,AFRO,5,581,2,38
3301,2020-04-23T00:00:00Z,BF,Burkina Faso,AFRO,19,600,0,38
3302,2020-04-24T00:00:00Z,BF,Burkina Faso,AFRO,0,600,0,38
3303,2020-04-25T00:00:00Z,BF,Burkina Faso,AFRO,16,616,3,41
3304,2020-04-26T00:00:00Z,BF,Burkina Faso,AFRO,13,629,0,41
3305,2020-04-27T00:00:00Z,BF,Burkina Faso,AFRO,3,632,1,42
3306,2020-04-28T00:00:00Z,BF,Burkina Faso,AFRO,0,632,0,42
3307,2020-04-29T00:00:00Z,BF,Burkina Faso,AFRO,6,638,0,42
3308,2020-04-30T00:00:00Z,BF,Burkina Faso,AFRO,0,638,0,42
3309,2020-05-01T00:00:00Z,BF,Burkina Faso,AFRO,7,645,1,43
3310,2020-05-02T00:00:00Z,BF,Burkina Faso,AFRO,4,649,1,44
3311,2020-05-03T00:00:00Z,BF,Burkina Faso,AFRO,3,652,0,44
3312,2020-05-04T00:00:00Z,BF,Burkina Faso,AFRO,10,662,1,45
3313,2020-05-05T00:00:00Z,BF,Burkina Faso,AFRO,10,672,1,46
3314,2020-05-06T00:00:00Z,BF,Burkina Faso,AFRO,17,689,2,48
3315,2020-05-07T00:00:00Z,BF,Burkina Faso,AFRO,40,729,0,48
3316,2020-05-08T00:00:00Z,BF,Burkina Faso,AFRO,7,736,0,48
3317,2020-05-09T00:00:00Z,BF,Burkina Faso,AFRO,0,736,0,48
3318,2020-05-10T00:00:00Z,BF,Burkina Faso,AFRO,12,748,0,48
3319,2020-05-11T00:00:00Z,BF,Burkina Faso,AFRO,3,751,1,49
3320,2020-05-12T00:00:00Z,BF,Burkina Faso,AFRO,9,760,1,50
3321,2020-05-13T00:00:00Z,BF,Burkina Faso,AFRO,6,766,1,51
3322,2020-05-14T00:00:00Z,BF,Burkina Faso,AFRO,7,773,0,51
3323,2020-05-15T00:00:00Z,BF,Burkina Faso,AFRO,0,773,0,51
3324,2020-05-16T00:00:00Z,BF,Burkina Faso,AFRO,7,780,0,51
3325,2020-05-17T00:00:00Z,BF,Burkina Faso,AFRO,2,782,0,51
3326,2020-05-18T00:00:00Z,BF,Burkina Faso,AFRO,14,796,0,51
3327,2020-05-19T00:00:00Z,BF,Burkina Faso,AFRO,0,796,0,51
3328,2020-05-20T00:00:00Z,BF,Burkina Faso,AFRO,10,806,1,52
3329,2020-05-21T00:00:00Z,BF,Burkina Faso,AFRO,3,809,0,52
3330,2020-05-22T00:00:00Z,BF,Burkina Faso,AFRO,3,812,0,52
3331,2020-05-23T00:00:00Z,BF,Burkina Faso,AFRO,2,814,0,52
3332,2020-05-24T00:00:00Z,BF,Burkina Faso,AFRO,17,831,0,52
3333,2020-05-25T00:00:00Z,BF,Burkina Faso,AFRO,1,832,0,52
3334,2020-05-26T00:00:00Z,BF,Burkina Faso,AFRO,9,841,0,52
3335,2020-05-27T00:00:00Z,BF,Burkina Faso,AFRO,4,845,1,53
3336,2020-05-28T00:00:00Z,BF,Burkina Faso,AFRO,0,845,0,53
3337,2020-05-29T00:00:00Z,BF,Burkina Faso,AFRO,2,847,0,53
3338,2020-05-30T00:00:00Z,BF,Burkina Faso,AFRO,0,847,0,53
3339,2020-05-31T00:00:00Z,BF,Burkina Faso,AFRO,6,853,0,53
3340,2020-06-01T00:00:00Z,BF,Burkina Faso,AFRO,28,881,0,53
3341,2020-06-02T00:00:00Z,BF,Burkina Faso,AFRO,2,883,0,53
3342,2020-06-03T00:00:00Z,BF,Burkina Faso,AFRO,1,884,0,53
3343,2020-06-04T00:00:00Z,BF,Burkina Faso,AFRO,0,884,0,53
3344,2020-06-05T00:00:00Z,BF,Burkina Faso,AFRO,1,885,0,53
3345,2020-06-06T00:00:00Z,BF,Burkina Faso,AFRO,0,885,0,53
3346,2020-06-07T00:00:00Z,BF,Burkina Faso,AFRO,3,888,0,53
3347,2020-06-08T00:00:00Z,BF,Burkina Faso,AFRO,0,888,0,53
3348,2020-06-09T00:00:00Z,BF,Burkina Faso,AFRO,2,890,0,53
3349,2020-06-10T00:00:00Z,BF,Burkina Faso,AFRO,1,891,0,53
3350,2020-06-11T00:00:00Z,BF,Burkina Faso,AFRO,0,891,0,53
3351,2020-06-12T00:00:00Z,BF,Burkina Faso,AFRO,0,891,0,53
3352,2020-06-13T00:00:00Z,BF,Burkina Faso,AFRO,1,892,0,53
3353,2020-06-14T00:00:00Z,BF,Burkina Faso,AFRO,0,892,0,53
3354,2020-06-15T00:00:00Z,BF,Burkina Faso,AFRO,2,894,0,53
3355,2020-06-16T00:00:00Z,BF,Burkina Faso,AFRO,0,894,0,53
3356,2020-06-17T00:00:00Z,BF,Burkina Faso,AFRO,1,895,0,53
3357,2020-06-18T00:00:00Z,BF,Burkina Faso,AFRO,4,899,0,53
3358,2020-06-19T00:00:00Z,BF,Burkina Faso,AFRO,0,899,0,53
3359,2020-06-20T00:00:00Z,BF,Burkina Faso,AFRO,2,901,0,53
3360,2020-04-01T00:00:00Z,BI,Burundi,AFRO,2,2,0,0
3361,2020-04-02T00:00:00Z,BI,Burundi,AFRO,0,2,0,0
3362,2020-04-03T00:00:00Z,BI,Burundi,AFRO,1,3,0,0
3363,2020-04-04T00:00:00Z,BI,Burundi,AFRO,0,3,0,0
3364,2020-04-05T00:00:00Z,BI,Burundi,AFRO,0,3,0,0
3365,2020-04-06T00:00:00Z,BI,Burundi,AFRO,0,3,0,0
3366,2020-04-07T00:00:00Z,BI,Burundi,AFRO,0,3,0,0
3367,2020-04-08T00:00:00Z,BI,Burundi,AFRO,0,3,0,0
3368,2020-04-09T00:00:00Z,BI,Burundi,AFRO,0,3,0,0
3369,2020-04-10T00:00:00Z,BI,Burundi,AFRO,0,3,0,0
3370,2020-04-11T00:00:00Z,BI,Burundi,AFRO,0,3,0,0
3371,2020-04-12T00:00:00Z,BI,Burundi,AFRO,0,3,0,0
3372,2020-04-13T00:00:00Z,BI,Burundi,AFRO,2,5,0,0
3373,2020-04-14T00:00:00Z,BI,Burundi,AFRO,0,5,0,0
3374,2020-04-15T00:00:00Z,BI,Burundi,AFRO,0,5,0,0
3375,2020-04-16T00:00:00Z,BI,Burundi,AFRO,0,5,0,0
3376,2020-04-17T00:00:00Z,BI,Burundi,AFRO,0,5,0,0
3377,2020-04-18T00:00:00Z,BI,Burundi,AFRO,0,5,0,0
3378,2020-04-19T00:00:00Z,BI,Burundi,AFRO,0,5,0,0
3379,2020-04-20T00:00:00Z,BI,Burundi,AFRO,1,6,1,1
3380,2020-04-21T00:00:00Z,BI,Burundi,AFRO,0,6,0,1
3381,2020-04-22T00:00:00Z,BI,Burundi,AFRO,5,11,0,1
3382,2020-04-23T00:00:00Z,BI,Burundi,AFRO,0,11,0,1
3383,2020-04-24T00:00:00Z,BI,Burundi,AFRO,0,11,0,1
3384,2020-04-25T00:00:00Z,BI,Burundi,AFRO,1,12,0,1
3385,2020-04-26T00:00:00Z,BI,Burundi,AFRO,0,12,0,1
3386,2020-04-27T00:00:00Z,BI,Burundi,AFRO,3,15,0,1
3387,2020-04-28T00:00:00Z,BI,Burundi,AFRO,0,15,0,1
3388,2020-04-29T00:00:00Z,BI,Burundi,AFRO,0,15,0,1
3389,2020-04-30T00:00:00Z,BI,Burundi,AFRO,0,15,0,1
3390,2020-05-01T00:00:00Z,BI,Burundi,AFRO,0,15,0,1
3391,2020-05-02T00:00:00Z,BI,Burundi,AFRO,0,15,0,1
3392,2020-05-03T00:00:00Z,BI,Burundi,AFRO,4,19,0,1
3393,2020-05-04T00:00:00Z,BI,Burundi,AFRO,0,19,0,1
3394,2020-05-05T00:00:00Z,BI,Burundi,AFRO,0,19,0,1
3395,2020-05-06T00:00:00Z,BI,Burundi,AFRO,0,19,0,1
3396,2020-05-07T00:00:00Z,BI,Burundi,AFRO,0,19,0,1
3397,2020-05-08T00:00:00Z,BI,Burundi,AFRO,0,19,0,1
3398,2020-05-09T00:00:00Z,BI,Burundi,AFRO,0,19,0,1
3399,2020-05-10T00:00:00Z,BI,Burundi,AFRO,0,19,0,1
3400,2020-05-11T00:00:00Z,BI,Burundi,AFRO,0,19,0,1
3401,2020-05-12T00:00:00Z,BI,Burundi,AFRO,0,19,0,1
3402,2020-05-13T00:00:00Z,BI,Burundi,AFRO,8,27,0,1
3403,2020-05-14T00:00:00Z,BI,Burundi,AFRO,0,27,0,1
3404,2020-05-15T00:00:00Z,BI,Burundi,AFRO,0,27,0,1
3405,2020-05-16T00:00:00Z,BI,Burundi,AFRO,0,27,0,1
3406,2020-05-17T00:00:00Z,BI,Burundi,AFRO,0,27,0,1
3407,2020-05-18T00:00:00Z,BI,Burundi,AFRO,15,42,0,1
3408,2020-05-19T00:00:00Z,BI,Burundi,AFRO,0,42,0,1
3409,2020-05-20T00:00:00Z,BI,Burundi,AFRO,0,42,0,1
3410,2020-05-21T00:00:00Z,BI,Burundi,AFRO,0,42,0,1
3411,2020-05-22T00:00:00Z,BI,Burundi,AFRO,0,42,0,1
3412,2020-05-23T00:00:00Z,BI,Burundi,AFRO,0,42,0,1
3413,2020-05-24T00:00:00Z,BI,Burundi,AFRO,0,42,0,1
3414,2020-05-25T00:00:00Z,BI,Burundi,AFRO,0,42,0,1
3415,2020-05-26T00:00:00Z,BI,Burundi,AFRO,0,42,0,1
3416,2020-05-27T00:00:00Z,BI,Burundi,AFRO,0,42,0,1
3417,2020-05-28T00:00:00Z,BI,Burundi,AFRO,0,42,0,1
3418,2020-05-29T00:00:00Z,BI,Burundi,AFRO,0,42,0,1
3419,2020-05-30T00:00:00Z,BI,Burundi,AFRO,0,42,0,1
3420,2020-05-31T00:00:00Z,BI,Burundi,AFRO,0,42,0,1
3421,2020-06-01T00:00:00Z,BI,Burundi,AFRO,21,63,0,1
3422,2020-06-02T00:00:00Z,BI,Burundi,AFRO,0,63,0,1
3423,2020-06-03T00:00:00Z,BI,Burundi,AFRO,0,63,0,1
3424,2020-06-04T00:00:00Z,BI,Burundi,AFRO,0,63,0,1
3425,2020-06-05T00:00:00Z,BI,Burundi,AFRO,0,63,0,1
3426,2020-06-06T00:00:00Z,BI,Burundi,AFRO,0,63,0,1
3427,2020-06-07T00:00:00Z,BI,Burundi,AFRO,20,83,0,1
3428,2020-06-08T00:00:00Z,BI,Burundi,AFRO,0,83,0,1
3429,2020-06-09T00:00:00Z,BI,Burundi,AFRO,0,83,0,1
3430,2020-06-10T00:00:00Z,BI,Burundi,AFRO,0,83,0,1
3431,2020-06-11T00:00:00Z,BI,Burundi,AFRO,0,83,0,1
3432,2020-06-12T00:00:00Z,BI,Burundi,AFRO,11,94,0,1
3433,2020-06-13T00:00:00Z,BI,Burundi,AFRO,0,94,0,1
3434,2020-06-14T00:00:00Z,BI,Burundi,AFRO,0,94,0,1
3435,2020-06-15T00:00:00Z,BI,Burundi,AFRO,0,94,0,1
3436,2020-06-16T00:00:00Z,BI,Burundi,AFRO,10,104,0,1
3437,2020-06-17T00:00:00Z,BI,Burundi,AFRO,0,104,0,1
3438,2020-06-18T00:00:00Z,BI,Burundi,AFRO,0,104,0,1
3439,2020-06-19T00:00:00Z,BI,Burundi,AFRO,0,104,0,1
3440,2020-06-20T00:00:00Z,BI,Burundi,AFRO,0,104,0,1
3441,2020-03-20T00:00:00Z,CV,Cabo Verde,AFRO,1,1,0,0
3442,2020-03-21T00:00:00Z,CV,Cabo Verde,AFRO,2,3,0,0
3443,2020-03-22T00:00:00Z,CV,Cabo Verde,AFRO,0,3,0,0
3444,2020-03-23T00:00:00Z,CV,Cabo Verde,AFRO,0,3,0,0
3445,2020-03-24T00:00:00Z,CV,Cabo Verde,AFRO,0,3,0,0
3446,2020-03-25T00:00:00Z,CV,Cabo Verde,AFRO,0,3,0,0
3447,2020-03-26T00:00:00Z,CV,Cabo Verde,AFRO,0,3,0,0
3448,2020-03-27T00:00:00Z,CV,Cabo Verde,AFRO,0,3,0,0
3449,2020-03-28T00:00:00Z,CV,Cabo Verde,AFRO,2,5,1,1
3450,2020-03-29T00:00:00Z,CV,Cabo Verde,AFRO,0,5,0,1
3451,2020-03-30T00:00:00Z,CV,Cabo Verde,AFRO,0,5,0,1
3452,2020-03-31T00:00:00Z,CV,Cabo Verde,AFRO,0,5,0,1
3453,2020-04-01T00:00:00Z,CV,Cabo Verde,AFRO,0,5,0,1
3454,2020-04-02T00:00:00Z,CV,Cabo Verde,AFRO,0,5,0,1
3455,2020-04-03T00:00:00Z,CV,Cabo Verde,AFRO,0,5,0,1
3456,2020-04-04T00:00:00Z,CV,Cabo Verde,AFRO,0,5,0,1
3457,2020-04-05T00:00:00Z,CV,Cabo Verde,AFRO,0,5,0,1
3458,2020-04-06T00:00:00Z,CV,Cabo Verde,AFRO,0,5,0,1
3459,2020-04-07T00:00:00Z,CV,Cabo Verde,AFRO,2,7,0,1
3460,2020-04-08T00:00:00Z,CV,Cabo Verde,AFRO,0,7,0,1
3461,2020-04-09T00:00:00Z,CV,Cabo Verde,AFRO,0,7,0,1
3462,2020-04-10T00:00:00Z,CV,Cabo Verde,AFRO,0,7,0,1
3463,2020-04-11T00:00:00Z,CV,Cabo Verde,AFRO,0,7,0,1
3464,2020-04-12T00:00:00Z,CV,Cabo Verde,AFRO,0,7,0,1
3465,2020-04-13T00:00:00Z,CV,Cabo Verde,AFRO,0,7,0,1
3466,2020-04-14T00:00:00Z,CV,Cabo Verde,AFRO,3,10,0,1
3467,2020-04-15T00:00:00Z,CV,Cabo Verde,AFRO,0,10,0,1
3468,2020-04-16T00:00:00Z,CV,Cabo Verde,AFRO,0,10,0,1
3469,2020-04-17T00:00:00Z,CV,Cabo Verde,AFRO,45,55,0,1
3470,2020-04-18T00:00:00Z,CV,Cabo Verde,AFRO,0,55,0,1
3471,2020-04-19T00:00:00Z,CV,Cabo Verde,AFRO,0,55,0,1
3472,2020-04-20T00:00:00Z,CV,Cabo Verde,AFRO,0,55,0,1
3473,2020-04-21T00:00:00Z,CV,Cabo Verde,AFRO,0,55,0,1
3474,2020-04-22T00:00:00Z,CV,Cabo Verde,AFRO,12,67,0,1
3475,2020-04-23T00:00:00Z,CV,Cabo Verde,AFRO,0,67,0,1
3476,2020-04-24T00:00:00Z,CV,Cabo Verde,AFRO,0,67,0,1
3477,2020-04-25T00:00:00Z,CV,Cabo Verde,AFRO,21,88,0,1
3478,2020-04-26T00:00:00Z,CV,Cabo Verde,AFRO,2,90,0,1
3479,2020-04-27T00:00:00Z,CV,Cabo Verde,AFRO,16,106,0,1
3480,2020-04-28T00:00:00Z,CV,Cabo Verde,AFRO,0,106,0,1
3481,2020-04-29T00:00:00Z,CV,Cabo Verde,AFRO,7,113,0,1
3482,2020-04-30T00:00:00Z,CV,Cabo Verde,AFRO,0,113,0,1
3483,2020-05-01T00:00:00Z,CV,Cabo Verde,AFRO,8,121,0,1
3484,2020-05-02T00:00:00Z,CV,Cabo Verde,AFRO,0,121,0,1
3485,2020-05-03T00:00:00Z,CV,Cabo Verde,AFRO,31,152,1,2
3486,2020-05-04T00:00:00Z,CV,Cabo Verde,AFRO,13,165,0,2
3487,2020-05-05T00:00:00Z,CV,Cabo Verde,AFRO,0,165,0,2
3488,2020-05-06T00:00:00Z,CV,Cabo Verde,AFRO,21,186,0,2
3489,2020-05-07T00:00:00Z,CV,Cabo Verde,AFRO,5,191,0,2
3490,2020-05-08T00:00:00Z,CV,Cabo Verde,AFRO,27,218,0,2
3491,2020-05-09T00:00:00Z,CV,Cabo Verde,AFRO,12,230,0,2
3492,2020-05-10T00:00:00Z,CV,Cabo Verde,AFRO,6,236,0,2
3493,2020-05-11T00:00:00Z,CV,Cabo Verde,AFRO,10,246,0,2
3494,2020-05-12T00:00:00Z,CV,Cabo Verde,AFRO,14,260,0,2
3495,2020-05-13T00:00:00Z,CV,Cabo Verde,AFRO,10,270,0,2
3496,2020-05-14T00:00:00Z,CV,Cabo Verde,AFRO,19,289,0,2
3497,2020-05-15T00:00:00Z,CV,Cabo Verde,AFRO,26,315,0,2
3498,2020-05-16T00:00:00Z,CV,Cabo Verde,AFRO,11,326,0,2
3499,2020-05-17T00:00:00Z,CV,Cabo Verde,AFRO,2,328,1,3
3500,2020-05-18T00:00:00Z,CV,Cabo Verde,AFRO,0,328,0,3
3501,2020-05-19T00:00:00Z,CV,Cabo Verde,AFRO,0,328,0,3
3502,2020-05-20T00:00:00Z,CV,Cabo Verde,AFRO,7,335,0,3
3503,2020-05-21T00:00:00Z,CV,Cabo Verde,AFRO,14,349,0,3
3504,2020-05-22T00:00:00Z,CV,Cabo Verde,AFRO,7,356,0,3
3505,2020-05-23T00:00:00Z,CV,Cabo Verde,AFRO,6,362,0,3
3506,2020-05-24T00:00:00Z,CV,Cabo Verde,AFRO,9,371,0,3
3507,2020-05-25T00:00:00Z,CV,Cabo Verde,AFRO,9,380,0,3
3508,2020-05-26T00:00:00Z,CV,Cabo Verde,AFRO,10,390,0,3
3509,2020-05-27T00:00:00Z,CV,Cabo Verde,AFRO,0,390,1,4
3510,2020-05-28T00:00:00Z,CV,Cabo Verde,AFRO,0,390,0,4
3511,2020-05-29T00:00:00Z,CV,Cabo Verde,AFRO,0,390,0,4
3512,2020-05-30T00:00:00Z,CV,Cabo Verde,AFRO,15,405,0,4
3513,2020-05-31T00:00:00Z,CV,Cabo Verde,AFRO,16,421,0,4
3514,2020-06-01T00:00:00Z,CV,Cabo Verde,AFRO,14,435,0,4
3515,2020-06-02T00:00:00Z,CV,Cabo Verde,AFRO,23,458,0,4
3516,2020-06-03T00:00:00Z,CV,Cabo Verde,AFRO,8,466,1,5
3517,2020-06-04T00:00:00Z,CV,Cabo Verde,AFRO,11,477,0,5
3518,2020-06-05T00:00:00Z,CV,Cabo Verde,AFRO,25,502,0,5
3519,2020-06-06T00:00:00Z,CV,Cabo Verde,AFRO,34,536,0,5
3520,2020-06-07T00:00:00Z,CV,Cabo Verde,AFRO,6,542,0,5
3521,2020-06-08T00:00:00Z,CV,Cabo Verde,AFRO,12,554,0,5
3522,2020-06-09T00:00:00Z,CV,Cabo Verde,AFRO,13,567,0,5
3523,2020-06-10T00:00:00Z,CV,Cabo Verde,AFRO,18,585,0,5
3524,2020-06-11T00:00:00Z,CV,Cabo Verde,AFRO,31,616,0,5
3525,2020-06-12T00:00:00Z,CV,Cabo Verde,AFRO,41,657,1,6
3526,2020-06-13T00:00:00Z,CV,Cabo Verde,AFRO,40,697,0,6
3527,2020-06-14T00:00:00Z,CV,Cabo Verde,AFRO,29,726,0,6
3528,2020-06-15T00:00:00Z,CV,Cabo Verde,AFRO,24,750,0,6
3529,2020-06-16T00:00:00Z,CV,Cabo Verde,AFRO,10,760,1,7
3530,2020-06-17T00:00:00Z,CV,Cabo Verde,AFRO,21,781,0,7
3531,2020-06-18T00:00:00Z,CV,Cabo Verde,AFRO,11,792,0,7
3532,2020-06-19T00:00:00Z,CV,Cabo Verde,AFRO,31,823,0,7
3533,2020-06-20T00:00:00Z,CV,Cabo Verde,AFRO,25,848,1,8
3680,2020-03-06T00:00:00Z,CM,Cameroon,AFRO,2,2,0,0
3681,2020-03-07T00:00:00Z,CM,Cameroon,AFRO,0,2,0,0
3682,2020-03-08T00:00:00Z,CM,Cameroon,AFRO,0,2,0,0
3683,2020-03-09T00:00:00Z,CM,Cameroon,AFRO,0,2,0,0
3684,2020-03-10T00:00:00Z,CM,Cameroon,AFRO,0,2,0,0
3685,2020-03-11T00:00:00Z,CM,Cameroon,AFRO,0,2,0,0
3686,2020-03-12T00:00:00Z,CM,Cameroon,AFRO,0,2,0,0
3687,2020-03-13T00:00:00Z,CM,Cameroon,AFRO,0,2,0,0
3688,2020-03-14T00:00:00Z,CM,Cameroon,AFRO,1,3,0,0
3689,2020-03-15T00:00:00Z,CM,Cameroon,AFRO,0,3,0,0
3690,2020-03-16T00:00:00Z,CM,Cameroon,AFRO,2,5,0,0
3691,2020-03-17T00:00:00Z,CM,Cameroon,AFRO,0,5,0,0
3692,2020-03-18T00:00:00Z,CM,Cameroon,AFRO,5,10,0,0
3693,2020-03-19T00:00:00Z,CM,Cameroon,AFRO,5,15,0,0
3694,2020-03-20T00:00:00Z,CM,Cameroon,AFRO,7,22,0,0
3695,2020-03-21T00:00:00Z,CM,Cameroon,AFRO,5,27,0,0
3696,2020-03-22T00:00:00Z,CM,Cameroon,AFRO,0,27,0,0
3697,2020-03-23T00:00:00Z,CM,Cameroon,AFRO,13,40,0,0
3698,2020-03-24T00:00:00Z,CM,Cameroon,AFRO,30,70,0,0
3699,2020-03-25T00:00:00Z,CM,Cameroon,AFRO,0,70,1,1
3700,2020-03-26T00:00:00Z,CM,Cameroon,AFRO,5,75,0,1
3701,2020-03-27T00:00:00Z,CM,Cameroon,AFRO,0,75,0,1
3702,2020-03-28T00:00:00Z,CM,Cameroon,AFRO,0,75,0,1
3703,2020-03-29T00:00:00Z,CM,Cameroon,AFRO,16,91,1,2
3704,2020-03-30T00:00:00Z,CM,Cameroon,AFRO,22,113,0,2
3705,2020-03-31T00:00:00Z,CM,Cameroon,AFRO,26,139,4,6
3706,2020-04-01T00:00:00Z,CM,Cameroon,AFRO,0,139,0,6
3707,2020-04-02T00:00:00Z,CM,Cameroon,AFRO,0,139,0,6
3708,2020-04-03T00:00:00Z,CM,Cameroon,AFRO,107,246,1,7
3709,2020-04-04T00:00:00Z,CM,Cameroon,AFRO,263,509,1,8
3710,2020-04-05T00:00:00Z,CM,Cameroon,AFRO,46,555,1,9
3711,2020-04-06T00:00:00Z,CM,Cameroon,AFRO,0,555,0,9
3712,2020-04-07T00:00:00Z,CM,Cameroon,AFRO,0,555,0,9
3713,2020-04-08T00:00:00Z,CM,Cameroon,AFRO,0,555,0,9
3714,2020-04-09T00:00:00Z,CM,Cameroon,AFRO,175,730,1,10
3715,2020-04-10T00:00:00Z,CM,Cameroon,AFRO,0,730,0,10
3716,2020-04-11T00:00:00Z,CM,Cameroon,AFRO,73,803,0,10
3717,2020-04-12T00:00:00Z,CM,Cameroon,AFRO,0,803,0,10
3718,2020-04-13T00:00:00Z,CM,Cameroon,AFRO,0,803,0,10
3719,2020-04-14T00:00:00Z,CM,Cameroon,AFRO,0,803,0,10
3720,2020-04-15T00:00:00Z,CM,Cameroon,AFRO,52,855,5,15
3721,2020-04-16T00:00:00Z,CM,Cameroon,AFRO,0,855,2,17
3722,2020-04-17T00:00:00Z,CM,Cameroon,AFRO,0,855,0,17
3723,2020-04-18T00:00:00Z,CM,Cameroon,AFRO,161,1016,4,21
3724,2020-04-19T00:00:00Z,CM,Cameroon,AFRO,0,1016,0,21
3725,2020-04-20T00:00:00Z,CM,Cameroon,AFRO,0,1016,0,21
3726,2020-04-21T00:00:00Z,CM,Cameroon,AFRO,147,1163,21,42
3727,2020-04-22T00:00:00Z,CM,Cameroon,AFRO,0,1163,1,43
3728,2020-04-23T00:00:00Z,CM,Cameroon,AFRO,0,1163,0,43
3729,2020-04-24T00:00:00Z,CM,Cameroon,AFRO,238,1401,6,49
3730,2020-04-25T00:00:00Z,CM,Cameroon,AFRO,2,1403,0,49
3731,2020-04-26T00:00:00Z,CM,Cameroon,AFRO,115,1518,4,53
3732,2020-04-27T00:00:00Z,CM,Cameroon,AFRO,103,1621,3,56
3733,2020-04-28T00:00:00Z,CM,Cameroon,AFRO,0,1621,0,56
3734,2020-04-29T00:00:00Z,CM,Cameroon,AFRO,84,1705,2,58
3735,2020-04-30T00:00:00Z,CM,Cameroon,AFRO,101,1806,1,59
3736,2020-05-01T00:00:00Z,CM,Cameroon,AFRO,26,1832,2,61
3737,2020-05-02T00:00:00Z,CM,Cameroon,AFRO,237,2069,0,61
3738,2020-05-03T00:00:00Z,CM,Cameroon,AFRO,8,2077,3,64
3739,2020-05-04T00:00:00Z,CM,Cameroon,AFRO,0,2077,0,64
3740,2020-05-05T00:00:00Z,CM,Cameroon,AFRO,0,2077,0,64
3741,2020-05-06T00:00:00Z,CM,Cameroon,AFRO,188,2265,44,108
3742,2020-05-07T00:00:00Z,CM,Cameroon,AFRO,0,2265,0,108
3743,2020-05-08T00:00:00Z,CM,Cameroon,AFRO,0,2265,0,108
3744,2020-05-09T00:00:00Z,CM,Cameroon,AFRO,0,2265,0,108
3745,2020-05-10T00:00:00Z,CM,Cameroon,AFRO,70,2335,2,110
3746,2020-05-11T00:00:00Z,CM,Cameroon,AFRO,244,2579,4,114
3747,2020-05-12T00:00:00Z,CM,Cameroon,AFRO,0,2579,0,114
3748,2020-05-13T00:00:00Z,CM,Cameroon,AFRO,110,2689,11,125
3749,2020-05-14T00:00:00Z,CM,Cameroon,AFRO,111,2800,11,136
3750,2020-05-15T00:00:00Z,CM,Cameroon,AFRO,154,2954,3,139
3751,2020-05-16T00:00:00Z,CM,Cameroon,AFRO,93,3047,0,139
3752,2020-05-17T00:00:00Z,CM,Cameroon,AFRO,0,3047,0,139
3753,2020-05-18T00:00:00Z,CM,Cameroon,AFRO,0,3047,0,139
3754,2020-05-19T00:00:00Z,CM,Cameroon,AFRO,482,3529,1,140
3755,2020-05-20T00:00:00Z,CM,Cameroon,AFRO,0,3529,0,140
3756,2020-05-21T00:00:00Z,CM,Cameroon,AFRO,204,3733,6,146
3757,2020-05-22T00:00:00Z,CM,Cameroon,AFRO,555,4288,10,156
3758,2020-05-23T00:00:00Z,CM,Cameroon,AFRO,112,4400,3,159
3759,2020-05-24T00:00:00Z,CM,Cameroon,AFRO,0,4400,0,159
3760,2020-05-25T00:00:00Z,CM,Cameroon,AFRO,0,4400,0,159
3761,2020-05-26T00:00:00Z,CM,Cameroon,AFRO,490,4890,6,165
3762,2020-05-27T00:00:00Z,CM,Cameroon,AFRO,546,5436,12,177
3763,2020-05-28T00:00:00Z,CM,Cameroon,AFRO,0,5436,0,177
3764,2020-05-29T00:00:00Z,CM,Cameroon,AFRO,0,5436,0,177
3765,2020-05-30T00:00:00Z,CM,Cameroon,AFRO,0,5436,0,177
3766,2020-05-31T00:00:00Z,CM,Cameroon,AFRO,223,5659,8,185
3767,2020-06-01T00:00:00Z,CM,Cameroon,AFRO,245,5904,6,191
3768,2020-06-02T00:00:00Z,CM,Cameroon,AFRO,493,6397,8,199
3769,2020-06-03T00:00:00Z,CM,Cameroon,AFRO,188,6585,1,200
3770,2020-06-04T00:00:00Z,CM,Cameroon,AFRO,167,6752,0,200
3771,2020-06-05T00:00:00Z,CM,Cameroon,AFRO,37,6789,3,203
3772,2020-06-06T00:00:00Z,CM,Cameroon,AFRO,603,7392,2,205
3773,2020-06-07T00:00:00Z,CM,Cameroon,AFRO,207,7599,7,212
3774,2020-06-08T00:00:00Z,CM,Cameroon,AFRO,261,7860,3,215
3775,2020-06-09T00:00:00Z,CM,Cameroon,AFRO,200,8060,0,215
3776,2020-06-10T00:00:00Z,CM,Cameroon,AFRO,252,8312,0,215
3777,2020-06-11T00:00:00Z,CM,Cameroon,AFRO,369,8681,0,215
3778,2020-06-12T00:00:00Z,CM,Cameroon,AFRO,0,8681,0,215
3779,2020-06-13T00:00:00Z,CM,Cameroon,AFRO,62,8743,55,270
3780,2020-06-14T00:00:00Z,CM,Cameroon,AFRO,0,8743,0,270
3781,2020-06-15T00:00:00Z,CM,Cameroon,AFRO,829,9572,5,275
3782,2020-06-16T00:00:00Z,CM,Cameroon,AFRO,292,9864,1,276
3783,2020-06-17T00:00:00Z,CM,Cameroon,AFRO,0,9864,0,276
3784,2020-06-18T00:00:00Z,CM,Cameroon,AFRO,0,9864,0,276
3785,2020-06-19T00:00:00Z,CM,Cameroon,AFRO,0,9864,0,276
3786,2020-06-20T00:00:00Z,CM,Cameroon,AFRO,774,10638,6,282
4034,2020-03-14T00:00:00Z,CF,Central African Republic,AFRO,1,1,0,0
4035,2020-03-15T00:00:00Z,CF,Central African Republic,AFRO,0,1,0,0
4036,2020-03-16T00:00:00Z,CF,Central African Republic,AFRO,0,1,0,0
4037,2020-03-17T00:00:00Z,CF,Central African Republic,AFRO,0,1,0,0
4038,2020-03-18T00:00:00Z,CF,Central African Republic,AFRO,0,1,0,0
4039,2020-03-19T00:00:00Z,CF,Central African Republic,AFRO,0,1,0,0
4040,2020-03-20T00:00:00Z,CF,Central African Republic,AFRO,0,1,0,0
4041,2020-03-21T00:00:00Z,CF,Central African Republic,AFRO,2,3,0,0
4042,2020-03-22T00:00:00Z,CF,Central African Republic,AFRO,0,3,0,0
4043,2020-03-23T00:00:00Z,CF,Central African Republic,AFRO,1,4,0,0
4044,2020-03-24T00:00:00Z,CF,Central African Republic,AFRO,0,4,0,0
4045,2020-03-25T00:00:00Z,CF,Central African Republic,AFRO,0,4,0,0
4046,2020-03-26T00:00:00Z,CF,Central African Republic,AFRO,1,5,0,0
4047,2020-03-27T00:00:00Z,CF,Central African Republic,AFRO,0,5,0,0
4048,2020-03-28T00:00:00Z,CF,Central African Republic,AFRO,1,6,0,0
4049,2020-03-29T00:00:00Z,CF,Central African Republic,AFRO,0,6,0,0
4050,2020-03-30T00:00:00Z,CF,Central African Republic,AFRO,0,6,0,0
4051,2020-03-31T00:00:00Z,CF,Central African Republic,AFRO,0,6,0,0
4052,2020-04-01T00:00:00Z,CF,Central African Republic,AFRO,0,6,0,0
4053,2020-04-02T00:00:00Z,CF,Central African Republic,AFRO,2,8,0,0
4054,2020-04-03T00:00:00Z,CF,Central African Republic,AFRO,0,8,0,0
4055,2020-04-04T00:00:00Z,CF,Central African Republic,AFRO,0,8,0,0
4056,2020-04-05T00:00:00Z,CF,Central African Republic,AFRO,1,9,0,0
4057,2020-04-06T00:00:00Z,CF,Central African Republic,AFRO,0,9,0,0
4058,2020-04-07T00:00:00Z,CF,Central African Republic,AFRO,0,9,0,0
4059,2020-04-08T00:00:00Z,CF,Central African Republic,AFRO,0,9,0,0
4060,2020-04-09T00:00:00Z,CF,Central African Republic,AFRO,1,10,0,0
4061,2020-04-10T00:00:00Z,CF,Central African Republic,AFRO,0,10,0,0
4062,2020-04-11T00:00:00Z,CF,Central African Republic,AFRO,1,11,0,0
4063,2020-04-12T00:00:00Z,CF,Central African Republic,AFRO,0,11,0,0
4064,2020-04-13T00:00:00Z,CF,Central African Republic,AFRO,0,11,0,0
4065,2020-04-14T00:00:00Z,CF,Central African Republic,AFRO,0,11,0,0
4066,2020-04-15T00:00:00Z,CF,Central African Republic,AFRO,0,11,0,0
4067,2020-04-16T00:00:00Z,CF,Central African Republic,AFRO,0,11,0,0
4068,2020-04-17T00:00:00Z,CF,Central African Republic,AFRO,1,12,0,0
4069,2020-04-18T00:00:00Z,CF,Central African Republic,AFRO,0,12,0,0
4070,2020-04-19T00:00:00Z,CF,Central African Republic,AFRO,0,12,0,0
4071,2020-04-20T00:00:00Z,CF,Central African Republic,AFRO,0,12,0,0
4072,2020-04-21T00:00:00Z,CF,Central African Republic,AFRO,0,12,0,0
4073,2020-04-22T00:00:00Z,CF,Central African Republic,AFRO,2,14,0,0
4074,2020-04-23T00:00:00Z,CF,Central African Republic,AFRO,0,14,0,0
4075,2020-04-24T00:00:00Z,CF,Central African Republic,AFRO,2,16,0,0
4076,2020-04-25T00:00:00Z,CF,Central African Republic,AFRO,3,19,0,0
4077,2020-04-26T00:00:00Z,CF,Central African Republic,AFRO,0,19,0,0
4078,2020-04-27T00:00:00Z,CF,Central African Republic,AFRO,0,19,0,0
4079,2020-04-28T00:00:00Z,CF,Central African Republic,AFRO,23,42,0,0
4080,2020-04-29T00:00:00Z,CF,Central African Republic,AFRO,8,50,0,0
4081,2020-04-30T00:00:00Z,CF,Central African Republic,AFRO,0,50,0,0
4082,2020-05-01T00:00:00Z,CF,Central African Republic,AFRO,14,64,0,0
4083,2020-05-02T00:00:00Z,CF,Central African Republic,AFRO,0,64,0,0
4084,2020-05-03T00:00:00Z,CF,Central African Republic,AFRO,8,72,0,0
4085,2020-05-04T00:00:00Z,CF,Central African Republic,AFRO,0,72,0,0
4086,2020-05-05T00:00:00Z,CF,Central African Republic,AFRO,22,94,0,0
4087,2020-05-06T00:00:00Z,CF,Central African Republic,AFRO,0,94,0,0
4088,2020-05-07T00:00:00Z,CF,Central African Republic,AFRO,0,94,0,0
4089,2020-05-08T00:00:00Z,CF,Central African Republic,AFRO,0,94,0,0
4090,2020-05-09T00:00:00Z,CF,Central African Republic,AFRO,0,94,0,0
4091,2020-05-10T00:00:00Z,CF,Central African Republic,AFRO,49,143,0,0
4092,2020-05-11T00:00:00Z,CF,Central African Republic,AFRO,36,179,0,0
4093,2020-05-12T00:00:00Z,CF,Central African Republic,AFRO,0,179,0,0
4094,2020-05-13T00:00:00Z,CF,Central African Republic,AFRO,0,179,0,0
4095,2020-05-14T00:00:00Z,CF,Central African Republic,AFRO,8,187,0,0
4096,2020-05-15T00:00:00Z,CF,Central African Republic,AFRO,34,221,0,0
4097,2020-05-16T00:00:00Z,CF,Central African Republic,AFRO,80,301,0,0
4098,2020-05-17T00:00:00Z,CF,Central African Republic,AFRO,0,301,0,0
4099,2020-05-18T00:00:00Z,CF,Central African Republic,AFRO,26,327,0,0
4100,2020-05-19T00:00:00Z,CF,Central African Republic,AFRO,9,336,0,0
4101,2020-05-20T00:00:00Z,CF,Central African Republic,AFRO,75,411,0,0
4102,2020-05-21T00:00:00Z,CF,Central African Republic,AFRO,0,411,0,0
4103,2020-05-22T00:00:00Z,CF,Central African Republic,AFRO,25,436,0,0
4104,2020-05-23T00:00:00Z,CF,Central African Republic,AFRO,43,479,0,0
4105,2020-05-24T00:00:00Z,CF,Central African Republic,AFRO,73,552,1,1
4106,2020-05-25T00:00:00Z,CF,Central African Republic,AFRO,52,604,0,1
4107,2020-05-26T00:00:00Z,CF,Central African Republic,AFRO,48,652,0,1
4108,2020-05-27T00:00:00Z,CF,Central African Republic,AFRO,0,652,0,1
4109,2020-05-28T00:00:00Z,CF,Central African Republic,AFRO,49,701,0,1
4110,2020-05-29T00:00:00Z,CF,Central African Republic,AFRO,54,755,0,1
4111,2020-05-30T00:00:00Z,CF,Central African Republic,AFRO,119,874,0,1
4112,2020-05-31T00:00:00Z,CF,Central African Republic,AFRO,0,874,0,1
4113,2020-06-01T00:00:00Z,CF,Central African Republic,AFRO,137,1011,1,2
4114,2020-06-02T00:00:00Z,CF,Central African Republic,AFRO,58,1069,2,4
4115,2020-06-03T00:00:00Z,CF,Central African Republic,AFRO,0,1069,0,4
4116,2020-06-04T00:00:00Z,CF,Central African Republic,AFRO,120,1189,0,4
4117,2020-06-05T00:00:00Z,CF,Central African Republic,AFRO,99,1288,0,4
4118,2020-06-06T00:00:00Z,CF,Central African Republic,AFRO,163,1451,0,4
4119,2020-06-07T00:00:00Z,CF,Central African Republic,AFRO,119,1570,1,5
4120,2020-06-08T00:00:00Z,CF,Central African Republic,AFRO,64,1634,0,5
4121,2020-06-09T00:00:00Z,CF,Central African Republic,AFRO,216,1850,0,5
4122,2020-06-10T00:00:00Z,CF,Central African Republic,AFRO,0,1850,0,5
4123,2020-06-11T00:00:00Z,CF,Central African Republic,AFRO,38,1888,0,5
4124,2020-06-12T00:00:00Z,CF,Central African Republic,AFRO,156,2044,0,5
4125,2020-06-13T00:00:00Z,CF,Central African Republic,AFRO,13,2057,2,7
4126,2020-06-14T00:00:00Z,CF,Central African Republic,AFRO,0,2057,0,7
4127,2020-06-15T00:00:00Z,CF,Central African Republic,AFRO,165,2222,0,7
4128,2020-06-16T00:00:00Z,CF,Central African Republic,AFRO,0,2222,0,7
4129,2020-06-17T00:00:00Z,CF,Central African Republic,AFRO,188,2410,7,14
4130,2020-06-18T00:00:00Z,CF,Central African Republic,AFRO,154,2564,4,18
4131,2020-06-19T00:00:00Z,CF,Central African Republic,AFRO,41,2605,1,19
4132,2020-06-20T00:00:00Z,CF,Central African Republic,AFRO,0,2605,0,19
4133,2020-03-19T00:00:00Z,TD,Chad,AFRO,1,1,0,0
4134,2020-03-20T00:00:00Z,TD,Chad,AFRO,0,1,0,0
4135,2020-03-21T00:00:00Z,TD,Chad,AFRO,0,1,0,0
4136,2020-03-22T00:00:00Z,TD,Chad,AFRO,0,1,0,0
4137,2020-03-23T00:00:00Z,TD,Chad,AFRO,0,1,0,0
4138,2020-03-24T00:00:00Z,TD,Chad,AFRO,2,3,0,0
4139,2020-03-25T00:00:00Z,TD,Chad,AFRO,0,3,0,0
4140,2020-03-26T00:00:00Z,TD,Chad,AFRO,0,3,0,0
4141,2020-03-27T00:00:00Z,TD,Chad,AFRO,2,5,0,0
4142,2020-03-28T00:00:00Z,TD,Chad,AFRO,0,5,0,0
4143,2020-03-29T00:00:00Z,TD,Chad,AFRO,0,5,0,0
4144,2020-03-30T00:00:00Z,TD,Chad,AFRO,0,5,0,0
4145,2020-03-31T00:00:00Z,TD,Chad,AFRO,0,5,0,0
4146,2020-04-01T00:00:00Z,TD,Chad,AFRO,2,7,0,0
4147,2020-04-02T00:00:00Z,TD,Chad,AFRO,0,7,0,0
4148,2020-04-03T00:00:00Z,TD,Chad,AFRO,0,7,0,0
4149,2020-04-04T00:00:00Z,TD,Chad,AFRO,0,7,0,0
4150,2020-04-05T00:00:00Z,TD,Chad,AFRO,0,7,0,0
4151,2020-04-06T00:00:00Z,TD,Chad,AFRO,2,9,0,0
4152,2020-04-07T00:00:00Z,TD,Chad,AFRO,0,9,0,0
4153,2020-04-08T00:00:00Z,TD,Chad,AFRO,1,10,0,0
4154,2020-04-09T00:00:00Z,TD,Chad,AFRO,0,10,0,0
4155,2020-04-10T00:00:00Z,TD,Chad,AFRO,1,11,0,0
4156,2020-04-11T00:00:00Z,TD,Chad,AFRO,0,11,0,0
4157,2020-04-12T00:00:00Z,TD,Chad,AFRO,0,11,0,0
4158,2020-04-13T00:00:00Z,TD,Chad,AFRO,7,18,0,0
4159,2020-04-14T00:00:00Z,TD,Chad,AFRO,5,23,0,0
4160,2020-04-15T00:00:00Z,TD,Chad,AFRO,0,23,0,0
4161,2020-04-16T00:00:00Z,TD,Chad,AFRO,4,27,0,0
4162,2020-04-17T00:00:00Z,TD,Chad,AFRO,0,27,0,0
4163,2020-04-18T00:00:00Z,TD,Chad,AFRO,6,33,0,0
4164,2020-04-19T00:00:00Z,TD,Chad,AFRO,0,33,0,0
4165,2020-04-20T00:00:00Z,TD,Chad,AFRO,0,33,0,0
4166,2020-04-21T00:00:00Z,TD,Chad,AFRO,0,33,0,0
4167,2020-04-22T00:00:00Z,TD,Chad,AFRO,1,34,0,0
4168,2020-04-23T00:00:00Z,TD,Chad,AFRO,0,34,0,0
4169,2020-04-24T00:00:00Z,TD,Chad,AFRO,0,34,0,0
4170,2020-04-25T00:00:00Z,TD,Chad,AFRO,6,40,0,0
4171,2020-04-26T00:00:00Z,TD,Chad,AFRO,6,46,0,0
4172,2020-04-27T00:00:00Z,TD,Chad,AFRO,0,46,0,0
4173,2020-04-28T00:00:00Z,TD,Chad,AFRO,0,46,0,0
4174,2020-04-29T00:00:00Z,TD,Chad,AFRO,6,52,2,2
4175,2020-04-30T00:00:00Z,TD,Chad,AFRO,0,52,0,2
4176,2020-05-01T00:00:00Z,TD,Chad,AFRO,21,73,1,3
4177,2020-05-02T00:00:00Z,TD,Chad,AFRO,0,73,2,5
4178,2020-05-03T00:00:00Z,TD,Chad,AFRO,44,117,5,10
4179,2020-05-04T00:00:00Z,TD,Chad,AFRO,0,117,0,10
4180,2020-05-05T00:00:00Z,TD,Chad,AFRO,0,117,0,10
4181,2020-05-06T00:00:00Z,TD,Chad,AFRO,53,170,7,17
4182,2020-05-07T00:00:00Z,TD,Chad,AFRO,0,170,0,17
4183,2020-05-08T00:00:00Z,TD,Chad,AFRO,83,253,10,27
4184,2020-05-09T00:00:00Z,TD,Chad,AFRO,7,260,1,28
4185,2020-05-10T00:00:00Z,TD,Chad,AFRO,62,322,3,31
4186,2020-05-11T00:00:00Z,TD,Chad,AFRO,0,322,0,31
4187,2020-05-12T00:00:00Z,TD,Chad,AFRO,0,322,0,31
4188,2020-05-13T00:00:00Z,TD,Chad,AFRO,35,357,9,40
4189,2020-05-14T00:00:00Z,TD,Chad,AFRO,15,372,2,42
4190,2020-05-15T00:00:00Z,TD,Chad,AFRO,27,399,4,46
4191,2020-05-16T00:00:00Z,TD,Chad,AFRO,29,428,2,48
4192,2020-05-17T00:00:00Z,TD,Chad,AFRO,46,474,2,50
4193,2020-05-18T00:00:00Z,TD,Chad,AFRO,29,503,3,53
4194,2020-05-19T00:00:00Z,TD,Chad,AFRO,16,519,1,54
4195,2020-05-20T00:00:00Z,TD,Chad,AFRO,26,545,2,56
4196,2020-05-21T00:00:00Z,TD,Chad,AFRO,20,565,1,57
4197,2020-05-22T00:00:00Z,TD,Chad,AFRO,23,588,1,58
4198,2020-05-23T00:00:00Z,TD,Chad,AFRO,23,611,1,59
4199,2020-05-24T00:00:00Z,TD,Chad,AFRO,37,648,1,60
4200,2020-05-25T00:00:00Z,TD,Chad,AFRO,27,675,0,60
4201,2020-05-26T00:00:00Z,TD,Chad,AFRO,12,687,1,61
4202,2020-05-27T00:00:00Z,TD,Chad,AFRO,13,700,1,62
4203,2020-05-28T00:00:00Z,TD,Chad,AFRO,15,715,2,64
4204,2020-05-29T00:00:00Z,TD,Chad,AFRO,11,726,1,65
4205,2020-05-30T00:00:00Z,TD,Chad,AFRO,33,759,0,65
4206,2020-05-31T00:00:00Z,TD,Chad,AFRO,0,759,0,65
4207,2020-06-01T00:00:00Z,TD,Chad,AFRO,19,778,0,65
4208,2020-06-02T00:00:00Z,TD,Chad,AFRO,12,790,1,66
4209,2020-06-03T00:00:00Z,TD,Chad,AFRO,13,803,0,66
4210,2020-06-04T00:00:00Z,TD,Chad,AFRO,17,820,0,66
4211,2020-06-05T00:00:00Z,TD,Chad,AFRO,8,828,0,66
4212,2020-06-06T00:00:00Z,TD,Chad,AFRO,8,836,2,68
4213,2020-06-07T00:00:00Z,TD,Chad,AFRO,0,836,1,69
4214,2020-06-08T00:00:00Z,TD,Chad,AFRO,1,837,0,69
4215,2020-06-09T00:00:00Z,TD,Chad,AFRO,2,839,1,70
4216,2020-06-10T00:00:00Z,TD,Chad,AFRO,5,844,1,71
4217,2020-06-11T00:00:00Z,TD,Chad,AFRO,2,846,1,72
4218,2020-06-12T00:00:00Z,TD,Chad,AFRO,2,848,0,72
4219,2020-06-13T00:00:00Z,TD,Chad,AFRO,0,848,0,72
4220,2020-06-14T00:00:00Z,TD,Chad,AFRO,0,848,0,72
4221,2020-06-15T00:00:00Z,TD,Chad,AFRO,2,850,1,73
4222,2020-06-16T00:00:00Z,TD,Chad,AFRO,0,850,0,73
4223,2020-06-17T00:00:00Z,TD,Chad,AFRO,3,853,1,74
4224,2020-06-18T00:00:00Z,TD,Chad,AFRO,1,854,0,74
4225,2020-06-19T00:00:00Z,TD,Chad,AFRO,0,854,0,74
4226,2020-06-20T00:00:00Z,TD,Chad,AFRO,4,858,0,74
4606,2020-05-01T00:00:00Z,KM,Comoros,AFRO,1,1,0,0
4607,2020-05-02T00:00:00Z,KM,Comoros,AFRO,0,1,0,0
4608,2020-05-03T00:00:00Z,KM,Comoros,AFRO,2,3,0,0
4609,2020-05-04T00:00:00Z,KM,Comoros,AFRO,0,3,0,0
4610,2020-05-05T00:00:00Z,KM,Comoros,AFRO,1,4,1,1
4611,2020-05-06T00:00:00Z,KM,Comoros,AFRO,0,4,0,1
4612,2020-05-07T00:00:00Z,KM,Comoros,AFRO,4,8,0,1
4613,2020-05-08T00:00:00Z,KM,Comoros,AFRO,0,8,0,1
4614,2020-05-09T00:00:00Z,KM,Comoros,AFRO,0,8,0,1
4615,2020-05-10T00:00:00Z,KM,Comoros,AFRO,3,11,0,1
4616,2020-05-11T00:00:00Z,KM,Comoros,AFRO,0,11,0,1
4617,2020-05-12T00:00:00Z,KM,Comoros,AFRO,0,11,0,1
4618,2020-05-13T00:00:00Z,KM,Comoros,AFRO,0,11,0,1
4619,2020-05-14T00:00:00Z,KM,Comoros,AFRO,0,11,0,1
4620,2020-05-15T00:00:00Z,KM,Comoros,AFRO,0,11,0,1
4621,2020-05-16T00:00:00Z,KM,Comoros,AFRO,0,11,0,1
4622,2020-05-17T00:00:00Z,KM,Comoros,AFRO,0,11,0,1
4623,2020-05-18T00:00:00Z,KM,Comoros,AFRO,0,11,0,1
4624,2020-05-19T00:00:00Z,KM,Comoros,AFRO,0,11,0,1
4625,2020-05-20T00:00:00Z,KM,Comoros,AFRO,23,34,0,1
4626,2020-05-21T00:00:00Z,KM,Comoros,AFRO,0,34,0,1
4627,2020-05-22T00:00:00Z,KM,Comoros,AFRO,0,34,0,1
4628,2020-05-23T00:00:00Z,KM,Comoros,AFRO,0,34,0,1
4629,2020-05-24T00:00:00Z,KM,Comoros,AFRO,0,34,0,1
4630,2020-05-25T00:00:00Z,KM,Comoros,AFRO,9,43,0,1
4631,2020-05-26T00:00:00Z,KM,Comoros,AFRO,0,43,0,1
4632,2020-05-27T00:00:00Z,KM,Comoros,AFRO,0,43,0,1
4633,2020-05-28T00:00:00Z,KM,Comoros,AFRO,0,43,1,2
4634,2020-05-29T00:00:00Z,KM,Comoros,AFRO,0,43,0,2
4635,2020-05-30T00:00:00Z,KM,Comoros,AFRO,0,43,0,2
4636,2020-05-31T00:00:00Z,KM,Comoros,AFRO,0,43,0,2
4637,2020-06-01T00:00:00Z,KM,Comoros,AFRO,19,62,0,2
4638,2020-06-02T00:00:00Z,KM,Comoros,AFRO,0,62,0,2
4639,2020-06-03T00:00:00Z,KM,Comoros,AFRO,0,62,0,2
4640,2020-06-04T00:00:00Z,KM,Comoros,AFRO,0,62,0,2
4641,2020-06-05T00:00:00Z,KM,Comoros,AFRO,0,62,0,2
4642,2020-06-06T00:00:00Z,KM,Comoros,AFRO,0,62,0,2
4643,2020-06-07T00:00:00Z,KM,Comoros,AFRO,35,97,0,2
4644,2020-06-08T00:00:00Z,KM,Comoros,AFRO,0,97,0,2
4645,2020-06-09T00:00:00Z,KM,Comoros,AFRO,0,97,0,2
4646,2020-06-10T00:00:00Z,KM,Comoros,AFRO,0,97,0,2
4647,2020-06-11T00:00:00Z,KM,Comoros,AFRO,65,162,0,2
4648,2020-06-12T00:00:00Z,KM,Comoros,AFRO,0,162,0,2
4649,2020-06-13T00:00:00Z,KM,Comoros,AFRO,1,163,0,2
4650,2020-06-14T00:00:00Z,KM,Comoros,AFRO,13,176,0,2
4651,2020-06-15T00:00:00Z,KM,Comoros,AFRO,0,176,0,2
4652,2020-06-16T00:00:00Z,KM,Comoros,AFRO,0,176,0,2
4653,2020-06-17T00:00:00Z,KM,Comoros,AFRO,21,197,1,3
4654,2020-06-18T00:00:00Z,KM,Comoros,AFRO,0,197,0,3
4655,2020-06-19T00:00:00Z,KM,Comoros,AFRO,13,210,2,5
4656,2020-06-20T00:00:00Z,KM,Comoros,AFRO,0,210,0,5
4657,2020-03-15T00:00:00Z,CG,Congo,AFRO,1,1,0,0
4658,2020-03-16T00:00:00Z,CG,Congo,AFRO,0,1,0,0
4659,2020-03-17T00:00:00Z,CG,Congo,AFRO,0,1,0,0
4660,2020-03-18T00:00:00Z,CG,Congo,AFRO,2,3,0,0
4661,2020-03-19T00:00:00Z,CG,Congo,AFRO,0,3,0,0
4662,2020-03-20T00:00:00Z,CG,Congo,AFRO,0,3,0,0
4663,2020-03-21T00:00:00Z,CG,Congo,AFRO,1,4,0,0
4664,2020-03-22T00:00:00Z,CG,Congo,AFRO,0,4,0,0
4665,2020-03-23T00:00:00Z,CG,Congo,AFRO,0,4,0,0
4666,2020-03-24T00:00:00Z,CG,Congo,AFRO,0,4,0,0
4667,2020-03-25T00:00:00Z,CG,Congo,AFRO,0,4,0,0
4668,2020-03-26T00:00:00Z,CG,Congo,AFRO,0,4,0,0
4669,2020-03-27T00:00:00Z,CG,Congo,AFRO,0,4,0,0
4670,2020-03-28T00:00:00Z,CG,Congo,AFRO,15,19,0,0
4671,2020-03-29T00:00:00Z,CG,Congo,AFRO,0,19,0,0
4672,2020-03-30T00:00:00Z,CG,Congo,AFRO,0,19,0,0
4673,2020-03-31T00:00:00Z,CG,Congo,AFRO,0,19,0,0
4674,2020-04-01T00:00:00Z,CG,Congo,AFRO,3,22,2,2
4675,2020-04-02T00:00:00Z,CG,Congo,AFRO,0,22,0,2
4676,2020-04-03T00:00:00Z,CG,Congo,AFRO,19,41,0,2
4677,2020-04-04T00:00:00Z,CG,Congo,AFRO,0,41,1,3
4678,2020-04-05T00:00:00Z,CG,Congo,AFRO,4,45,2,5
4679,2020-04-06T00:00:00Z,CG,Congo,AFRO,0,45,0,5
4680,2020-04-07T00:00:00Z,CG,Congo,AFRO,0,45,0,5
4681,2020-04-08T00:00:00Z,CG,Congo,AFRO,4,49,0,5
4682,2020-04-09T00:00:00Z,CG,Congo,AFRO,11,60,0,5
4683,2020-04-10T00:00:00Z,CG,Congo,AFRO,0,60,0,5
4684,2020-04-11T00:00:00Z,CG,Congo,AFRO,0,60,0,5
4685,2020-04-12T00:00:00Z,CG,Congo,AFRO,0,60,0,5
4686,2020-04-13T00:00:00Z,CG,Congo,AFRO,10,70,0,5
4687,2020-04-14T00:00:00Z,CG,Congo,AFRO,4,74,0,5
4688,2020-04-15T00:00:00Z,CG,Congo,AFRO,0,74,0,5
4689,2020-04-16T00:00:00Z,CG,Congo,AFRO,43,117,0,5
4690,2020-04-17T00:00:00Z,CG,Congo,AFRO,0,117,0,5
4691,2020-04-18T00:00:00Z,CG,Congo,AFRO,26,143,1,6
4692,2020-04-19T00:00:00Z,CG,Congo,AFRO,0,143,0,6
4693,2020-04-20T00:00:00Z,CG,Congo,AFRO,0,143,0,6
4694,2020-04-21T00:00:00Z,CG,Congo,AFRO,17,160,0,6
4695,2020-04-22T00:00:00Z,CG,Congo,AFRO,5,165,0,6
4696,2020-04-23T00:00:00Z,CG,Congo,AFRO,21,186,0,6
4697,2020-04-24T00:00:00Z,CG,Congo,AFRO,0,186,0,6
4698,2020-04-25T00:00:00Z,CG,Congo,AFRO,14,200,0,6
4699,2020-04-26T00:00:00Z,CG,Congo,AFRO,0,200,2,8
4700,2020-04-27T00:00:00Z,CG,Congo,AFRO,0,200,0,8
4701,2020-04-28T00:00:00Z,CG,Congo,AFRO,7,207,0,8
4702,2020-04-29T00:00:00Z,CG,Congo,AFRO,0,207,0,8
4703,2020-04-30T00:00:00Z,CG,Congo,AFRO,13,220,1,9
4704,2020-05-01T00:00:00Z,CG,Congo,AFRO,0,220,0,9
4705,2020-05-02T00:00:00Z,CG,Congo,AFRO,9,229,1,10
4706,2020-05-03T00:00:00Z,CG,Congo,AFRO,0,229,0,10
4707,2020-05-04T00:00:00Z,CG,Congo,AFRO,0,229,0,10
4708,2020-05-05T00:00:00Z,CG,Congo,AFRO,7,236,0,10
4709,2020-05-06T00:00:00Z,CG,Congo,AFRO,0,236,0,10
4710,2020-05-07T00:00:00Z,CG,Congo,AFRO,28,264,0,10
4711,2020-05-08T00:00:00Z,CG,Congo,AFRO,10,274,0,10
4712,2020-05-09T00:00:00Z,CG,Congo,AFRO,13,287,0,10
4713,2020-05-10T00:00:00Z,CG,Congo,AFRO,0,287,0,10
4714,2020-05-11T00:00:00Z,CG,Congo,AFRO,0,287,0,10
4715,2020-05-12T00:00:00Z,CG,Congo,AFRO,46,333,1,11
4716,2020-05-13T00:00:00Z,CG,Congo,AFRO,0,333,0,11
4717,2020-05-14T00:00:00Z,CG,Congo,AFRO,8,341,0,11
4718,2020-05-15T00:00:00Z,CG,Congo,AFRO,50,391,4,15
4719,2020-05-16T00:00:00Z,CG,Congo,AFRO,0,391,0,15
4720,2020-05-17T00:00:00Z,CG,Congo,AFRO,0,391,0,15
4721,2020-05-18T00:00:00Z,CG,Congo,AFRO,19,410,0,15
4722,2020-05-19T00:00:00Z,CG,Congo,AFRO,4,414,0,15
4723,2020-05-20T00:00:00Z,CG,Congo,AFRO,6,420,0,15
4724,2020-05-21T00:00:00Z,CG,Congo,AFRO,0,420,0,15
4725,2020-05-22T00:00:00Z,CG,Congo,AFRO,49,469,1,16
4726,2020-05-23T00:00:00Z,CG,Congo,AFRO,0,469,0,16
4727,2020-05-24T00:00:00Z,CG,Congo,AFRO,18,487,0,16
4728,2020-05-25T00:00:00Z,CG,Congo,AFRO,0,487,0,16
4729,2020-05-26T00:00:00Z,CG,Congo,AFRO,44,531,1,17
4730,2020-05-27T00:00:00Z,CG,Congo,AFRO,38,569,2,19
4731,2020-05-28T00:00:00Z,CG,Congo,AFRO,2,571,0,19
4732,2020-05-29T00:00:00Z,CG,Congo,AFRO,0,571,0,19
4733,2020-05-30T00:00:00Z,CG,Congo,AFRO,16,587,0,19
4734,2020-05-31T00:00:00Z,CG,Congo,AFRO,0,587,0,19
4735,2020-06-01T00:00:00Z,CG,Congo,AFRO,17,604,1,20
4736,2020-06-02T00:00:00Z,CG,Congo,AFRO,7,611,0,20
4737,2020-06-03T00:00:00Z,CG,Congo,AFRO,7,618,0,20
4738,2020-06-04T00:00:00Z,CG,Congo,AFRO,14,632,0,20
4739,2020-06-05T00:00:00Z,CG,Congo,AFRO,3,635,0,20
4740,2020-06-06T00:00:00Z,CG,Congo,AFRO,4,639,0,20
4741,2020-06-07T00:00:00Z,CG,Congo,AFRO,14,653,0,20
4742,2020-06-08T00:00:00Z,CG,Congo,AFRO,30,683,2,22
4743,2020-06-09T00:00:00Z,CG,Congo,AFRO,0,683,-2,20
4744,2020-06-10T00:00:00Z,CG,Congo,AFRO,35,718,4,24
4745,2020-06-11T00:00:00Z,CG,Congo,AFRO,10,728,0,24
4746,2020-06-12T00:00:00Z,CG,Congo,AFRO,17,745,1,25
4747,2020-06-13T00:00:00Z,CG,Congo,AFRO,0,745,0,25
4748,2020-06-14T00:00:00Z,CG,Congo,AFRO,34,779,0,25
4749,2020-06-15T00:00:00Z,CG,Congo,AFRO,0,779,0,25
4750,2020-06-16T00:00:00Z,CG,Congo,AFRO,104,883,2,27
4751,2020-06-17T00:00:00Z,CG,Congo,AFRO,0,883,0,27
4752,2020-06-18T00:00:00Z,CG,Congo,AFRO,0,883,0,27
4753,2020-06-19T00:00:00Z,CG,Congo,AFRO,0,883,0,27
4754,2020-06-20T00:00:00Z,CG,Congo,AFRO,0,883,0,27
4860,2020-03-12T00:00:00Z,CI,Côte d’Ivoire,AFRO,1,1,0,0
4861,2020-03-13T00:00:00Z,CI,Côte d’Ivoire,AFRO,0,1,0,0
4862,2020-03-14T00:00:00Z,CI,Côte d’Ivoire,AFRO,2,3,0,0
4863,2020-03-15T00:00:00Z,CI,Côte d’Ivoire,AFRO,0,3,0,0
4864,2020-03-16T00:00:00Z,CI,Côte d’Ivoire,AFRO,0,3,0,0
4865,2020-03-17T00:00:00Z,CI,Côte d’Ivoire,AFRO,3,6,0,0
4866,2020-03-18T00:00:00Z,CI,Côte d’Ivoire,AFRO,3,9,0,0
4867,2020-03-19T00:00:00Z,CI,Côte d’Ivoire,AFRO,0,9,0,0
4868,2020-03-20T00:00:00Z,CI,Côte d’Ivoire,AFRO,0,9,0,0
4869,2020-03-21T00:00:00Z,CI,Côte d’Ivoire,AFRO,0,9,0,0
4870,2020-03-22T00:00:00Z,CI,Côte d’Ivoire,AFRO,0,9,0,0
4871,2020-03-23T00:00:00Z,CI,Côte d’Ivoire,AFRO,16,25,0,0
4872,2020-03-24T00:00:00Z,CI,Côte d’Ivoire,AFRO,0,25,0,0
4873,2020-03-25T00:00:00Z,CI,Côte d’Ivoire,AFRO,47,72,0,0
4874,2020-03-26T00:00:00Z,CI,Côte d’Ivoire,AFRO,8,80,0,0
4875,2020-03-27T00:00:00Z,CI,Côte d’Ivoire,AFRO,0,80,0,0
4876,2020-03-28T00:00:00Z,CI,Côte d’Ivoire,AFRO,12,92,0,0
4877,2020-03-29T00:00:00Z,CI,Côte d’Ivoire,AFRO,48,140,0,0
4878,2020-03-30T00:00:00Z,CI,Côte d’Ivoire,AFRO,25,165,0,0
4879,2020-03-31T00:00:00Z,CI,Côte d’Ivoire,AFRO,4,169,0,0
4880,2020-04-01T00:00:00Z,CI,Côte d’Ivoire,AFRO,0,169,0,0
4881,2020-04-02T00:00:00Z,CI,Côte d’Ivoire,AFRO,21,190,1,1
4882,2020-04-03T00:00:00Z,CI,Côte d’Ivoire,AFRO,0,190,0,1
4883,2020-04-04T00:00:00Z,CI,Côte d’Ivoire,AFRO,28,218,0,1
4884,2020-04-05T00:00:00Z,CI,Côte d’Ivoire,AFRO,27,245,1,2
4885,2020-04-06T00:00:00Z,CI,Côte d’Ivoire,AFRO,16,261,0,2
4886,2020-04-07T00:00:00Z,CI,Côte d’Ivoire,AFRO,62,323,1,3
4887,2020-04-08T00:00:00Z,CI,Côte d’Ivoire,AFRO,26,349,0,3
4888,2020-04-09T00:00:00Z,CI,Côte d’Ivoire,AFRO,35,384,0,3
4889,2020-04-10T00:00:00Z,CI,Côte d’Ivoire,AFRO,0,384,0,3
4890,2020-04-11T00:00:00Z,CI,Côte d’Ivoire,AFRO,96,480,0,3
4891,2020-04-12T00:00:00Z,CI,Côte d’Ivoire,AFRO,53,533,1,4
4892,2020-04-13T00:00:00Z,CI,Côte d’Ivoire,AFRO,0,533,0,4
4893,2020-04-14T00:00:00Z,CI,Côte d’Ivoire,AFRO,93,626,2,6
4894,2020-04-15T00:00:00Z,CI,Côte d’Ivoire,AFRO,12,638,0,6
4895,2020-04-16T00:00:00Z,CI,Côte d’Ivoire,AFRO,16,654,0,6
4896,2020-04-17T00:00:00Z,CI,Côte d’Ivoire,AFRO,34,688,0,6
4897,2020-04-18T00:00:00Z,CI,Côte d’Ivoire,AFRO,54,742,0,6
4898,2020-04-19T00:00:00Z,CI,Côte d’Ivoire,AFRO,0,742,0,6
4899,2020-04-20T00:00:00Z,CI,Côte d’Ivoire,AFRO,105,847,3,9
4900,2020-04-21T00:00:00Z,CI,Côte d’Ivoire,AFRO,32,879,1,10
4901,2020-04-22T00:00:00Z,CI,Côte d’Ivoire,AFRO,37,916,3,13
4902,2020-04-23T00:00:00Z,CI,Côte d’Ivoire,AFRO,36,952,1,14
4903,2020-04-24T00:00:00Z,CI,Côte d’Ivoire,AFRO,52,1004,0,14
4904,2020-04-25T00:00:00Z,CI,Côte d’Ivoire,AFRO,73,1077,0,14
4905,2020-04-26T00:00:00Z,CI,Côte d’Ivoire,AFRO,34,1111,0,14
4906,2020-04-27T00:00:00Z,CI,Côte d’Ivoire,AFRO,39,1150,0,14
4907,2020-04-28T00:00:00Z,CI,Côte d’Ivoire,AFRO,14,1164,0,14
4908,2020-04-29T00:00:00Z,CI,Côte d’Ivoire,AFRO,19,1183,0,14
4909,2020-04-30T00:00:00Z,CI,Côte d’Ivoire,AFRO,55,1238,0,14
4910,2020-05-01T00:00:00Z,CI,Côte d’Ivoire,AFRO,37,1275,0,14
4911,2020-05-02T00:00:00Z,CI,Côte d’Ivoire,AFRO,0,1275,0,14
4912,2020-05-03T00:00:00Z,CI,Côte d’Ivoire,AFRO,87,1362,1,15
4913,2020-05-04T00:00:00Z,CI,Côte d’Ivoire,AFRO,36,1398,2,17
4914,2020-05-05T00:00:00Z,CI,Côte d’Ivoire,AFRO,34,1432,0,17
4915,2020-05-06T00:00:00Z,CI,Côte d’Ivoire,AFRO,32,1464,1,18
4916,2020-05-07T00:00:00Z,CI,Côte d’Ivoire,AFRO,52,1516,0,18
4917,2020-05-08T00:00:00Z,CI,Côte d’Ivoire,AFRO,55,1571,2,20
4918,2020-05-09T00:00:00Z,CI,Côte d’Ivoire,AFRO,31,1602,0,20
4919,2020-05-10T00:00:00Z,CI,Côte d’Ivoire,AFRO,65,1667,1,21
4920,2020-05-11T00:00:00Z,CI,Côte d’Ivoire,AFRO,33,1700,0,21
4921,2020-05-12T00:00:00Z,CI,Côte d’Ivoire,AFRO,30,1730,0,21
4922,2020-05-13T00:00:00Z,CI,Côte d’Ivoire,AFRO,127,1857,0,21
4923,2020-05-14T00:00:00Z,CI,Côte d’Ivoire,AFRO,55,1912,3,24
4924,2020-05-15T00:00:00Z,CI,Côte d’Ivoire,AFRO,59,1971,0,24
4925,2020-05-16T00:00:00Z,CI,Côte d’Ivoire,AFRO,46,2017,0,24
4926,2020-05-17T00:00:00Z,CI,Côte d’Ivoire,AFRO,44,2061,1,25
4927,2020-05-18T00:00:00Z,CI,Côte d’Ivoire,AFRO,48,2109,2,27
4928,2020-05-19T00:00:00Z,CI,Côte d’Ivoire,AFRO,10,2119,1,28
4929,2020-05-20T00:00:00Z,CI,Côte d’Ivoire,AFRO,34,2153,0,28
4930,2020-05-21T00:00:00Z,CI,Côte d’Ivoire,AFRO,78,2231,1,29
4931,2020-05-22T00:00:00Z,CI,Côte d’Ivoire,AFRO,70,2301,0,29
4932,2020-05-23T00:00:00Z,CI,Côte d’Ivoire,AFRO,40,2341,0,29
4933,2020-05-24T00:00:00Z,CI,Côte d’Ivoire,AFRO,25,2366,1,30
4934,2020-05-25T00:00:00Z,CI,Côte d’Ivoire,AFRO,10,2376,0,30
4935,2020-05-26T00:00:00Z,CI,Côte d’Ivoire,AFRO,47,2423,0,30
4936,2020-05-27T00:00:00Z,CI,Côte d’Ivoire,AFRO,54,2477,0,30
4937,2020-05-28T00:00:00Z,CI,Côte d’Ivoire,AFRO,79,2556,1,31
4938,2020-05-29T00:00:00Z,CI,Côte d’Ivoire,AFRO,85,2641,1,32
4939,2020-05-30T00:00:00Z,CI,Côte d’Ivoire,AFRO,109,2750,0,32
4940,2020-05-31T00:00:00Z,CI,Côte d’Ivoire,AFRO,49,2799,1,33
4941,2020-06-01T00:00:00Z,CI,Côte d’Ivoire,AFRO,34,2833,0,33
4942,2020-06-02T00:00:00Z,CI,Côte d’Ivoire,AFRO,118,2951,0,33
4943,2020-06-03T00:00:00Z,CI,Côte d’Ivoire,AFRO,73,3024,0,33
4944,2020-06-04T00:00:00Z,CI,Côte d’Ivoire,AFRO,86,3110,2,35
4945,2020-06-05T00:00:00Z,CI,Côte d’Ivoire,AFRO,152,3262,0,35
4946,2020-06-06T00:00:00Z,CI,Côte d’Ivoire,AFRO,169,3431,1,36
4947,2020-06-07T00:00:00Z,CI,Côte d’Ivoire,AFRO,126,3557,0,36
4948,2020-06-08T00:00:00Z,CI,Côte d’Ivoire,AFRO,182,3739,0,36
4949,2020-06-09T00:00:00Z,CI,Côte d’Ivoire,AFRO,142,3881,2,38
4950,2020-06-10T00:00:00Z,CI,Côte d’Ivoire,AFRO,114,3995,0,38
4951,2020-06-11T00:00:00Z,CI,Côte d’Ivoire,AFRO,186,4181,3,41
4952,2020-06-12T00:00:00Z,CI,Côte d’Ivoire,AFRO,223,4404,0,41
4953,2020-06-13T00:00:00Z,CI,Côte d’Ivoire,AFRO,280,4684,4,45
4954,2020-06-14T00:00:00Z,CI,Côte d’Ivoire,AFRO,164,4848,0,45
4955,2020-06-15T00:00:00Z,CI,Côte d’Ivoire,AFRO,236,5084,0,45
4956,2020-06-16T00:00:00Z,CI,Côte d’Ivoire,AFRO,0,5084,0,45
4957,2020-06-17T00:00:00Z,CI,Côte d’Ivoire,AFRO,595,5679,1,46
4958,2020-06-18T00:00:00Z,CI,Côte d’Ivoire,AFRO,384,6063,2,48
4959,2020-06-19T00:00:00Z,CI,Côte d’Ivoire,AFRO,381,6444,1,49
4960,2020-06-20T00:00:00Z,CI,Côte d’Ivoire,AFRO,430,6874,0,49
5494,2020-03-11T00:00:00Z,CD,Democratic Republic of the Congo,AFRO,1,1,0,0
5495,2020-03-12T00:00:00Z,CD,Democratic Republic of the Congo,AFRO,0,1,0,0
5496,2020-03-13T00:00:00Z,CD,Democratic Republic of the Congo,AFRO,0,1,0,0
5497,2020-03-14T00:00:00Z,CD,Democratic Republic of the Congo,AFRO,1,2,0,0
5498,2020-03-15T00:00:00Z,CD,Democratic Republic of the Congo,AFRO,0,2,0,0
5499,2020-03-16T00:00:00Z,CD,Democratic Republic of the Congo,AFRO,0,2,0,0
5500,2020-03-17T00:00:00Z,CD,Democratic Republic of the Congo,AFRO,1,3,0,0
5501,2020-03-18T00:00:00Z,CD,Democratic Republic of the Congo,AFRO,4,7,0,0
5502,2020-03-19T00:00:00Z,CD,Democratic Republic of the Congo,AFRO,7,14,0,0
5503,2020-03-20T00:00:00Z,CD,Democratic Republic of the Congo,AFRO,0,14,0,0
5504,2020-03-21T00:00:00Z,CD,Democratic Republic of the Congo,AFRO,9,23,1,1
5505,2020-03-22T00:00:00Z,CD,Democratic Republic of the Congo,AFRO,0,23,0,1
5506,2020-03-23T00:00:00Z,CD,Democratic Republic of the Congo,AFRO,7,30,1,2
5507,2020-03-24T00:00:00Z,CD,Democratic Republic of the Congo,AFRO,6,36,0,2
5508,2020-03-25T00:00:00Z,CD,Democratic Republic of the Congo,AFRO,9,45,0,2
5509,2020-03-26T00:00:00Z,CD,Democratic Republic of the Congo,AFRO,6,51,1,3
5510,2020-03-27T00:00:00Z,CD,Democratic Republic of the Congo,AFRO,3,54,1,4
5511,2020-03-28T00:00:00Z,CD,Democratic Republic of the Congo,AFRO,4,58,1,5
5512,2020-03-29T00:00:00Z,CD,Democratic Republic of the Congo,AFRO,10,68,1,6
5513,2020-03-30T00:00:00Z,CD,Democratic Republic of the Congo,AFRO,13,81,2,8
5514,2020-03-31T00:00:00Z,CD,Democratic Republic of the Congo,AFRO,17,98,0,8
5515,2020-04-01T00:00:00Z,CD,Democratic Republic of the Congo,AFRO,11,109,1,9
5516,2020-04-02T00:00:00Z,CD,Democratic Republic of the Congo,AFRO,14,123,2,11
5517,2020-04-03T00:00:00Z,CD,Democratic Republic of the Congo,AFRO,11,134,2,13
5518,2020-04-04T00:00:00Z,CD,Democratic Republic of the Congo,AFRO,14,148,3,16
5519,2020-04-05T00:00:00Z,CD,Democratic Republic of the Congo,AFRO,0,148,0,16
5520,2020-04-06T00:00:00Z,CD,Democratic Republic of the Congo,AFRO,13,161,2,18
5521,2020-04-07T00:00:00Z,CD,Democratic Republic of the Congo,AFRO,0,161,0,18
5522,2020-04-08T00:00:00Z,CD,Democratic Republic of the Congo,AFRO,22,183,2,20
5523,2020-04-09T00:00:00Z,CD,Democratic Republic of the Congo,AFRO,24,207,0,20
5524,2020-04-10T00:00:00Z,CD,Democratic Republic of the Congo,AFRO,8,215,0,20
5525,2020-04-11T00:00:00Z,CD,Democratic Republic of the Congo,AFRO,0,215,0,20
5526,2020-04-12T00:00:00Z,CD,Democratic Republic of the Congo,AFRO,8,223,0,20
5527,2020-04-13T00:00:00Z,CD,Democratic Republic of the Congo,AFRO,12,235,0,20
5528,2020-04-14T00:00:00Z,CD,Democratic Republic of the Congo,AFRO,6,241,0,20
5529,2020-04-15T00:00:00Z,CD,Democratic Republic of the Congo,AFRO,13,254,1,21
5530,2020-04-16T00:00:00Z,CD,Democratic Republic of the Congo,AFRO,13,267,1,22
5531,2020-04-17T00:00:00Z,CD,Democratic Republic of the Congo,AFRO,20,287,1,23
5532,2020-04-18T00:00:00Z,CD,Democratic Republic of the Congo,AFRO,0,287,0,23
5533,2020-04-19T00:00:00Z,CD,Democratic Republic of the Congo,AFRO,40,327,2,25
5534,2020-04-20T00:00:00Z,CD,Democratic Republic of the Congo,AFRO,5,332,0,25
5535,2020-04-21T00:00:00Z,CD,Democratic Republic of the Congo,AFRO,18,350,0,25
5536,2020-04-22T00:00:00Z,CD,Democratic Republic of the Congo,AFRO,9,359,0,25
5537,2020-04-23T00:00:00Z,CD,Democratic Republic of the Congo,AFRO,0,359,0,25
5538,2020-04-24T00:00:00Z,CD,Democratic Republic of the Congo,AFRO,35,394,0,25
5539,2020-04-25T00:00:00Z,CD,Democratic Republic of the Congo,AFRO,22,416,3,28
5540,2020-04-26T00:00:00Z,CD,Democratic Republic of the Congo,AFRO,26,442,0,28
5541,2020-04-27T00:00:00Z,CD,Democratic Republic of the Congo,AFRO,17,459,0,28
5542,2020-04-28T00:00:00Z,CD,Democratic Republic of the Congo,AFRO,12,471,2,30
5543,2020-04-29T00:00:00Z,CD,Democratic Republic of the Congo,AFRO,20,491,0,30
5544,2020-04-30T00:00:00Z,CD,Democratic Republic of the Congo,AFRO,9,500,1,31
5545,2020-05-01T00:00:00Z,CD,Democratic Republic of the Congo,AFRO,72,572,0,31
5546,2020-05-02T00:00:00Z,CD,Democratic Republic of the Congo,AFRO,32,604,1,32
5547,2020-05-03T00:00:00Z,CD,Democratic Republic of the Congo,AFRO,70,674,1,33
5548,2020-05-04T00:00:00Z,CD,Democratic Republic of the Congo,AFRO,8,682,1,34
5549,2020-05-05T00:00:00Z,CD,Democratic Republic of the Congo,AFRO,0,682,0,34
5550,2020-05-06T00:00:00Z,CD,Democratic Republic of the Congo,AFRO,23,705,0,34
5551,2020-05-07T00:00:00Z,CD,Democratic Republic of the Congo,AFRO,92,797,1,35
5552,2020-05-08T00:00:00Z,CD,Democratic Republic of the Congo,AFRO,100,897,1,36
5553,2020-05-09T00:00:00Z,CD,Democratic Republic of the Congo,AFRO,40,937,3,39
5554,2020-05-10T00:00:00Z,CD,Democratic Republic of the Congo,AFRO,54,991,2,41
5555,2020-05-11T00:00:00Z,CD,Democratic Republic of the Congo,AFRO,33,1024,0,41
5556,2020-05-12T00:00:00Z,CD,Democratic Republic of the Congo,AFRO,78,1102,3,44
5557,2020-05-13T00:00:00Z,CD,Democratic Republic of the Congo,AFRO,67,1169,6,50
5558,2020-05-14T00:00:00Z,CD,Democratic Republic of the Congo,AFRO,73,1242,0,50
5559,2020-05-15T00:00:00Z,CD,Democratic Republic of the Congo,AFRO,56,1298,0,50
5560,2020-05-16T00:00:00Z,CD,Democratic Republic of the Congo,AFRO,71,1369,10,60
5561,2020-05-17T00:00:00Z,CD,Democratic Republic of the Congo,AFRO,85,1454,0,60
5562,2020-05-18T00:00:00Z,CD,Democratic Republic of the Congo,AFRO,0,1454,0,60
5563,2020-05-19T00:00:00Z,CD,Democratic Republic of the Congo,AFRO,83,1537,0,60
5564,2020-05-20T00:00:00Z,CD,Democratic Republic of the Congo,AFRO,193,1730,0,60
5565,2020-05-21T00:00:00Z,CD,Democratic Republic of the Congo,AFRO,104,1834,0,60
5566,2020-05-22T00:00:00Z,CD,Democratic Republic of the Congo,AFRO,110,1944,2,62
5567,2020-05-23T00:00:00Z,CD,Democratic Republic of the Congo,AFRO,0,1944,0,62
5568,2020-05-24T00:00:00Z,CD,Democratic Republic of the Congo,AFRO,196,2140,0,62
5569,2020-05-25T00:00:00Z,CD,Democratic Republic of the Congo,AFRO,0,2140,0,62
5570,2020-05-26T00:00:00Z,CD,Democratic Republic of the Congo,AFRO,164,2304,4,66
5571,2020-05-27T00:00:00Z,CD,Democratic Republic of the Congo,AFRO,98,2402,1,67
5572,2020-05-28T00:00:00Z,CD,Democratic Republic of the Congo,AFRO,257,2659,1,68
5573,2020-05-29T00:00:00Z,CD,Democratic Republic of the Congo,AFRO,173,2832,0,68
5574,2020-05-30T00:00:00Z,CD,Democratic Republic of the Congo,AFRO,0,2832,0,68
5575,2020-05-31T00:00:00Z,CD,Democratic Republic of the Congo,AFRO,133,2965,0,68
5576,2020-06-01T00:00:00Z,CD,Democratic Republic of the Congo,AFRO,83,3048,3,71
5577,2020-06-02T00:00:00Z,CD,Democratic Republic of the Congo,AFRO,146,3194,0,71
5578,2020-06-03T00:00:00Z,CD,Democratic Republic of the Congo,AFRO,131,3325,0,71
5579,2020-06-04T00:00:00Z,CD,Democratic Republic of the Congo,AFRO,169,3494,3,74
5580,2020-06-05T00:00:00Z,CD,Democratic Republic of the Congo,AFRO,149,3643,3,77
5581,2020-06-06T00:00:00Z,CD,Democratic Republic of the Congo,AFRO,120,3763,3,80
5582,2020-06-07T00:00:00Z,CD,Democratic Republic of the Congo,AFRO,114,3877,1,81
5583,2020-06-08T00:00:00Z,CD,Democratic Republic of the Congo,AFRO,138,4015,3,84
5584,2020-06-09T00:00:00Z,CD,Democratic Republic of the Congo,AFRO,90,4105,3,87
5585,2020-06-10T00:00:00Z,CD,Democratic Republic of the Congo,AFRO,153,4258,3,90
5586,2020-06-11T00:00:00Z,CD,Democratic Republic of the Congo,AFRO,131,4389,6,96
5587,2020-06-12T00:00:00Z,CD,Democratic Republic of the Congo,AFRO,125,4514,1,97
5588,2020-06-13T00:00:00Z,CD,Democratic Republic of the Congo,AFRO,122,4636,3,100
5589,2020-06-14T00:00:00Z,CD,Democratic Republic of the Congo,AFRO,87,4723,5,105
5590,2020-06-15T00:00:00Z,CD,Democratic Republic of the Congo,AFRO,54,4777,1,106
5591,2020-06-16T00:00:00Z,CD,Democratic Republic of the Congo,AFRO,0,4777,0,106
5592,2020-06-17T00:00:00Z,CD,Democratic Republic of the Congo,AFRO,196,4973,5,111
5593,2020-06-18T00:00:00Z,CD,Democratic Republic of the Congo,AFRO,126,5099,3,114
5594,2020-06-19T00:00:00Z,CD,Democratic Republic of the Congo,AFRO,183,5282,2,116
5595,2020-06-20T00:00:00Z,CD,Democratic Republic of the Congo,AFRO,194,5476,5,121
6341,2020-03-14T00:00:00Z,GQ,Equatorial Guinea,AFRO,1,1,0,0
6342,2020-03-15T00:00:00Z,GQ,Equatorial Guinea,AFRO,0,1,0,0
6343,2020-03-16T00:00:00Z,GQ,Equatorial Guinea,AFRO,0,1,0,0
6344,2020-03-17T00:00:00Z,GQ,Equatorial Guinea,AFRO,0,1,0,0
6345,2020-03-18T00:00:00Z,GQ,Equatorial Guinea,AFRO,2,3,0,0
6346,2020-03-19T00:00:00Z,GQ,Equatorial Guinea,AFRO,1,4,0,0
6347,2020-03-20T00:00:00Z,GQ,Equatorial Guinea,AFRO,0,4,0,0
6348,2020-03-21T00:00:00Z,GQ,Equatorial Guinea,AFRO,2,6,0,0
6349,2020-03-22T00:00:00Z,GQ,Equatorial Guinea,AFRO,0,6,0,0
6350,2020-03-23T00:00:00Z,GQ,Equatorial Guinea,AFRO,0,6,0,0
6351,2020-03-24T00:00:00Z,GQ,Equatorial Guinea,AFRO,0,6,0,0
6352,2020-03-25T00:00:00Z,GQ,Equatorial Guinea,AFRO,0,6,0,0
6353,2020-03-26T00:00:00Z,GQ,Equatorial Guinea,AFRO,0,6,0,0
6354,2020-03-27T00:00:00Z,GQ,Equatorial Guinea,AFRO,0,6,0,0
6355,2020-03-28T00:00:00Z,GQ,Equatorial Guinea,AFRO,0,6,0,0
6356,2020-03-29T00:00:00Z,GQ,Equatorial Guinea,AFRO,0,6,0,0
6357,2020-03-30T00:00:00Z,GQ,Equatorial Guinea,AFRO,7,13,0,0
6358,2020-03-31T00:00:00Z,GQ,Equatorial Guinea,AFRO,1,14,0,0
6359,2020-04-01T00:00:00Z,GQ,Equatorial Guinea,AFRO,0,14,0,0
6360,2020-04-02T00:00:00Z,GQ,Equatorial Guinea,AFRO,1,15,0,0
6361,2020-04-03T00:00:00Z,GQ,Equatorial Guinea,AFRO,0,15,0,0
6362,2020-04-04T00:00:00Z,GQ,Equatorial Guinea,AFRO,0,15,0,0
6363,2020-04-05T00:00:00Z,GQ,Equatorial Guinea,AFRO,1,16,0,0
6364,2020-04-06T00:00:00Z,GQ,Equatorial Guinea,AFRO,0,16,0,0
6365,2020-04-07T00:00:00Z,GQ,Equatorial Guinea,AFRO,0,16,0,0
6366,2020-04-08T00:00:00Z,GQ,Equatorial Guinea,AFRO,0,16,0,0
6367,2020-04-09T00:00:00Z,GQ,Equatorial Guinea,AFRO,0,16,0,0
6368,2020-04-10T00:00:00Z,GQ,Equatorial Guinea,AFRO,2,18,0,0
6369,2020-04-11T00:00:00Z,GQ,Equatorial Guinea,AFRO,0,18,0,0
6370,2020-04-12T00:00:00Z,GQ,Equatorial Guinea,AFRO,0,18,0,0
6371,2020-04-13T00:00:00Z,GQ,Equatorial Guinea,AFRO,0,18,0,0
6372,2020-04-14T00:00:00Z,GQ,Equatorial Guinea,AFRO,3,21,0,0
6373,2020-04-15T00:00:00Z,GQ,Equatorial Guinea,AFRO,20,41,0,0
6374,2020-04-16T00:00:00Z,GQ,Equatorial Guinea,AFRO,10,51,0,0
6375,2020-04-17T00:00:00Z,GQ,Equatorial Guinea,AFRO,0,51,0,0
6376,2020-04-18T00:00:00Z,GQ,Equatorial Guinea,AFRO,0,51,0,0
6377,2020-04-19T00:00:00Z,GQ,Equatorial Guinea,AFRO,28,79,0,0
6378,2020-04-20T00:00:00Z,GQ,Equatorial Guinea,AFRO,0,79,0,0
6379,2020-04-21T00:00:00Z,GQ,Equatorial Guinea,AFRO,0,79,0,0
6380,2020-04-22T00:00:00Z,GQ,Equatorial Guinea,AFRO,0,79,0,0
6381,2020-04-23T00:00:00Z,GQ,Equatorial Guinea,AFRO,5,84,1,1
6382,2020-04-24T00:00:00Z,GQ,Equatorial Guinea,AFRO,0,84,0,1
6383,2020-04-25T00:00:00Z,GQ,Equatorial Guinea,AFRO,128,212,0,1
6384,2020-04-26T00:00:00Z,GQ,Equatorial Guinea,AFRO,46,258,0,1
6385,2020-04-27T00:00:00Z,GQ,Equatorial Guinea,AFRO,0,258,0,1
6386,2020-04-28T00:00:00Z,GQ,Equatorial Guinea,AFRO,0,258,0,1
6387,2020-04-29T00:00:00Z,GQ,Equatorial Guinea,AFRO,57,315,0,1
6388,2020-04-30T00:00:00Z,GQ,Equatorial Guinea,AFRO,0,315,0,1
6389,2020-05-01T00:00:00Z,GQ,Equatorial Guinea,AFRO,0,315,1,2
6390,2020-05-02T00:00:00Z,GQ,Equatorial Guinea,AFRO,0,315,0,2
6391,2020-05-03T00:00:00Z,GQ,Equatorial Guinea,AFRO,0,315,0,2
6392,2020-05-04T00:00:00Z,GQ,Equatorial Guinea,AFRO,0,315,0,2
6393,2020-05-05T00:00:00Z,GQ,Equatorial Guinea,AFRO,0,315,0,2
6394,2020-05-06T00:00:00Z,GQ,Equatorial Guinea,AFRO,124,439,2,4
6395,2020-05-07T00:00:00Z,GQ,Equatorial Guinea,AFRO,0,439,0,4
6396,2020-05-08T00:00:00Z,GQ,Equatorial Guinea,AFRO,0,439,0,4
6397,2020-05-09T00:00:00Z,GQ,Equatorial Guinea,AFRO,0,439,0,4
6398,2020-05-10T00:00:00Z,GQ,Equatorial Guinea,AFRO,0,439,0,4
6399,2020-05-11T00:00:00Z,GQ,Equatorial Guinea,AFRO,0,439,0,4
6400,2020-05-12T00:00:00Z,GQ,Equatorial Guinea,AFRO,0,439,0,4
6401,2020-05-13T00:00:00Z,GQ,Equatorial Guinea,AFRO,83,522,2,6
6402,2020-05-14T00:00:00Z,GQ,Equatorial Guinea,AFRO,61,583,1,7
6403,2020-05-15T00:00:00Z,GQ,Equatorial Guinea,AFRO,11,594,0,7
6404,2020-05-16T00:00:00Z,GQ,Equatorial Guinea,AFRO,0,594,0,7
6405,2020-05-17T00:00:00Z,GQ,Equatorial Guinea,AFRO,96,690,0,7
6406,2020-05-18T00:00:00Z,GQ,Equatorial Guinea,AFRO,29,719,0,7
6407,2020-05-19T00:00:00Z,GQ,Equatorial Guinea,AFRO,106,825,0,7
6408,2020-05-20T00:00:00Z,GQ,Equatorial Guinea,AFRO,65,890,0,7
6409,2020-05-21T00:00:00Z,GQ,Equatorial Guinea,AFRO,13,903,3,10
6410,2020-05-22T00:00:00Z,GQ,Equatorial Guinea,AFRO,57,960,1,11
6411,2020-05-23T00:00:00Z,GQ,Equatorial Guinea,AFRO,0,960,0,11
6412,2020-05-24T00:00:00Z,GQ,Equatorial Guinea,AFRO,83,1043,1,12
6413,2020-05-25T00:00:00Z,GQ,Equatorial Guinea,AFRO,0,1043,0,12
6414,2020-05-26T00:00:00Z,GQ,Equatorial Guinea,AFRO,0,1043,0,12
6415,2020-05-27T00:00:00Z,GQ,Equatorial Guinea,AFRO,0,1043,0,12
6416,2020-05-28T00:00:00Z,GQ,Equatorial Guinea,AFRO,0,1043,0,12
6417,2020-05-29T00:00:00Z,GQ,Equatorial Guinea,AFRO,0,1043,0,12
6418,2020-05-30T00:00:00Z,GQ,Equatorial Guinea,AFRO,0,1043,0,12
6419,2020-05-31T00:00:00Z,GQ,Equatorial Guinea,AFRO,0,1043,0,12
6420,2020-06-01T00:00:00Z,GQ,Equatorial Guinea,AFRO,0,1043,0,12
6421,2020-06-02T00:00:00Z,GQ,Equatorial Guinea,AFRO,0,1043,0,12
6422,2020-06-03T00:00:00Z,GQ,Equatorial Guinea,AFRO,0,1043,0,12
6423,2020-06-04T00:00:00Z,GQ,Equatorial Guinea,AFRO,0,1043,0,12
6424,2020-06-05T00:00:00Z,GQ,Equatorial Guinea,AFRO,0,1043,0,12
6425,2020-06-06T00:00:00Z,GQ,Equatorial Guinea,AFRO,0,1043,0,12
6426,2020-06-07T00:00:00Z,GQ,Equatorial Guinea,AFRO,0,1043,0,12
6427,2020-06-08T00:00:00Z,GQ,Equatorial Guinea,AFRO,0,1043,0,12
6428,2020-06-09T00:00:00Z,GQ,Equatorial Guinea,AFRO,0,1043,0,12
6429,2020-06-10T00:00:00Z,GQ,Equatorial Guinea,AFRO,0,1043,0,12
6430,2020-06-11T00:00:00Z,GQ,Equatorial Guinea,AFRO,0,1043,0,12
6431,2020-06-12T00:00:00Z,GQ,Equatorial Guinea,AFRO,0,1043,0,12
6432,2020-06-13T00:00:00Z,GQ,Equatorial Guinea,AFRO,0,1043,0,12
6433,2020-06-14T00:00:00Z,GQ,Equatorial Guinea,AFRO,0,1043,0,12
6434,2020-06-15T00:00:00Z,GQ,Equatorial Guinea,AFRO,0,1043,0,12
6435,2020-06-16T00:00:00Z,GQ,Equatorial Guinea,AFRO,0,1043,0,12
6436,2020-06-17T00:00:00Z,GQ,Equatorial Guinea,AFRO,0,1043,0,12
6437,2020-06-18T00:00:00Z,GQ,Equatorial Guinea,AFRO,0,1043,0,12
6438,2020-06-19T00:00:00Z,GQ,Equatorial Guinea,AFRO,0,1043,0,12
6439,2020-06-20T00:00:00Z,GQ,Equatorial Guinea,AFRO,0,1043,0,12
6440,2020-03-21T00:00:00Z,ER,Eritrea,AFRO,1,1,0,0
6441,2020-03-22T00:00:00Z,ER,Eritrea,AFRO,0,1,0,0
6442,2020-03-23T00:00:00Z,ER,Eritrea,AFRO,0,1,0,0
6443,2020-03-24T00:00:00Z,ER,Eritrea,AFRO,0,1,0,0
6444,2020-03-25T00:00:00Z,ER,Eritrea,AFRO,0,1,0,0
6445,2020-03-26T00:00:00Z,ER,Eritrea,AFRO,3,4,0,0
6446,2020-03-27T00:00:00Z,ER,Eritrea,AFRO,2,6,0,0
6447,2020-03-28T00:00:00Z,ER,Eritrea,AFRO,0,6,0,0
6448,2020-03-29T00:00:00Z,ER,Eritrea,AFRO,0,6,0,0
6449,2020-03-30T00:00:00Z,ER,Eritrea,AFRO,0,6,0,0
6450,2020-03-31T00:00:00Z,ER,Eritrea,AFRO,0,6,0,0
6451,2020-04-01T00:00:00Z,ER,Eritrea,AFRO,0,6,0,0
6452,2020-04-02T00:00:00Z,ER,Eritrea,AFRO,9,15,0,0
6453,2020-04-03T00:00:00Z,ER,Eritrea,AFRO,5,20,0,0
6454,2020-04-04T00:00:00Z,ER,Eritrea,AFRO,0,20,0,0
6455,2020-04-05T00:00:00Z,ER,Eritrea,AFRO,0,20,0,0
6456,2020-04-06T00:00:00Z,ER,Eritrea,AFRO,9,29,0,0
6457,2020-04-07T00:00:00Z,ER,Eritrea,AFRO,0,29,0,0
6458,2020-04-08T00:00:00Z,ER,Eritrea,AFRO,2,31,0,0
6459,2020-04-09T00:00:00Z,ER,Eritrea,AFRO,2,33,0,0
6460,2020-04-10T00:00:00Z,ER,Eritrea,AFRO,0,33,0,0
6461,2020-04-11T00:00:00Z,ER,Eritrea,AFRO,0,33,0,0
6462,2020-04-12T00:00:00Z,ER,Eritrea,AFRO,0,33,0,0
6463,2020-04-13T00:00:00Z,ER,Eritrea,AFRO,1,34,0,0
6464,2020-04-14T00:00:00Z,ER,Eritrea,AFRO,0,34,0,0
6465,2020-04-15T00:00:00Z,ER,Eritrea,AFRO,0,34,0,0
6466,2020-04-16T00:00:00Z,ER,Eritrea,AFRO,1,35,0,0
6467,2020-04-17T00:00:00Z,ER,Eritrea,AFRO,0,35,0,0
6468,2020-04-18T00:00:00Z,ER,Eritrea,AFRO,0,35,0,0
6469,2020-04-19T00:00:00Z,ER,Eritrea,AFRO,4,39,0,0
6470,2020-04-20T00:00:00Z,ER,Eritrea,AFRO,0,39,0,0
6471,2020-04-21T00:00:00Z,ER,Eritrea,AFRO,0,39,0,0
6472,2020-04-22T00:00:00Z,ER,Eritrea,AFRO,0,39,0,0
6473,2020-04-23T00:00:00Z,ER,Eritrea,AFRO,0,39,0,0
6474,2020-04-24T00:00:00Z,ER,Eritrea,AFRO,0,39,0,0
6475,2020-04-25T00:00:00Z,ER,Eritrea,AFRO,0,39,0,0
6476,2020-04-26T00:00:00Z,ER,Eritrea,AFRO,0,39,0,0
6477,2020-04-27T00:00:00Z,ER,Eritrea,AFRO,0,39,0,0
6478,2020-04-28T00:00:00Z,ER,Eritrea,AFRO,0,39,0,0
6479,2020-04-29T00:00:00Z,ER,Eritrea,AFRO,0,39,0,0
6480,2020-04-30T00:00:00Z,ER,Eritrea,AFRO,0,39,0,0
6481,2020-05-01T00:00:00Z,ER,Eritrea,AFRO,0,39,0,0
6482,2020-05-02T00:00:00Z,ER,Eritrea,AFRO,0,39,0,0
6483,2020-05-03T00:00:00Z,ER,Eritrea,AFRO,0,39,0,0
6484,2020-05-04T00:00:00Z,ER,Eritrea,AFRO,0,39,0,0
6485,2020-05-05T00:00:00Z,ER,Eritrea,AFRO,0,39,0,0
6486,2020-05-06T00:00:00Z,ER,Eritrea,AFRO,0,39,0,0
6487,2020-05-07T00:00:00Z,ER,Eritrea,AFRO,0,39,0,0
6488,2020-05-08T00:00:00Z,ER,Eritrea,AFRO,0,39,0,0
6489,2020-05-09T00:00:00Z,ER,Eritrea,AFRO,0,39,0,0
6490,2020-05-10T00:00:00Z,ER,Eritrea,AFRO,0,39,0,0
6491,2020-05-11T00:00:00Z,ER,Eritrea,AFRO,0,39,0,0
6492,2020-05-12T00:00:00Z,ER,Eritrea,AFRO,0,39,0,0
6493,2020-05-13T00:00:00Z,ER,Eritrea,AFRO,0,39,0,0
6494,2020-05-14T00:00:00Z,ER,Eritrea,AFRO,0,39,0,0
6495,2020-05-15T00:00:00Z,ER,Eritrea,AFRO,0,39,0,0
6496,2020-05-16T00:00:00Z,ER,Eritrea,AFRO,0,39,0,0
6497,2020-05-17T00:00:00Z,ER,Eritrea,AFRO,0,39,0,0
6498,2020-05-18T00:00:00Z,ER,Eritrea,AFRO,0,39,0,0
6499,2020-05-19T00:00:00Z,ER,Eritrea,AFRO,0,39,0,0
6500,2020-05-20T00:00:00Z,ER,Eritrea,AFRO,0,39,0,0
6501,2020-05-21T00:00:00Z,ER,Eritrea,AFRO,0,39,0,0
6502,2020-05-22T00:00:00Z,ER,Eritrea,AFRO,0,39,0,0
6503,2020-05-23T00:00:00Z,ER,Eritrea,AFRO,0,39,0,0
6504,2020-05-24T00:00:00Z,ER,Eritrea,AFRO,0,39,0,0
6505,2020-05-25T00:00:00Z,ER,Eritrea,AFRO,0,39,0,0
6506,2020-05-26T00:00:00Z,ER,Eritrea,AFRO,0,39,0,0
6507,2020-05-27T00:00:00Z,ER,Eritrea,AFRO,0,39,0,0
6508,2020-05-28T00:00:00Z,ER,Eritrea,AFRO,0,39,0,0
6509,2020-05-29T00:00:00Z,ER,Eritrea,AFRO,0,39,0,0
6510,2020-05-30T00:00:00Z,ER,Eritrea,AFRO,0,39,0,0
6511,2020-05-31T00:00:00Z,ER,Eritrea,AFRO,0,39,0,0
6512,2020-06-01T00:00:00Z,ER,Eritrea,AFRO,0,39,0,0
6513,2020-06-02T00:00:00Z,ER,Eritrea,AFRO,0,39,0,0
6514,2020-06-03T00:00:00Z,ER,Eritrea,AFRO,0,39,0,0
6515,2020-06-04T00:00:00Z,ER,Eritrea,AFRO,0,39,0,0
6516,2020-06-05T00:00:00Z,ER,Eritrea,AFRO,2,41,0,0
6517,2020-06-06T00:00:00Z,ER,Eritrea,AFRO,0,41,0,0
6518,2020-06-07T00:00:00Z,ER,Eritrea,AFRO,0,41,0,0
6519,2020-06-08T00:00:00Z,ER,Eritrea,AFRO,0,41,0,0
6520,2020-06-09T00:00:00Z,ER,Eritrea,AFRO,0,41,0,0
6521,2020-06-10T00:00:00Z,ER,Eritrea,AFRO,0,41,0,0
6522,2020-06-11T00:00:00Z,ER,Eritrea,AFRO,0,41,0,0
6523,2020-06-12T00:00:00Z,ER,Eritrea,AFRO,0,41,0,0
6524,2020-06-13T00:00:00Z,ER,Eritrea,AFRO,0,41,0,0
6525,2020-06-14T00:00:00Z,ER,Eritrea,AFRO,24,65,0,0
6526,2020-06-15T00:00:00Z,ER,Eritrea,AFRO,31,96,0,0
6527,2020-06-16T00:00:00Z,ER,Eritrea,AFRO,13,109,0,0
6528,2020-06-17T00:00:00Z,ER,Eritrea,AFRO,12,121,0,0
6529,2020-06-18T00:00:00Z,ER,Eritrea,AFRO,10,131,0,0
6530,2020-06-19T00:00:00Z,ER,Eritrea,AFRO,11,142,0,0
6531,2020-06-20T00:00:00Z,ER,Eritrea,AFRO,0,142,0,0
6647,2020-03-14T00:00:00Z,SZ,Eswatini,AFRO,1,1,0,0
6648,2020-03-15T00:00:00Z,SZ,Eswatini,AFRO,0,1,0,0
6649,2020-03-16T00:00:00Z,SZ,Eswatini,AFRO,0,1,0,0
6650,2020-03-17T00:00:00Z,SZ,Eswatini,AFRO,0,1,0,0
6651,2020-03-18T00:00:00Z,SZ,Eswatini,AFRO,0,1,0,0
6652,2020-03-19T00:00:00Z,SZ,Eswatini,AFRO,0,1,0,0
6653,2020-03-20T00:00:00Z,SZ,Eswatini,AFRO,0,1,0,0
6654,2020-03-21T00:00:00Z,SZ,Eswatini,AFRO,0,1,0,0
6655,2020-03-22T00:00:00Z,SZ,Eswatini,AFRO,0,1,0,0
6656,2020-03-23T00:00:00Z,SZ,Eswatini,AFRO,3,4,0,0
6657,2020-03-24T00:00:00Z,SZ,Eswatini,AFRO,0,4,0,0
6658,2020-03-25T00:00:00Z,SZ,Eswatini,AFRO,0,4,0,0
6659,2020-03-26T00:00:00Z,SZ,Eswatini,AFRO,0,4,0,0
6660,2020-03-27T00:00:00Z,SZ,Eswatini,AFRO,2,6,0,0
6661,2020-03-28T00:00:00Z,SZ,Eswatini,AFRO,3,9,0,0
6662,2020-03-29T00:00:00Z,SZ,Eswatini,AFRO,0,9,0,0
6663,2020-03-30T00:00:00Z,SZ,Eswatini,AFRO,0,9,0,0
6664,2020-03-31T00:00:00Z,SZ,Eswatini,AFRO,0,9,0,0
6665,2020-04-01T00:00:00Z,SZ,Eswatini,AFRO,0,9,0,0
6666,2020-04-02T00:00:00Z,SZ,Eswatini,AFRO,0,9,0,0
6667,2020-04-03T00:00:00Z,SZ,Eswatini,AFRO,0,9,0,0
6668,2020-04-04T00:00:00Z,SZ,Eswatini,AFRO,0,9,0,0
6669,2020-04-05T00:00:00Z,SZ,Eswatini,AFRO,0,9,0,0
6670,2020-04-06T00:00:00Z,SZ,Eswatini,AFRO,0,9,0,0
6671,2020-04-07T00:00:00Z,SZ,Eswatini,AFRO,0,9,0,0
6672,2020-04-08T00:00:00Z,SZ,Eswatini,AFRO,1,10,0,0
6673,2020-04-09T00:00:00Z,SZ,Eswatini,AFRO,2,12,0,0
6674,2020-04-10T00:00:00Z,SZ,Eswatini,AFRO,0,12,0,0
6675,2020-04-11T00:00:00Z,SZ,Eswatini,AFRO,0,12,0,0
6676,2020-04-12T00:00:00Z,SZ,Eswatini,AFRO,0,12,0,0
6677,2020-04-13T00:00:00Z,SZ,Eswatini,AFRO,2,14,0,0
6678,2020-04-14T00:00:00Z,SZ,Eswatini,AFRO,0,14,0,0
6679,2020-04-15T00:00:00Z,SZ,Eswatini,AFRO,1,15,0,0
6680,2020-04-16T00:00:00Z,SZ,Eswatini,AFRO,1,16,0,0
6681,2020-04-17T00:00:00Z,SZ,Eswatini,AFRO,0,16,1,1
6682,2020-04-18T00:00:00Z,SZ,Eswatini,AFRO,3,19,0,1
6683,2020-04-19T00:00:00Z,SZ,Eswatini,AFRO,3,22,0,1
6684,2020-04-20T00:00:00Z,SZ,Eswatini,AFRO,0,22,0,1
6685,2020-04-21T00:00:00Z,SZ,Eswatini,AFRO,2,24,0,1
6686,2020-04-22T00:00:00Z,SZ,Eswatini,AFRO,0,24,0,1
6687,2020-04-23T00:00:00Z,SZ,Eswatini,AFRO,7,31,0,1
6688,2020-04-24T00:00:00Z,SZ,Eswatini,AFRO,0,31,0,1
6689,2020-04-25T00:00:00Z,SZ,Eswatini,AFRO,9,40,0,1
6690,2020-04-26T00:00:00Z,SZ,Eswatini,AFRO,16,56,0,1
6691,2020-04-27T00:00:00Z,SZ,Eswatini,AFRO,3,59,0,1
6692,2020-04-28T00:00:00Z,SZ,Eswatini,AFRO,6,65,0,1
6693,2020-04-29T00:00:00Z,SZ,Eswatini,AFRO,6,71,0,1
6694,2020-04-30T00:00:00Z,SZ,Eswatini,AFRO,20,91,0,1
6695,2020-05-01T00:00:00Z,SZ,Eswatini,AFRO,9,100,0,1
6696,2020-05-02T00:00:00Z,SZ,Eswatini,AFRO,6,106,0,1
6697,2020-05-03T00:00:00Z,SZ,Eswatini,AFRO,2,108,0,1
6698,2020-05-04T00:00:00Z,SZ,Eswatini,AFRO,4,112,0,1
6699,2020-05-05T00:00:00Z,SZ,Eswatini,AFRO,4,116,0,1
6700,2020-05-06T00:00:00Z,SZ,Eswatini,AFRO,3,119,0,1
6701,2020-05-07T00:00:00Z,SZ,Eswatini,AFRO,4,123,1,2
6702,2020-05-08T00:00:00Z,SZ,Eswatini,AFRO,30,153,0,2
6703,2020-05-09T00:00:00Z,SZ,Eswatini,AFRO,6,159,0,2
6704,2020-05-10T00:00:00Z,SZ,Eswatini,AFRO,4,163,0,2
6705,2020-05-11T00:00:00Z,SZ,Eswatini,AFRO,9,172,0,2
6706,2020-05-12T00:00:00Z,SZ,Eswatini,AFRO,3,175,0,2
6707,2020-05-13T00:00:00Z,SZ,Eswatini,AFRO,9,184,0,2
6708,2020-05-14T00:00:00Z,SZ,Eswatini,AFRO,3,187,0,2
6709,2020-05-15T00:00:00Z,SZ,Eswatini,AFRO,0,187,0,2
6710,2020-05-16T00:00:00Z,SZ,Eswatini,AFRO,3,190,0,2
6711,2020-05-17T00:00:00Z,SZ,Eswatini,AFRO,12,202,0,2
6712,2020-05-18T00:00:00Z,SZ,Eswatini,AFRO,1,203,0,2
6713,2020-05-19T00:00:00Z,SZ,Eswatini,AFRO,2,205,0,2
6714,2020-05-20T00:00:00Z,SZ,Eswatini,AFRO,3,208,0,2
6715,2020-05-21T00:00:00Z,SZ,Eswatini,AFRO,9,217,0,2
6716,2020-05-22T00:00:00Z,SZ,Eswatini,AFRO,3,220,0,2
6717,2020-05-23T00:00:00Z,SZ,Eswatini,AFRO,5,225,0,2
6718,2020-05-24T00:00:00Z,SZ,Eswatini,AFRO,13,238,0,2
6719,2020-05-25T00:00:00Z,SZ,Eswatini,AFRO,12,250,0,2
6720,2020-05-26T00:00:00Z,SZ,Eswatini,AFRO,6,256,0,2
6721,2020-05-27T00:00:00Z,SZ,Eswatini,AFRO,5,261,0,2
6722,2020-05-28T00:00:00Z,SZ,Eswatini,AFRO,11,272,0,2
6723,2020-05-29T00:00:00Z,SZ,Eswatini,AFRO,7,279,0,2
6724,2020-05-30T00:00:00Z,SZ,Eswatini,AFRO,0,279,0,2
6725,2020-05-31T00:00:00Z,SZ,Eswatini,AFRO,4,283,0,2
6726,2020-06-01T00:00:00Z,SZ,Eswatini,AFRO,2,285,0,2
6727,2020-06-02T00:00:00Z,SZ,Eswatini,AFRO,8,293,1,3
6728,2020-06-03T00:00:00Z,SZ,Eswatini,AFRO,1,294,0,3
6729,2020-06-04T00:00:00Z,SZ,Eswatini,AFRO,1,295,0,3
6730,2020-06-05T00:00:00Z,SZ,Eswatini,AFRO,5,300,0,3
6731,2020-06-06T00:00:00Z,SZ,Eswatini,AFRO,5,305,0,3
6732,2020-06-07T00:00:00Z,SZ,Eswatini,AFRO,17,322,0,3
6733,2020-06-08T00:00:00Z,SZ,Eswatini,AFRO,11,333,0,3
6734,2020-06-09T00:00:00Z,SZ,Eswatini,AFRO,7,340,0,3
6735,2020-06-10T00:00:00Z,SZ,Eswatini,AFRO,31,371,0,3
6736,2020-06-11T00:00:00Z,SZ,Eswatini,AFRO,27,398,0,3
6737,2020-06-12T00:00:00Z,SZ,Eswatini,AFRO,51,449,0,3
6738,2020-06-13T00:00:00Z,SZ,Eswatini,AFRO,23,472,0,3
6739,2020-06-14T00:00:00Z,SZ,Eswatini,AFRO,14,486,0,3
6740,2020-06-15T00:00:00Z,SZ,Eswatini,AFRO,4,490,1,4
6741,2020-06-16T00:00:00Z,SZ,Eswatini,AFRO,16,506,0,4
6742,2020-06-17T00:00:00Z,SZ,Eswatini,AFRO,14,520,0,4
6743,2020-06-18T00:00:00Z,SZ,Eswatini,AFRO,43,563,0,4
6744,2020-06-19T00:00:00Z,SZ,Eswatini,AFRO,23,586,0,4
6745,2020-06-20T00:00:00Z,SZ,Eswatini,AFRO,37,623,0,4
6746,2020-03-14T00:00:00Z,ET,Ethiopia,AFRO,1,1,0,0
6747,2020-03-15T00:00:00Z,ET,Ethiopia,AFRO,0,1,0,0
6748,2020-03-16T00:00:00Z,ET,Ethiopia,AFRO,3,4,0,0
6749,2020-03-17T00:00:00Z,ET,Ethiopia,AFRO,1,5,0,0
6750,2020-03-18T00:00:00Z,ET,Ethiopia,AFRO,1,6,0,0
6751,2020-03-19T00:00:00Z,ET,Ethiopia,AFRO,3,9,0,0
6752,2020-03-20T00:00:00Z,ET,Ethiopia,AFRO,0,9,0,0
6753,2020-03-21T00:00:00Z,ET,Ethiopia,AFRO,0,9,0,0
6754,2020-03-22T00:00:00Z,ET,Ethiopia,AFRO,0,9,0,0
6755,2020-03-23T00:00:00Z,ET,Ethiopia,AFRO,2,11,0,0
6756,2020-03-24T00:00:00Z,ET,Ethiopia,AFRO,0,11,0,0
6757,2020-03-25T00:00:00Z,ET,Ethiopia,AFRO,1,12,0,0
6758,2020-03-26T00:00:00Z,ET,Ethiopia,AFRO,0,12,0,0
6759,2020-03-27T00:00:00Z,ET,Ethiopia,AFRO,0,12,0,0
6760,2020-03-28T00:00:00Z,ET,Ethiopia,AFRO,4,16,0,0
6761,2020-03-29T00:00:00Z,ET,Ethiopia,AFRO,0,16,0,0
6762,2020-03-30T00:00:00Z,ET,Ethiopia,AFRO,5,21,0,0
6763,2020-03-31T00:00:00Z,ET,Ethiopia,AFRO,2,23,0,0
6764,2020-04-01T00:00:00Z,ET,Ethiopia,AFRO,3,26,0,0
6765,2020-04-02T00:00:00Z,ET,Ethiopia,AFRO,0,26,0,0
6766,2020-04-03T00:00:00Z,ET,Ethiopia,AFRO,5,31,0,0
6767,2020-04-04T00:00:00Z,ET,Ethiopia,AFRO,4,35,0,0
6768,2020-04-05T00:00:00Z,ET,Ethiopia,AFRO,3,38,0,0
6769,2020-04-06T00:00:00Z,ET,Ethiopia,AFRO,5,43,1,1
6770,2020-04-07T00:00:00Z,ET,Ethiopia,AFRO,1,44,0,1
6771,2020-04-08T00:00:00Z,ET,Ethiopia,AFRO,8,52,1,2
6772,2020-04-09T00:00:00Z,ET,Ethiopia,AFRO,3,55,0,2
6773,2020-04-10T00:00:00Z,ET,Ethiopia,AFRO,1,56,0,2
6774,2020-04-11T00:00:00Z,ET,Ethiopia,AFRO,9,65,0,2
6775,2020-04-12T00:00:00Z,ET,Ethiopia,AFRO,4,69,1,3
6776,2020-04-13T00:00:00Z,ET,Ethiopia,AFRO,2,71,0,3
6777,2020-04-14T00:00:00Z,ET,Ethiopia,AFRO,3,74,0,3
6778,2020-04-15T00:00:00Z,ET,Ethiopia,AFRO,8,82,0,3
6779,2020-04-16T00:00:00Z,ET,Ethiopia,AFRO,3,85,0,3
6780,2020-04-17T00:00:00Z,ET,Ethiopia,AFRO,7,92,0,3
6781,2020-04-18T00:00:00Z,ET,Ethiopia,AFRO,4,96,0,3
6782,2020-04-19T00:00:00Z,ET,Ethiopia,AFRO,9,105,0,3
6783,2020-04-20T00:00:00Z,ET,Ethiopia,AFRO,3,108,0,3
6784,2020-04-21T00:00:00Z,ET,Ethiopia,AFRO,3,111,0,3
6785,2020-04-22T00:00:00Z,ET,Ethiopia,AFRO,3,114,0,3
6786,2020-04-23T00:00:00Z,ET,Ethiopia,AFRO,2,116,0,3
6787,2020-04-24T00:00:00Z,ET,Ethiopia,AFRO,0,116,0,3
6788,2020-04-25T00:00:00Z,ET,Ethiopia,AFRO,1,117,0,3
6789,2020-04-26T00:00:00Z,ET,Ethiopia,AFRO,5,122,0,3
6790,2020-04-27T00:00:00Z,ET,Ethiopia,AFRO,1,123,0,3
6791,2020-04-28T00:00:00Z,ET,Ethiopia,AFRO,1,124,0,3
6792,2020-04-29T00:00:00Z,ET,Ethiopia,AFRO,2,126,0,3
6793,2020-04-30T00:00:00Z,ET,Ethiopia,AFRO,4,130,0,3
6794,2020-05-01T00:00:00Z,ET,Ethiopia,AFRO,1,131,0,3
6795,2020-05-02T00:00:00Z,ET,Ethiopia,AFRO,2,133,0,3
6796,2020-05-03T00:00:00Z,ET,Ethiopia,AFRO,0,133,0,3
6797,2020-05-04T00:00:00Z,ET,Ethiopia,AFRO,2,135,0,3
6798,2020-05-05T00:00:00Z,ET,Ethiopia,AFRO,5,140,0,3
6799,2020-05-06T00:00:00Z,ET,Ethiopia,AFRO,5,145,1,4
6800,2020-05-07T00:00:00Z,ET,Ethiopia,AFRO,17,162,0,4
6801,2020-05-08T00:00:00Z,ET,Ethiopia,AFRO,29,191,0,4
6802,2020-05-09T00:00:00Z,ET,Ethiopia,AFRO,3,194,0,4
6803,2020-05-10T00:00:00Z,ET,Ethiopia,AFRO,16,210,1,5
6804,2020-05-11T00:00:00Z,ET,Ethiopia,AFRO,29,239,0,5
6805,2020-05-12T00:00:00Z,ET,Ethiopia,AFRO,11,250,0,5
6806,2020-05-13T00:00:00Z,ET,Ethiopia,AFRO,11,261,0,5
6807,2020-05-14T00:00:00Z,ET,Ethiopia,AFRO,2,263,0,5
6808,2020-05-15T00:00:00Z,ET,Ethiopia,AFRO,9,272,0,5
6809,2020-05-16T00:00:00Z,ET,Ethiopia,AFRO,15,287,0,5
6810,2020-05-17T00:00:00Z,ET,Ethiopia,AFRO,19,306,0,5
6811,2020-05-18T00:00:00Z,ET,Ethiopia,AFRO,11,317,0,5
6812,2020-05-19T00:00:00Z,ET,Ethiopia,AFRO,35,352,0,5
6813,2020-05-20T00:00:00Z,ET,Ethiopia,AFRO,13,365,0,5
6814,2020-05-21T00:00:00Z,ET,Ethiopia,AFRO,24,389,0,5
6815,2020-05-22T00:00:00Z,ET,Ethiopia,AFRO,10,399,0,5
6816,2020-05-23T00:00:00Z,ET,Ethiopia,AFRO,34,433,0,5
6817,2020-05-24T00:00:00Z,ET,Ethiopia,AFRO,61,494,0,5
6818,2020-05-25T00:00:00Z,ET,Ethiopia,AFRO,88,582,0,5
6819,2020-05-26T00:00:00Z,ET,Ethiopia,AFRO,73,655,0,5
6820,2020-05-27T00:00:00Z,ET,Ethiopia,AFRO,46,701,1,6
6821,2020-05-28T00:00:00Z,ET,Ethiopia,AFRO,30,731,0,6
6822,2020-05-29T00:00:00Z,ET,Ethiopia,AFRO,100,831,1,7
6823,2020-05-30T00:00:00Z,ET,Ethiopia,AFRO,137,968,1,8
6824,2020-05-31T00:00:00Z,ET,Ethiopia,AFRO,95,1063,0,8
6825,2020-06-01T00:00:00Z,ET,Ethiopia,AFRO,109,1172,3,11
6826,2020-06-02T00:00:00Z,ET,Ethiopia,AFRO,85,1257,1,12
6827,2020-06-03T00:00:00Z,ET,Ethiopia,AFRO,87,1344,2,14
6828,2020-06-04T00:00:00Z,ET,Ethiopia,AFRO,142,1486,3,17
6829,2020-06-05T00:00:00Z,ET,Ethiopia,AFRO,150,1636,1,18
6830,2020-06-06T00:00:00Z,ET,Ethiopia,AFRO,169,1805,1,19
6831,2020-06-07T00:00:00Z,ET,Ethiopia,AFRO,129,1934,1,20
6832,2020-06-08T00:00:00Z,ET,Ethiopia,AFRO,86,2020,7,27
6833,2020-06-09T00:00:00Z,ET,Ethiopia,AFRO,136,2156,0,27
6834,2020-06-10T00:00:00Z,ET,Ethiopia,AFRO,180,2336,5,32
6835,2020-06-11T00:00:00Z,ET,Ethiopia,AFRO,170,2506,3,35
6836,2020-06-12T00:00:00Z,ET,Ethiopia,AFRO,164,2670,5,40
6837,2020-06-13T00:00:00Z,ET,Ethiopia,AFRO,245,2915,7,47
6838,2020-06-14T00:00:00Z,ET,Ethiopia,AFRO,251,3166,8,55
6839,2020-06-15T00:00:00Z,ET,Ethiopia,AFRO,179,3345,2,57
6840,2020-06-16T00:00:00Z,ET,Ethiopia,AFRO,176,3521,3,60
6841,2020-06-17T00:00:00Z,ET,Ethiopia,AFRO,109,3630,1,61
6842,2020-06-18T00:00:00Z,ET,Ethiopia,AFRO,129,3759,2,63
6843,2020-06-19T00:00:00Z,ET,Ethiopia,AFRO,195,3954,2,65
6844,2020-06-20T00:00:00Z,ET,Ethiopia,AFRO,116,4070,7,72
7624,2020-03-14T00:00:00Z,GA,Gabon,AFRO,1,1,0,0
7625,2020-03-15T00:00:00Z,GA,Gabon,AFRO,0,1,0,0
7626,2020-03-16T00:00:00Z,GA,Gabon,AFRO,0,1,0,0
7627,2020-03-17T00:00:00Z,GA,Gabon,AFRO,0,1,0,0
7628,2020-03-18T00:00:00Z,GA,Gabon,AFRO,2,3,0,0
7629,2020-03-19T00:00:00Z,GA,Gabon,AFRO,0,3,0,0
7630,2020-03-20T00:00:00Z,GA,Gabon,AFRO,0,3,1,1
7631,2020-03-21T00:00:00Z,GA,Gabon,AFRO,0,3,0,1
7632,2020-03-22T00:00:00Z,GA,Gabon,AFRO,3,6,0,1
7633,2020-03-23T00:00:00Z,GA,Gabon,AFRO,0,6,0,1
7634,2020-03-24T00:00:00Z,GA,Gabon,AFRO,0,6,0,1
7635,2020-03-25T00:00:00Z,GA,Gabon,AFRO,0,6,0,1
7636,2020-03-26T00:00:00Z,GA,Gabon,AFRO,0,6,0,1
7637,2020-03-27T00:00:00Z,GA,Gabon,AFRO,0,6,0,1
7638,2020-03-28T00:00:00Z,GA,Gabon,AFRO,1,7,0,1
7639,2020-03-29T00:00:00Z,GA,Gabon,AFRO,0,7,0,1
7640,2020-03-30T00:00:00Z,GA,Gabon,AFRO,0,7,0,1
7641,2020-03-31T00:00:00Z,GA,Gabon,AFRO,0,7,0,1
7642,2020-04-01T00:00:00Z,GA,Gabon,AFRO,0,7,0,1
7643,2020-04-02T00:00:00Z,GA,Gabon,AFRO,0,7,0,1
7644,2020-04-03T00:00:00Z,GA,Gabon,AFRO,11,18,0,1
7645,2020-04-04T00:00:00Z,GA,Gabon,AFRO,3,21,0,1
7646,2020-04-05T00:00:00Z,GA,Gabon,AFRO,0,21,0,1
7647,2020-04-06T00:00:00Z,GA,Gabon,AFRO,0,21,0,1
7648,2020-04-07T00:00:00Z,GA,Gabon,AFRO,0,21,0,1
7649,2020-04-08T00:00:00Z,GA,Gabon,AFRO,3,24,0,1
7650,2020-04-09T00:00:00Z,GA,Gabon,AFRO,0,24,0,1
7651,2020-04-10T00:00:00Z,GA,Gabon,AFRO,20,44,0,1
7652,2020-04-11T00:00:00Z,GA,Gabon,AFRO,0,44,0,1
7653,2020-04-12T00:00:00Z,GA,Gabon,AFRO,5,49,0,1
7654,2020-04-13T00:00:00Z,GA,Gabon,AFRO,8,57,0,1
7655,2020-04-14T00:00:00Z,GA,Gabon,AFRO,0,57,0,1
7656,2020-04-15T00:00:00Z,GA,Gabon,AFRO,23,80,0,1
7657,2020-04-16T00:00:00Z,GA,Gabon,AFRO,7,87,0,1
7658,2020-04-17T00:00:00Z,GA,Gabon,AFRO,8,95,0,1
7659,2020-04-18T00:00:00Z,GA,Gabon,AFRO,0,95,0,1
7660,2020-04-19T00:00:00Z,GA,Gabon,AFRO,13,108,0,1
7661,2020-04-20T00:00:00Z,GA,Gabon,AFRO,1,109,0,1
7662,2020-04-21T00:00:00Z,GA,Gabon,AFRO,11,120,0,1
7663,2020-04-22T00:00:00Z,GA,Gabon,AFRO,36,156,0,1
7664,2020-04-23T00:00:00Z,GA,Gabon,AFRO,10,166,0,1
7665,2020-04-24T00:00:00Z,GA,Gabon,AFRO,0,166,1,2
7666,2020-04-25T00:00:00Z,GA,Gabon,AFRO,6,172,1,3
7667,2020-04-26T00:00:00Z,GA,Gabon,AFRO,4,176,0,3
7668,2020-04-27T00:00:00Z,GA,Gabon,AFRO,0,176,0,3
7669,2020-04-28T00:00:00Z,GA,Gabon,AFRO,0,176,0,3
7670,2020-04-29T00:00:00Z,GA,Gabon,AFRO,62,238,0,3
7671,2020-04-30T00:00:00Z,GA,Gabon,AFRO,38,276,0,3
7672,2020-05-01T00:00:00Z,GA,Gabon,AFRO,0,276,0,3
7673,2020-05-02T00:00:00Z,GA,Gabon,AFRO,32,308,1,4
7674,2020-05-03T00:00:00Z,GA,Gabon,AFRO,27,335,1,5
7675,2020-05-04T00:00:00Z,GA,Gabon,AFRO,0,335,0,5
7676,2020-05-05T00:00:00Z,GA,Gabon,AFRO,32,367,1,6
7677,2020-05-06T00:00:00Z,GA,Gabon,AFRO,30,397,0,6
7678,2020-05-07T00:00:00Z,GA,Gabon,AFRO,0,397,0,6
7679,2020-05-08T00:00:00Z,GA,Gabon,AFRO,107,504,2,8
7680,2020-05-09T00:00:00Z,GA,Gabon,AFRO,116,620,0,8
7681,2020-05-10T00:00:00Z,GA,Gabon,AFRO,41,661,0,8
7682,2020-05-11T00:00:00Z,GA,Gabon,AFRO,0,661,0,8
7683,2020-05-12T00:00:00Z,GA,Gabon,AFRO,141,802,1,9
7684,2020-05-13T00:00:00Z,GA,Gabon,AFRO,61,863,0,9
7685,2020-05-14T00:00:00Z,GA,Gabon,AFRO,141,1004,0,9
7686,2020-05-15T00:00:00Z,GA,Gabon,AFRO,100,1104,1,10
7687,2020-05-16T00:00:00Z,GA,Gabon,AFRO,105,1209,0,10
7688,2020-05-17T00:00:00Z,GA,Gabon,AFRO,111,1320,1,11
7689,2020-05-18T00:00:00Z,GA,Gabon,AFRO,0,1320,0,11
7690,2020-05-19T00:00:00Z,GA,Gabon,AFRO,112,1432,0,11
7691,2020-05-20T00:00:00Z,GA,Gabon,AFRO,70,1502,1,12
7692,2020-05-21T00:00:00Z,GA,Gabon,AFRO,65,1567,0,12
7693,2020-05-22T00:00:00Z,GA,Gabon,AFRO,0,1567,0,12
7694,2020-05-23T00:00:00Z,GA,Gabon,AFRO,161,1728,0,12
7695,2020-05-24T00:00:00Z,GA,Gabon,AFRO,206,1934,0,12
7696,2020-05-25T00:00:00Z,GA,Gabon,AFRO,0,1934,0,12
7697,2020-05-26T00:00:00Z,GA,Gabon,AFRO,201,2135,2,14
7698,2020-05-27T00:00:00Z,GA,Gabon,AFRO,103,2238,0,14
7699,2020-05-28T00:00:00Z,GA,Gabon,AFRO,81,2319,0,14
7700,2020-05-29T00:00:00Z,GA,Gabon,AFRO,112,2431,0,14
7701,2020-05-30T00:00:00Z,GA,Gabon,AFRO,182,2613,1,15
7702,2020-05-31T00:00:00Z,GA,Gabon,AFRO,0,2613,0,15
7703,2020-06-01T00:00:00Z,GA,Gabon,AFRO,42,2655,2,17
7704,2020-06-02T00:00:00Z,GA,Gabon,AFRO,0,2655,0,17
7705,2020-06-03T00:00:00Z,GA,Gabon,AFRO,148,2803,3,20
7706,2020-06-04T00:00:00Z,GA,Gabon,AFRO,99,2902,0,20
7707,2020-06-05T00:00:00Z,GA,Gabon,AFRO,53,2955,1,21
7708,2020-06-06T00:00:00Z,GA,Gabon,AFRO,146,3101,0,21
7709,2020-06-07T00:00:00Z,GA,Gabon,AFRO,0,3101,0,21
7710,2020-06-08T00:00:00Z,GA,Gabon,AFRO,0,3101,0,21
7711,2020-06-09T00:00:00Z,GA,Gabon,AFRO,0,3101,0,21
7712,2020-06-10T00:00:00Z,GA,Gabon,AFRO,193,3294,0,21
7713,2020-06-11T00:00:00Z,GA,Gabon,AFRO,0,3294,0,21
7714,2020-06-12T00:00:00Z,GA,Gabon,AFRO,169,3463,2,23
7715,2020-06-13T00:00:00Z,GA,Gabon,AFRO,0,3463,0,23
7716,2020-06-14T00:00:00Z,GA,Gabon,AFRO,0,3463,0,23
7717,2020-06-15T00:00:00Z,GA,Gabon,AFRO,0,3463,0,23
7718,2020-06-16T00:00:00Z,GA,Gabon,AFRO,570,4033,4,27
7719,2020-06-17T00:00:00Z,GA,Gabon,AFRO,81,4114,2,29
7720,2020-06-18T00:00:00Z,GA,Gabon,AFRO,115,4229,1,30
7721,2020-06-19T00:00:00Z,GA,Gabon,AFRO,111,4340,2,32
7722,2020-06-20T00:00:00Z,GA,Gabon,AFRO,0,4340,0,32
7723,2020-03-18T00:00:00Z,GM,Gambia,AFRO,1,1,0,0
7724,2020-03-19T00:00:00Z,GM,Gambia,AFRO,0,1,0,0
7725,2020-03-20T00:00:00Z,GM,Gambia,AFRO,0,1,0,0
7726,2020-03-21T00:00:00Z,GM,Gambia,AFRO,0,1,0,0
7727,2020-03-22T00:00:00Z,GM,Gambia,AFRO,0,1,0,0
7728,2020-03-23T00:00:00Z,GM,Gambia,AFRO,0,1,0,0
7729,2020-03-24T00:00:00Z,GM,Gambia,AFRO,0,1,0,0
7730,2020-03-25T00:00:00Z,GM,Gambia,AFRO,1,2,0,0
7731,2020-03-26T00:00:00Z,GM,Gambia,AFRO,0,2,0,0
7732,2020-03-27T00:00:00Z,GM,Gambia,AFRO,0,2,0,0
7733,2020-03-28T00:00:00Z,GM,Gambia,AFRO,0,2,1,1
7734,2020-03-29T00:00:00Z,GM,Gambia,AFRO,1,3,0,1
7735,2020-03-30T00:00:00Z,GM,Gambia,AFRO,0,3,0,1
7736,2020-03-31T00:00:00Z,GM,Gambia,AFRO,0,3,0,1
7737,2020-04-01T00:00:00Z,GM,Gambia,AFRO,0,3,0,1
7738,2020-04-02T00:00:00Z,GM,Gambia,AFRO,0,3,0,1
7739,2020-04-03T00:00:00Z,GM,Gambia,AFRO,1,4,0,1
7740,2020-04-04T00:00:00Z,GM,Gambia,AFRO,0,4,0,1
7741,2020-04-05T00:00:00Z,GM,Gambia,AFRO,0,4,0,1
7742,2020-04-06T00:00:00Z,GM,Gambia,AFRO,0,4,0,1
7743,2020-04-07T00:00:00Z,GM,Gambia,AFRO,0,4,0,1
7744,2020-04-08T00:00:00Z,GM,Gambia,AFRO,0,4,0,1
7745,2020-04-09T00:00:00Z,GM,Gambia,AFRO,0,4,0,1
7746,2020-04-10T00:00:00Z,GM,Gambia,AFRO,0,4,0,1
7747,2020-04-11T00:00:00Z,GM,Gambia,AFRO,0,4,0,1
7748,2020-04-12T00:00:00Z,GM,Gambia,AFRO,5,9,0,1
7749,2020-04-13T00:00:00Z,GM,Gambia,AFRO,0,9,0,1
7750,2020-04-14T00:00:00Z,GM,Gambia,AFRO,0,9,0,1
7751,2020-04-15T00:00:00Z,GM,Gambia,AFRO,0,9,0,1
7752,2020-04-16T00:00:00Z,GM,Gambia,AFRO,0,9,0,1
7753,2020-04-17T00:00:00Z,GM,Gambia,AFRO,0,9,0,1
7754,2020-04-18T00:00:00Z,GM,Gambia,AFRO,0,9,0,1
7755,2020-04-19T00:00:00Z,GM,Gambia,AFRO,0,9,0,1
7756,2020-04-20T00:00:00Z,GM,Gambia,AFRO,0,9,0,1
7757,2020-04-21T00:00:00Z,GM,Gambia,AFRO,1,10,0,1
7758,2020-04-22T00:00:00Z,GM,Gambia,AFRO,0,10,0,1
7759,2020-04-23T00:00:00Z,GM,Gambia,AFRO,0,10,0,1
7760,2020-04-24T00:00:00Z,GM,Gambia,AFRO,0,10,0,1
7761,2020-04-25T00:00:00Z,GM,Gambia,AFRO,0,10,0,1
7762,2020-04-26T00:00:00Z,GM,Gambia,AFRO,0,10,0,1
7763,2020-04-27T00:00:00Z,GM,Gambia,AFRO,0,10,0,1
7764,2020-04-28T00:00:00Z,GM,Gambia,AFRO,0,10,0,1
7765,2020-04-29T00:00:00Z,GM,Gambia,AFRO,0,10,0,1
7766,2020-04-30T00:00:00Z,GM,Gambia,AFRO,1,11,0,1
7767,2020-05-01T00:00:00Z,GM,Gambia,AFRO,1,12,0,1
7768,2020-05-02T00:00:00Z,GM,Gambia,AFRO,0,12,0,1
7769,2020-05-03T00:00:00Z,GM,Gambia,AFRO,5,17,0,1
7770,2020-05-04T00:00:00Z,GM,Gambia,AFRO,0,17,0,1
7771,2020-05-05T00:00:00Z,GM,Gambia,AFRO,0,17,0,1
7772,2020-05-06T00:00:00Z,GM,Gambia,AFRO,0,17,0,1
7773,2020-05-07T00:00:00Z,GM,Gambia,AFRO,0,17,0,1
7774,2020-05-08T00:00:00Z,GM,Gambia,AFRO,1,18,0,1
7775,2020-05-09T00:00:00Z,GM,Gambia,AFRO,2,20,0,1
7776,2020-05-10T00:00:00Z,GM,Gambia,AFRO,0,20,0,1
7777,2020-05-11T00:00:00Z,GM,Gambia,AFRO,0,20,0,1
7778,2020-05-12T00:00:00Z,GM,Gambia,AFRO,2,22,0,1
7779,2020-05-13T00:00:00Z,GM,Gambia,AFRO,1,23,0,1
7780,2020-05-14T00:00:00Z,GM,Gambia,AFRO,0,23,0,1
7781,2020-05-15T00:00:00Z,GM,Gambia,AFRO,0,23,0,1
7782,2020-05-16T00:00:00Z,GM,Gambia,AFRO,0,23,0,1
7783,2020-05-17T00:00:00Z,GM,Gambia,AFRO,0,23,0,1
7784,2020-05-18T00:00:00Z,GM,Gambia,AFRO,1,24,0,1
7785,2020-05-19T00:00:00Z,GM,Gambia,AFRO,0,24,0,1
7786,2020-05-20T00:00:00Z,GM,Gambia,AFRO,0,24,0,1
7787,2020-05-21T00:00:00Z,GM,Gambia,AFRO,0,24,0,1
7788,2020-05-22T00:00:00Z,GM,Gambia,AFRO,0,24,0,1
7789,2020-05-23T00:00:00Z,GM,Gambia,AFRO,1,25,0,1
7790,2020-05-24T00:00:00Z,GM,Gambia,AFRO,0,25,0,1
7791,2020-05-25T00:00:00Z,GM,Gambia,AFRO,0,25,0,1
7792,2020-05-26T00:00:00Z,GM,Gambia,AFRO,0,25,0,1
7793,2020-05-27T00:00:00Z,GM,Gambia,AFRO,0,25,0,1
7794,2020-05-28T00:00:00Z,GM,Gambia,AFRO,0,25,0,1
7795,2020-05-29T00:00:00Z,GM,Gambia,AFRO,0,25,0,1
7796,2020-05-30T00:00:00Z,GM,Gambia,AFRO,0,25,0,1
7797,2020-05-31T00:00:00Z,GM,Gambia,AFRO,0,25,0,1
7798,2020-06-01T00:00:00Z,GM,Gambia,AFRO,0,25,0,1
7799,2020-06-02T00:00:00Z,GM,Gambia,AFRO,0,25,0,1
7800,2020-06-03T00:00:00Z,GM,Gambia,AFRO,1,26,0,1
7801,2020-06-04T00:00:00Z,GM,Gambia,AFRO,0,26,0,1
7802,2020-06-05T00:00:00Z,GM,Gambia,AFRO,0,26,0,1
7803,2020-06-06T00:00:00Z,GM,Gambia,AFRO,0,26,0,1
7804,2020-06-07T00:00:00Z,GM,Gambia,AFRO,0,26,0,1
7805,2020-06-08T00:00:00Z,GM,Gambia,AFRO,0,26,0,1
7806,2020-06-09T00:00:00Z,GM,Gambia,AFRO,2,28,0,1
7807,2020-06-10T00:00:00Z,GM,Gambia,AFRO,0,28,0,1
7808,2020-06-11T00:00:00Z,GM,Gambia,AFRO,0,28,0,1
7809,2020-06-12T00:00:00Z,GM,Gambia,AFRO,0,28,0,1
7810,2020-06-13T00:00:00Z,GM,Gambia,AFRO,0,28,0,1
7811,2020-06-14T00:00:00Z,GM,Gambia,AFRO,0,28,0,1
7812,2020-06-15T00:00:00Z,GM,Gambia,AFRO,0,28,0,1
7813,2020-06-16T00:00:00Z,GM,Gambia,AFRO,0,28,0,1
7814,2020-06-17T00:00:00Z,GM,Gambia,AFRO,6,34,0,1
7815,2020-06-18T00:00:00Z,GM,Gambia,AFRO,0,34,0,1
7816,2020-06-19T00:00:00Z,GM,Gambia,AFRO,2,36,0,1
7817,2020-06-20T00:00:00Z,GM,Gambia,AFRO,0,36,0,1
8079,2020-03-14T00:00:00Z,GH,Ghana,AFRO,1,1,0,0
8080,2020-03-15T00:00:00Z,GH,Ghana,AFRO,1,2,0,0
8081,2020-03-16T00:00:00Z,GH,Ghana,AFRO,0,2,0,0
8082,2020-03-17T00:00:00Z,GH,Ghana,AFRO,4,6,0,0
8083,2020-03-18T00:00:00Z,GH,Ghana,AFRO,3,9,0,0
8084,2020-03-19T00:00:00Z,GH,Ghana,AFRO,2,11,0,0
8085,2020-03-20T00:00:00Z,GH,Ghana,AFRO,5,16,0,0
8086,2020-03-21T00:00:00Z,GH,Ghana,AFRO,3,19,0,0
8087,2020-03-22T00:00:00Z,GH,Ghana,AFRO,0,19,0,0
8088,2020-03-23T00:00:00Z,GH,Ghana,AFRO,5,24,0,0
8089,2020-03-24T00:00:00Z,GH,Ghana,AFRO,3,27,2,2
8090,2020-03-25T00:00:00Z,GH,Ghana,AFRO,26,53,0,2
8091,2020-03-26T00:00:00Z,GH,Ghana,AFRO,79,132,0,2
8092,2020-03-27T00:00:00Z,GH,Ghana,AFRO,4,136,1,3
8093,2020-03-28T00:00:00Z,GH,Ghana,AFRO,1,137,1,4
8094,2020-03-29T00:00:00Z,GH,Ghana,AFRO,0,137,0,4
8095,2020-03-30T00:00:00Z,GH,Ghana,AFRO,15,152,0,4
8096,2020-03-31T00:00:00Z,GH,Ghana,AFRO,0,152,0,4
8097,2020-04-01T00:00:00Z,GH,Ghana,AFRO,9,161,0,4
8098,2020-04-02T00:00:00Z,GH,Ghana,AFRO,34,195,0,4
8099,2020-04-03T00:00:00Z,GH,Ghana,AFRO,9,204,0,4
8100,2020-04-04T00:00:00Z,GH,Ghana,AFRO,1,205,0,4
8101,2020-04-05T00:00:00Z,GH,Ghana,AFRO,0,205,0,4
8102,2020-04-06T00:00:00Z,GH,Ghana,AFRO,9,214,1,5
8103,2020-04-07T00:00:00Z,GH,Ghana,AFRO,0,214,0,5
8104,2020-04-08T00:00:00Z,GH,Ghana,AFRO,73,287,0,5
8105,2020-04-09T00:00:00Z,GH,Ghana,AFRO,26,313,1,6
8106,2020-04-10T00:00:00Z,GH,Ghana,AFRO,0,313,0,6
8107,2020-04-11T00:00:00Z,GH,Ghana,AFRO,65,378,0,6
8108,2020-04-12T00:00:00Z,GH,Ghana,AFRO,30,408,2,8
8109,2020-04-13T00:00:00Z,GH,Ghana,AFRO,158,566,0,8
8110,2020-04-14T00:00:00Z,GH,Ghana,AFRO,0,566,0,8
8111,2020-04-15T00:00:00Z,GH,Ghana,AFRO,70,636,0,8
8112,2020-04-16T00:00:00Z,GH,Ghana,AFRO,0,636,0,8
8113,2020-04-17T00:00:00Z,GH,Ghana,AFRO,5,641,0,8
8114,2020-04-18T00:00:00Z,GH,Ghana,AFRO,0,641,0,8
8115,2020-04-19T00:00:00Z,GH,Ghana,AFRO,193,834,1,9
8116,2020-04-20T00:00:00Z,GH,Ghana,AFRO,208,1042,0,9
8117,2020-04-21T00:00:00Z,GH,Ghana,AFRO,0,1042,0,9
8118,2020-04-22T00:00:00Z,GH,Ghana,AFRO,0,1042,0,9
8119,2020-04-23T00:00:00Z,GH,Ghana,AFRO,112,1154,0,9
8120,2020-04-24T00:00:00Z,GH,Ghana,AFRO,0,1154,0,9
8121,2020-04-25T00:00:00Z,GH,Ghana,AFRO,125,1279,1,10
8122,2020-04-26T00:00:00Z,GH,Ghana,AFRO,0,1279,0,10
8123,2020-04-27T00:00:00Z,GH,Ghana,AFRO,271,1550,1,11
8124,2020-04-28T00:00:00Z,GH,Ghana,AFRO,0,1550,0,11
8125,2020-04-29T00:00:00Z,GH,Ghana,AFRO,121,1671,5,16
8126,2020-04-30T00:00:00Z,GH,Ghana,AFRO,0,1671,0,16
8127,2020-05-01T00:00:00Z,GH,Ghana,AFRO,403,2074,1,17
8128,2020-05-02T00:00:00Z,GH,Ghana,AFRO,0,2074,0,17
8129,2020-05-03T00:00:00Z,GH,Ghana,AFRO,95,2169,1,18
8130,2020-05-04T00:00:00Z,GH,Ghana,AFRO,0,2169,0,18
8131,2020-05-05T00:00:00Z,GH,Ghana,AFRO,550,2719,0,18
8132,2020-05-06T00:00:00Z,GH,Ghana,AFRO,0,2719,0,18
8133,2020-05-07T00:00:00Z,GH,Ghana,AFRO,0,2719,0,18
8134,2020-05-08T00:00:00Z,GH,Ghana,AFRO,372,3091,0,18
8135,2020-05-09T00:00:00Z,GH,Ghana,AFRO,921,4012,0,18
8136,2020-05-10T00:00:00Z,GH,Ghana,AFRO,251,4263,4,22
8137,2020-05-11T00:00:00Z,GH,Ghana,AFRO,0,4263,0,22
8138,2020-05-12T00:00:00Z,GH,Ghana,AFRO,437,4700,0,22
8139,2020-05-13T00:00:00Z,GH,Ghana,AFRO,427,5127,0,22
8140,2020-05-14T00:00:00Z,GH,Ghana,AFRO,281,5408,2,24
8141,2020-05-15T00:00:00Z,GH,Ghana,AFRO,122,5530,0,24
8142,2020-05-16T00:00:00Z,GH,Ghana,AFRO,108,5638,4,28
8143,2020-05-17T00:00:00Z,GH,Ghana,AFRO,97,5735,1,29
8144,2020-05-18T00:00:00Z,GH,Ghana,AFRO,0,5735,0,29
8145,2020-05-19T00:00:00Z,GH,Ghana,AFRO,0,5735,0,29
8146,2020-05-20T00:00:00Z,GH,Ghana,AFRO,361,6096,2,31
8147,2020-05-21T00:00:00Z,GH,Ghana,AFRO,0,6096,0,31
8148,2020-05-22T00:00:00Z,GH,Ghana,AFRO,173,6269,0,31
8149,2020-05-23T00:00:00Z,GH,Ghana,AFRO,217,6486,0,31
8150,2020-05-24T00:00:00Z,GH,Ghana,AFRO,131,6617,0,31
8151,2020-05-25T00:00:00Z,GH,Ghana,AFRO,66,6683,1,32
8152,2020-05-26T00:00:00Z,GH,Ghana,AFRO,125,6808,0,32
8153,2020-05-27T00:00:00Z,GH,Ghana,AFRO,156,6964,0,32
8154,2020-05-28T00:00:00Z,GH,Ghana,AFRO,339,7303,2,34
8155,2020-05-29T00:00:00Z,GH,Ghana,AFRO,0,7303,0,34
8156,2020-05-30T00:00:00Z,GH,Ghana,AFRO,313,7616,0,34
8157,2020-05-31T00:00:00Z,GH,Ghana,AFRO,152,7768,1,35
8158,2020-06-01T00:00:00Z,GH,Ghana,AFRO,113,7881,1,36
8159,2020-06-02T00:00:00Z,GH,Ghana,AFRO,189,8070,0,36
8160,2020-06-03T00:00:00Z,GH,Ghana,AFRO,227,8297,2,38
8161,2020-06-04T00:00:00Z,GH,Ghana,AFRO,251,8548,0,38
8162,2020-06-05T00:00:00Z,GH,Ghana,AFRO,337,8885,0,38
8163,2020-06-06T00:00:00Z,GH,Ghana,AFRO,283,9168,4,42
8164,2020-06-07T00:00:00Z,GH,Ghana,AFRO,294,9462,2,44
8165,2020-06-08T00:00:00Z,GH,Ghana,AFRO,176,9638,0,44
8166,2020-06-09T00:00:00Z,GH,Ghana,AFRO,272,9910,4,48
8167,2020-06-10T00:00:00Z,GH,Ghana,AFRO,291,10201,0,48
8168,2020-06-11T00:00:00Z,GH,Ghana,AFRO,0,10201,0,48
8169,2020-06-12T00:00:00Z,GH,Ghana,AFRO,157,10358,0,48
8170,2020-06-13T00:00:00Z,GH,Ghana,AFRO,498,10856,0,48
8171,2020-06-14T00:00:00Z,GH,Ghana,AFRO,262,11118,0,48
8172,2020-06-15T00:00:00Z,GH,Ghana,AFRO,304,11422,3,51
8173,2020-06-16T00:00:00Z,GH,Ghana,AFRO,542,11964,3,54
8174,2020-06-17T00:00:00Z,GH,Ghana,AFRO,229,12193,4,58
8175,2020-06-18T00:00:00Z,GH,Ghana,AFRO,397,12590,8,66
8176,2020-06-19T00:00:00Z,GH,Ghana,AFRO,339,12929,0,66
8177,2020-06-20T00:00:00Z,GH,Ghana,AFRO,274,13203,4,70
8986,2020-03-14T00:00:00Z,GN,Guinea,AFRO,1,1,0,0
8987,2020-03-15T00:00:00Z,GN,Guinea,AFRO,0,1,0,0
8988,2020-03-16T00:00:00Z,GN,Guinea,AFRO,0,1,0,0
8989,2020-03-17T00:00:00Z,GN,Guinea,AFRO,0,1,0,0
8990,2020-03-18T00:00:00Z,GN,Guinea,AFRO,0,1,0,0
8991,2020-03-19T00:00:00Z,GN,Guinea,AFRO,1,2,0,0
8992,2020-03-20T00:00:00Z,GN,Guinea,AFRO,0,2,0,0
8993,2020-03-21T00:00:00Z,GN,Guinea,AFRO,0,2,0,0
8994,2020-03-22T00:00:00Z,GN,Guinea,AFRO,0,2,0,0
8995,2020-03-23T00:00:00Z,GN,Guinea,AFRO,0,2,0,0
8996,2020-03-24T00:00:00Z,GN,Guinea,AFRO,2,4,0,0
8997,2020-03-25T00:00:00Z,GN,Guinea,AFRO,0,4,0,0
8998,2020-03-26T00:00:00Z,GN,Guinea,AFRO,0,4,0,0
8999,2020-03-27T00:00:00Z,GN,Guinea,AFRO,1,5,0,0
9000,2020-03-28T00:00:00Z,GN,Guinea,AFRO,3,8,0,0
9001,2020-03-29T00:00:00Z,GN,Guinea,AFRO,0,8,0,0
9002,2020-03-30T00:00:00Z,GN,Guinea,AFRO,8,16,0,0
9003,2020-03-31T00:00:00Z,GN,Guinea,AFRO,0,16,0,0
9004,2020-04-01T00:00:00Z,GN,Guinea,AFRO,0,16,0,0
9005,2020-04-02T00:00:00Z,GN,Guinea,AFRO,14,30,0,0
9006,2020-04-03T00:00:00Z,GN,Guinea,AFRO,22,52,0,0
9007,2020-04-04T00:00:00Z,GN,Guinea,AFRO,0,52,0,0
9008,2020-04-05T00:00:00Z,GN,Guinea,AFRO,59,111,0,0
9009,2020-04-06T00:00:00Z,GN,Guinea,AFRO,0,111,0,0
9010,2020-04-07T00:00:00Z,GN,Guinea,AFRO,0,111,0,0
9011,2020-04-08T00:00:00Z,GN,Guinea,AFRO,33,144,0,0
9012,2020-04-09T00:00:00Z,GN,Guinea,AFRO,20,164,0,0
9013,2020-04-10T00:00:00Z,GN,Guinea,AFRO,30,194,0,0
9014,2020-04-11T00:00:00Z,GN,Guinea,AFRO,0,194,0,0
9015,2020-04-12T00:00:00Z,GN,Guinea,AFRO,56,250,0,0
9016,2020-04-13T00:00:00Z,GN,Guinea,AFRO,0,250,0,0
9017,2020-04-14T00:00:00Z,GN,Guinea,AFRO,69,319,0,0
9018,2020-04-15T00:00:00Z,GN,Guinea,AFRO,44,363,0,0
9019,2020-04-16T00:00:00Z,GN,Guinea,AFRO,41,404,1,1
9020,2020-04-17T00:00:00Z,GN,Guinea,AFRO,34,438,0,1
9021,2020-04-18T00:00:00Z,GN,Guinea,AFRO,0,438,0,1
9022,2020-04-19T00:00:00Z,GN,Guinea,AFRO,39,477,2,3
9023,2020-04-20T00:00:00Z,GN,Guinea,AFRO,0,477,0,3
9024,2020-04-21T00:00:00Z,GN,Guinea,AFRO,145,622,2,5
9025,2020-04-22T00:00:00Z,GN,Guinea,AFRO,66,688,1,6
9026,2020-04-23T00:00:00Z,GN,Guinea,AFRO,73,761,0,6
9027,2020-04-24T00:00:00Z,GN,Guinea,AFRO,101,862,0,6
9028,2020-04-25T00:00:00Z,GN,Guinea,AFRO,92,954,0,6
9029,2020-04-26T00:00:00Z,GN,Guinea,AFRO,42,996,1,7
9030,2020-04-27T00:00:00Z,GN,Guinea,AFRO,98,1094,0,7
9031,2020-04-28T00:00:00Z,GN,Guinea,AFRO,69,1163,0,7
9032,2020-04-29T00:00:00Z,GN,Guinea,AFRO,77,1240,0,7
9033,2020-04-30T00:00:00Z,GN,Guinea,AFRO,111,1351,0,7
9034,2020-05-01T00:00:00Z,GN,Guinea,AFRO,144,1495,0,7
9035,2020-05-02T00:00:00Z,GN,Guinea,AFRO,42,1537,0,7
9036,2020-05-03T00:00:00Z,GN,Guinea,AFRO,49,1586,0,7
9037,2020-05-04T00:00:00Z,GN,Guinea,AFRO,64,1650,0,7
9038,2020-05-05T00:00:00Z,GN,Guinea,AFRO,60,1710,2,9
9039,2020-05-06T00:00:00Z,GN,Guinea,AFRO,101,1811,1,10
9040,2020-05-07T00:00:00Z,GN,Guinea,AFRO,45,1856,1,11
9041,2020-05-08T00:00:00Z,GN,Guinea,AFRO,71,1927,0,11
9042,2020-05-09T00:00:00Z,GN,Guinea,AFRO,82,2009,0,11
9043,2020-05-10T00:00:00Z,GN,Guinea,AFRO,33,2042,0,11
9044,2020-05-11T00:00:00Z,GN,Guinea,AFRO,104,2146,0,11
9045,2020-05-12T00:00:00Z,GN,Guinea,AFRO,0,2146,0,11
9046,2020-05-13T00:00:00Z,GN,Guinea,AFRO,152,2298,0,11
9047,2020-05-14T00:00:00Z,GN,Guinea,AFRO,74,2372,3,14
9048,2020-05-15T00:00:00Z,GN,Guinea,AFRO,101,2473,0,14
9049,2020-05-16T00:00:00Z,GN,Guinea,AFRO,58,2531,1,15
9050,2020-05-17T00:00:00Z,GN,Guinea,AFRO,127,2658,1,16
9051,2020-05-18T00:00:00Z,GN,Guinea,AFRO,69,2727,0,16
9052,2020-05-19T00:00:00Z,GN,Guinea,AFRO,69,2796,0,16
9053,2020-05-20T00:00:00Z,GN,Guinea,AFRO,67,2863,2,18
9054,2020-05-21T00:00:00Z,GN,Guinea,AFRO,64,2927,1,19
9055,2020-05-22T00:00:00Z,GN,Guinea,AFRO,140,3067,0,19
9056,2020-05-23T00:00:00Z,GN,Guinea,AFRO,47,3114,0,19
9057,2020-05-24T00:00:00Z,GN,Guinea,AFRO,62,3176,1,20
9058,2020-05-25T00:00:00Z,GN,Guinea,AFRO,99,3275,0,20
9059,2020-05-26T00:00:00Z,GN,Guinea,AFRO,47,3322,0,20
9060,2020-05-27T00:00:00Z,GN,Guinea,AFRO,36,3358,0,20
9061,2020-05-28T00:00:00Z,GN,Guinea,AFRO,88,3446,1,21
9062,2020-05-29T00:00:00Z,GN,Guinea,AFRO,107,3553,1,22
9063,2020-05-30T00:00:00Z,GN,Guinea,AFRO,103,3656,0,22
9064,2020-05-31T00:00:00Z,GN,Guinea,AFRO,50,3706,1,23
9065,2020-06-01T00:00:00Z,GN,Guinea,AFRO,65,3771,0,23
9066,2020-06-02T00:00:00Z,GN,Guinea,AFRO,73,3844,0,23
9067,2020-06-03T00:00:00Z,GN,Guinea,AFRO,42,3886,0,23
9068,2020-06-04T00:00:00Z,GN,Guinea,AFRO,47,3933,0,23
9069,2020-06-05T00:00:00Z,GN,Guinea,AFRO,58,3991,0,23
9070,2020-06-06T00:00:00Z,GN,Guinea,AFRO,69,4060,0,23
9071,2020-06-07T00:00:00Z,GN,Guinea,AFRO,57,4117,0,23
9072,2020-06-08T00:00:00Z,GN,Guinea,AFRO,48,4165,0,23
9073,2020-06-09T00:00:00Z,GN,Guinea,AFRO,51,4216,0,23
9074,2020-06-10T00:00:00Z,GN,Guinea,AFRO,42,4258,0,23
9075,2020-06-11T00:00:00Z,GN,Guinea,AFRO,33,4291,0,23
9076,2020-06-12T00:00:00Z,GN,Guinea,AFRO,81,4372,0,23
9077,2020-06-13T00:00:00Z,GN,Guinea,AFRO,54,4426,1,24
9078,2020-06-14T00:00:00Z,GN,Guinea,AFRO,58,4484,1,25
9079,2020-06-15T00:00:00Z,GN,Guinea,AFRO,50,4534,0,25
9080,2020-06-16T00:00:00Z,GN,Guinea,AFRO,38,4572,1,26
9081,2020-06-17T00:00:00Z,GN,Guinea,AFRO,67,4639,0,26
9082,2020-06-18T00:00:00Z,GN,Guinea,AFRO,29,4668,0,26
9083,2020-06-19T00:00:00Z,GN,Guinea,AFRO,173,4841,0,26
9084,2020-06-20T00:00:00Z,GN,Guinea,AFRO,63,4904,1,27
9085,2020-03-26T00:00:00Z,GW,Guinea-Bissau,AFRO,2,2,0,0
9086,2020-03-27T00:00:00Z,GW,Guinea-Bissau,AFRO,0,2,0,0
9087,2020-03-28T00:00:00Z,GW,Guinea-Bissau,AFRO,0,2,0,0
9088,2020-03-29T00:00:00Z,GW,Guinea-Bissau,AFRO,0,2,0,0
9089,2020-03-30T00:00:00Z,GW,Guinea-Bissau,AFRO,0,2,0,0
9090,2020-03-31T00:00:00Z,GW,Guinea-Bissau,AFRO,6,8,0,0
9091,2020-04-01T00:00:00Z,GW,Guinea-Bissau,AFRO,1,9,0,0
9092,2020-04-02T00:00:00Z,GW,Guinea-Bissau,AFRO,0,9,0,0
9093,2020-04-03T00:00:00Z,GW,Guinea-Bissau,AFRO,0,9,0,0
9094,2020-04-04T00:00:00Z,GW,Guinea-Bissau,AFRO,6,15,0,0
9095,2020-04-05T00:00:00Z,GW,Guinea-Bissau,AFRO,3,18,0,0
9096,2020-04-06T00:00:00Z,GW,Guinea-Bissau,AFRO,0,18,0,0
9097,2020-04-07T00:00:00Z,GW,Guinea-Bissau,AFRO,15,33,0,0
9098,2020-04-08T00:00:00Z,GW,Guinea-Bissau,AFRO,0,33,0,0
9099,2020-04-09T00:00:00Z,GW,Guinea-Bissau,AFRO,0,33,0,0
9100,2020-04-10T00:00:00Z,GW,Guinea-Bissau,AFRO,2,35,0,0
9101,2020-04-11T00:00:00Z,GW,Guinea-Bissau,AFRO,0,35,0,0
9102,2020-04-12T00:00:00Z,GW,Guinea-Bissau,AFRO,3,38,0,0
9103,2020-04-13T00:00:00Z,GW,Guinea-Bissau,AFRO,1,39,0,0
9104,2020-04-14T00:00:00Z,GW,Guinea-Bissau,AFRO,0,39,0,0
9105,2020-04-15T00:00:00Z,GW,Guinea-Bissau,AFRO,1,40,0,0
9106,2020-04-16T00:00:00Z,GW,Guinea-Bissau,AFRO,3,43,0,0
9107,2020-04-17T00:00:00Z,GW,Guinea-Bissau,AFRO,3,46,0,0
9108,2020-04-18T00:00:00Z,GW,Guinea-Bissau,AFRO,4,50,0,0
9109,2020-04-19T00:00:00Z,GW,Guinea-Bissau,AFRO,0,50,0,0
9110,2020-04-20T00:00:00Z,GW,Guinea-Bissau,AFRO,0,50,0,0
9111,2020-04-21T00:00:00Z,GW,Guinea-Bissau,AFRO,0,50,0,0
9112,2020-04-22T00:00:00Z,GW,Guinea-Bissau,AFRO,0,50,0,0
9113,2020-04-23T00:00:00Z,GW,Guinea-Bissau,AFRO,0,50,0,0
9114,2020-04-24T00:00:00Z,GW,Guinea-Bissau,AFRO,2,52,0,0
9115,2020-04-25T00:00:00Z,GW,Guinea-Bissau,AFRO,0,52,0,0
9116,2020-04-26T00:00:00Z,GW,Guinea-Bissau,AFRO,0,52,0,0
9117,2020-04-27T00:00:00Z,GW,Guinea-Bissau,AFRO,1,53,1,1
9118,2020-04-28T00:00:00Z,GW,Guinea-Bissau,AFRO,20,73,0,1
9119,2020-04-29T00:00:00Z,GW,Guinea-Bissau,AFRO,0,73,0,1
9120,2020-04-30T00:00:00Z,GW,Guinea-Bissau,AFRO,4,77,0,1
9121,2020-05-01T00:00:00Z,GW,Guinea-Bissau,AFRO,124,201,0,1
9122,2020-05-02T00:00:00Z,GW,Guinea-Bissau,AFRO,56,257,0,1
9123,2020-05-03T00:00:00Z,GW,Guinea-Bissau,AFRO,3,260,0,1
9124,2020-05-04T00:00:00Z,GW,Guinea-Bissau,AFRO,32,292,1,2
9125,2020-05-05T00:00:00Z,GW,Guinea-Bissau,AFRO,0,292,0,2
9126,2020-05-06T00:00:00Z,GW,Guinea-Bissau,AFRO,0,292,0,2
9127,2020-05-07T00:00:00Z,GW,Guinea-Bissau,AFRO,216,508,0,2
9128,2020-05-08T00:00:00Z,GW,Guinea-Bissau,AFRO,0,508,0,2
9129,2020-05-09T00:00:00Z,GW,Guinea-Bissau,AFRO,0,508,0,2
9130,2020-05-10T00:00:00Z,GW,Guinea-Bissau,AFRO,134,642,1,3
9131,2020-05-11T00:00:00Z,GW,Guinea-Bissau,AFRO,0,642,0,3
9132,2020-05-12T00:00:00Z,GW,Guinea-Bissau,AFRO,119,761,0,3
9133,2020-05-13T00:00:00Z,GW,Guinea-Bissau,AFRO,59,820,0,3
9134,2020-05-14T00:00:00Z,GW,Guinea-Bissau,AFRO,16,836,0,3
9135,2020-05-15T00:00:00Z,GW,Guinea-Bissau,AFRO,77,913,0,3
9136,2020-05-16T00:00:00Z,GW,Guinea-Bissau,AFRO,0,913,0,3
9137,2020-05-17T00:00:00Z,GW,Guinea-Bissau,AFRO,0,913,0,3
9138,2020-05-18T00:00:00Z,GW,Guinea-Bissau,AFRO,77,990,1,4
9139,2020-05-19T00:00:00Z,GW,Guinea-Bissau,AFRO,48,1038,2,6
9140,2020-05-20T00:00:00Z,GW,Guinea-Bissau,AFRO,0,1038,0,6
9141,2020-05-21T00:00:00Z,GW,Guinea-Bissau,AFRO,51,1089,0,6
9142,2020-05-22T00:00:00Z,GW,Guinea-Bissau,AFRO,20,1109,0,6
9143,2020-05-23T00:00:00Z,GW,Guinea-Bissau,AFRO,5,1114,0,6
9144,2020-05-24T00:00:00Z,GW,Guinea-Bissau,AFRO,0,1114,0,6
9145,2020-05-25T00:00:00Z,GW,Guinea-Bissau,AFRO,59,1173,0,6
9146,2020-05-26T00:00:00Z,GW,Guinea-Bissau,AFRO,0,1173,0,6
9147,2020-05-27T00:00:00Z,GW,Guinea-Bissau,AFRO,0,1173,0,6
9148,2020-05-28T00:00:00Z,GW,Guinea-Bissau,AFRO,0,1173,0,6
9149,2020-05-29T00:00:00Z,GW,Guinea-Bissau,AFRO,22,1195,2,8
9150,2020-05-30T00:00:00Z,GW,Guinea-Bissau,AFRO,61,1256,0,8
9151,2020-05-31T00:00:00Z,GW,Guinea-Bissau,AFRO,0,1256,0,8
9152,2020-06-01T00:00:00Z,GW,Guinea-Bissau,AFRO,66,1322,0,8
9153,2020-06-02T00:00:00Z,GW,Guinea-Bissau,AFRO,17,1339,0,8
9154,2020-06-03T00:00:00Z,GW,Guinea-Bissau,AFRO,0,1339,0,8
9155,2020-06-04T00:00:00Z,GW,Guinea-Bissau,AFRO,7,1346,1,9
9156,2020-06-05T00:00:00Z,GW,Guinea-Bissau,AFRO,0,1346,0,9
9157,2020-06-06T00:00:00Z,GW,Guinea-Bissau,AFRO,22,1368,3,12
9158,2020-06-07T00:00:00Z,GW,Guinea-Bissau,AFRO,0,1368,0,12
9159,2020-06-08T00:00:00Z,GW,Guinea-Bissau,AFRO,0,1368,0,12
9160,2020-06-09T00:00:00Z,GW,Guinea-Bissau,AFRO,21,1389,0,12
9161,2020-06-10T00:00:00Z,GW,Guinea-Bissau,AFRO,0,1389,0,12
9162,2020-06-11T00:00:00Z,GW,Guinea-Bissau,AFRO,0,1389,0,12
9163,2020-06-12T00:00:00Z,GW,Guinea-Bissau,AFRO,0,1389,0,12
9164,2020-06-13T00:00:00Z,GW,Guinea-Bissau,AFRO,0,1389,0,12
9165,2020-06-14T00:00:00Z,GW,Guinea-Bissau,AFRO,71,1460,3,15
9166,2020-06-15T00:00:00Z,GW,Guinea-Bissau,AFRO,0,1460,0,15
9167,2020-06-16T00:00:00Z,GW,Guinea-Bissau,AFRO,0,1460,0,15
9168,2020-06-17T00:00:00Z,GW,Guinea-Bissau,AFRO,32,1492,0,15
9169,2020-06-18T00:00:00Z,GW,Guinea-Bissau,AFRO,0,1492,0,15
9170,2020-06-19T00:00:00Z,GW,Guinea-Bissau,AFRO,20,1512,1,16
9171,2020-06-20T00:00:00Z,GW,Guinea-Bissau,AFRO,0,1512,0,16
11332,2020-03-14T00:00:00Z,KE,Kenya,AFRO,1,1,0,0
11333,2020-03-15T00:00:00Z,KE,Kenya,AFRO,0,1,0,0
11334,2020-03-16T00:00:00Z,KE,Kenya,AFRO,2,3,0,0
11335,2020-03-17T00:00:00Z,KE,Kenya,AFRO,0,3,0,0
11336,2020-03-18T00:00:00Z,KE,Kenya,AFRO,4,7,0,0
11337,2020-03-19T00:00:00Z,KE,Kenya,AFRO,0,7,0,0
11338,2020-03-20T00:00:00Z,KE,Kenya,AFRO,0,7,0,0
11339,2020-03-21T00:00:00Z,KE,Kenya,AFRO,0,7,0,0
11340,2020-03-22T00:00:00Z,KE,Kenya,AFRO,0,7,0,0
11341,2020-03-23T00:00:00Z,KE,Kenya,AFRO,8,15,0,0
11342,2020-03-24T00:00:00Z,KE,Kenya,AFRO,1,16,0,0
11343,2020-03-25T00:00:00Z,KE,Kenya,AFRO,9,25,0,0
11344,2020-03-26T00:00:00Z,KE,Kenya,AFRO,0,25,0,0
11345,2020-03-27T00:00:00Z,KE,Kenya,AFRO,0,25,1,1
11346,2020-03-28T00:00:00Z,KE,Kenya,AFRO,0,25,0,1
11347,2020-03-29T00:00:00Z,KE,Kenya,AFRO,0,25,0,1
11348,2020-03-30T00:00:00Z,KE,Kenya,AFRO,13,38,0,1
11349,2020-03-31T00:00:00Z,KE,Kenya,AFRO,12,50,0,1
11350,2020-04-01T00:00:00Z,KE,Kenya,AFRO,9,59,0,1
11351,2020-04-02T00:00:00Z,KE,Kenya,AFRO,22,81,0,1
11352,2020-04-03T00:00:00Z,KE,Kenya,AFRO,29,110,2,3
11353,2020-04-04T00:00:00Z,KE,Kenya,AFRO,12,122,1,4
11354,2020-04-05T00:00:00Z,KE,Kenya,AFRO,0,122,0,4
11355,2020-04-06T00:00:00Z,KE,Kenya,AFRO,20,142,0,4
11356,2020-04-07T00:00:00Z,KE,Kenya,AFRO,0,142,0,4
11357,2020-04-08T00:00:00Z,KE,Kenya,AFRO,30,172,2,6
11358,2020-04-09T00:00:00Z,KE,Kenya,AFRO,7,179,0,6
11359,2020-04-10T00:00:00Z,KE,Kenya,AFRO,5,184,1,7
11360,2020-04-11T00:00:00Z,KE,Kenya,AFRO,5,189,0,7
11361,2020-04-12T00:00:00Z,KE,Kenya,AFRO,2,191,0,7
11362,2020-04-13T00:00:00Z,KE,Kenya,AFRO,6,197,1,8
11363,2020-04-14T00:00:00Z,KE,Kenya,AFRO,11,208,1,9
11364,2020-04-15T00:00:00Z,KE,Kenya,AFRO,8,216,0,9
11365,2020-04-16T00:00:00Z,KE,Kenya,AFRO,9,225,1,10
11366,2020-04-17T00:00:00Z,KE,Kenya,AFRO,9,234,1,11
11367,2020-04-18T00:00:00Z,KE,Kenya,AFRO,12,246,0,11
11368,2020-04-19T00:00:00Z,KE,Kenya,AFRO,16,262,1,12
11369,2020-04-20T00:00:00Z,KE,Kenya,AFRO,8,270,2,14
11370,2020-04-21T00:00:00Z,KE,Kenya,AFRO,11,281,0,14
11371,2020-04-22T00:00:00Z,KE,Kenya,AFRO,15,296,0,14
11372,2020-04-23T00:00:00Z,KE,Kenya,AFRO,7,303,0,14
11373,2020-04-24T00:00:00Z,KE,Kenya,AFRO,17,320,0,14
11374,2020-04-25T00:00:00Z,KE,Kenya,AFRO,16,336,0,14
11375,2020-04-26T00:00:00Z,KE,Kenya,AFRO,7,343,0,14
11376,2020-04-27T00:00:00Z,KE,Kenya,AFRO,12,355,0,14
11377,2020-04-28T00:00:00Z,KE,Kenya,AFRO,8,363,0,14
11378,2020-04-29T00:00:00Z,KE,Kenya,AFRO,11,374,0,14
11379,2020-04-30T00:00:00Z,KE,Kenya,AFRO,10,384,1,15
11380,2020-05-01T00:00:00Z,KE,Kenya,AFRO,12,396,2,17
11381,2020-05-02T00:00:00Z,KE,Kenya,AFRO,15,411,4,21
11382,2020-05-03T00:00:00Z,KE,Kenya,AFRO,24,435,1,22
11383,2020-05-04T00:00:00Z,KE,Kenya,AFRO,31,466,2,24
11384,2020-05-05T00:00:00Z,KE,Kenya,AFRO,24,490,0,24
11385,2020-05-06T00:00:00Z,KE,Kenya,AFRO,45,535,2,26
11386,2020-05-07T00:00:00Z,KE,Kenya,AFRO,47,582,0,26
11387,2020-05-08T00:00:00Z,KE,Kenya,AFRO,25,607,3,29
11388,2020-05-09T00:00:00Z,KE,Kenya,AFRO,14,621,0,29
11389,2020-05-10T00:00:00Z,KE,Kenya,AFRO,28,649,1,30
11390,2020-05-11T00:00:00Z,KE,Kenya,AFRO,23,672,2,32
11391,2020-05-12T00:00:00Z,KE,Kenya,AFRO,28,700,1,33
11392,2020-05-13T00:00:00Z,KE,Kenya,AFRO,15,715,3,36
11393,2020-05-14T00:00:00Z,KE,Kenya,AFRO,22,737,4,40
11394,2020-05-15T00:00:00Z,KE,Kenya,AFRO,21,758,2,42
11395,2020-05-16T00:00:00Z,KE,Kenya,AFRO,23,781,4,46
11396,2020-05-17T00:00:00Z,KE,Kenya,AFRO,49,830,4,50
11397,2020-05-18T00:00:00Z,KE,Kenya,AFRO,57,887,0,50
11398,2020-05-19T00:00:00Z,KE,Kenya,AFRO,25,912,0,50
11399,2020-05-20T00:00:00Z,KE,Kenya,AFRO,51,963,0,50
11400,2020-05-21T00:00:00Z,KE,Kenya,AFRO,66,1029,0,50
11401,2020-05-22T00:00:00Z,KE,Kenya,AFRO,80,1109,0,50
11402,2020-05-23T00:00:00Z,KE,Kenya,AFRO,52,1161,0,50
11403,2020-05-24T00:00:00Z,KE,Kenya,AFRO,31,1192,0,50
11404,2020-05-25T00:00:00Z,KE,Kenya,AFRO,22,1214,1,51
11405,2020-05-26T00:00:00Z,KE,Kenya,AFRO,72,1286,1,52
11406,2020-05-27T00:00:00Z,KE,Kenya,AFRO,62,1348,0,52
11407,2020-05-28T00:00:00Z,KE,Kenya,AFRO,123,1471,3,55
11408,2020-05-29T00:00:00Z,KE,Kenya,AFRO,147,1618,3,58
11409,2020-05-30T00:00:00Z,KE,Kenya,AFRO,127,1745,4,62
11410,2020-05-31T00:00:00Z,KE,Kenya,AFRO,143,1888,1,63
11411,2020-06-01T00:00:00Z,KE,Kenya,AFRO,74,1962,1,64
11412,2020-06-02T00:00:00Z,KE,Kenya,AFRO,59,2021,5,69
11413,2020-06-03T00:00:00Z,KE,Kenya,AFRO,72,2093,2,71
11414,2020-06-04T00:00:00Z,KE,Kenya,AFRO,123,2216,3,74
11415,2020-06-05T00:00:00Z,KE,Kenya,AFRO,124,2340,4,78
11416,2020-06-06T00:00:00Z,KE,Kenya,AFRO,134,2474,1,79
11417,2020-06-07T00:00:00Z,KE,Kenya,AFRO,126,2600,4,83
11418,2020-06-08T00:00:00Z,KE,Kenya,AFRO,167,2767,1,84
11419,2020-06-09T00:00:00Z,KE,Kenya,AFRO,95,2862,1,85
11420,2020-06-10T00:00:00Z,KE,Kenya,AFRO,127,2989,3,88
11421,2020-06-11T00:00:00Z,KE,Kenya,AFRO,105,3094,1,89
11422,2020-06-12T00:00:00Z,KE,Kenya,AFRO,121,3215,3,92
11423,2020-06-13T00:00:00Z,KE,Kenya,AFRO,90,3305,4,96
11424,2020-06-14T00:00:00Z,KE,Kenya,AFRO,152,3457,4,100
11425,2020-06-15T00:00:00Z,KE,Kenya,AFRO,137,3594,3,103
11426,2020-06-16T00:00:00Z,KE,Kenya,AFRO,133,3727,1,104
11427,2020-06-17T00:00:00Z,KE,Kenya,AFRO,133,3860,1,105
11428,2020-06-18T00:00:00Z,KE,Kenya,AFRO,184,4044,2,107
11429,2020-06-19T00:00:00Z,KE,Kenya,AFRO,213,4257,10,117
11430,2020-06-20T00:00:00Z,KE,Kenya,AFRO,117,4374,2,119
12065,2020-05-14T00:00:00Z,LS,Lesotho,AFRO,1,1,0,0
12066,2020-05-15T00:00:00Z,LS,Lesotho,AFRO,0,1,0,0
12067,2020-05-16T00:00:00Z,LS,Lesotho,AFRO,0,1,0,0
12068,2020-05-17T00:00:00Z,LS,Lesotho,AFRO,0,1,0,0
12069,2020-05-18T00:00:00Z,LS,Lesotho,AFRO,0,1,0,0
12070,2020-05-19T00:00:00Z,LS,Lesotho,AFRO,0,1,0,0
12071,2020-05-20T00:00:00Z,LS,Lesotho,AFRO,0,1,0,0
12072,2020-05-21T00:00:00Z,LS,Lesotho,AFRO,0,1,0,0
12073,2020-05-22T00:00:00Z,LS,Lesotho,AFRO,0,1,0,0
12074,2020-05-23T00:00:00Z,LS,Lesotho,AFRO,1,2,0,0
12075,2020-05-24T00:00:00Z,LS,Lesotho,AFRO,0,2,0,0
12076,2020-05-25T00:00:00Z,LS,Lesotho,AFRO,0,2,0,0
12077,2020-05-26T00:00:00Z,LS,Lesotho,AFRO,0,2,0,0
12078,2020-05-27T00:00:00Z,LS,Lesotho,AFRO,0,2,0,0
12079,2020-05-28T00:00:00Z,LS,Lesotho,AFRO,0,2,0,0
12080,2020-05-29T00:00:00Z,LS,Lesotho,AFRO,0,2,0,0
12081,2020-05-30T00:00:00Z,LS,Lesotho,AFRO,0,2,0,0
12082,2020-05-31T00:00:00Z,LS,Lesotho,AFRO,0,2,0,0
12083,2020-06-01T00:00:00Z,LS,Lesotho,AFRO,0,2,0,0
12084,2020-06-02T00:00:00Z,LS,Lesotho,AFRO,0,2,0,0
12085,2020-06-03T00:00:00Z,LS,Lesotho,AFRO,0,2,0,0
12086,2020-06-04T00:00:00Z,LS,Lesotho,AFRO,2,4,0,0
12087,2020-06-05T00:00:00Z,LS,Lesotho,AFRO,0,4,0,0
12088,2020-06-06T00:00:00Z,LS,Lesotho,AFRO,0,4,0,0
12089,2020-06-07T00:00:00Z,LS,Lesotho,AFRO,0,4,0,0
12090,2020-06-08T00:00:00Z,LS,Lesotho,AFRO,0,4,0,0
12091,2020-06-09T00:00:00Z,LS,Lesotho,AFRO,0,4,0,0
12092,2020-06-10T00:00:00Z,LS,Lesotho,AFRO,0,4,0,0
12093,2020-06-11T00:00:00Z,LS,Lesotho,AFRO,0,4,0,0
12094,2020-06-12T00:00:00Z,LS,Lesotho,AFRO,0,4,0,0
12095,2020-06-13T00:00:00Z,LS,Lesotho,AFRO,0,4,0,0
12096,2020-06-14T00:00:00Z,LS,Lesotho,AFRO,0,4,0,0
12097,2020-06-15T00:00:00Z,LS,Lesotho,AFRO,0,4,0,0
12098,2020-06-16T00:00:00Z,LS,Lesotho,AFRO,0,4,0,0
12099,2020-06-17T00:00:00Z,LS,Lesotho,AFRO,0,4,0,0
12100,2020-06-18T00:00:00Z,LS,Lesotho,AFRO,0,4,0,0
12101,2020-06-19T00:00:00Z,LS,Lesotho,AFRO,0,4,0,0
12102,2020-06-20T00:00:00Z,LS,Lesotho,AFRO,0,4,0,0
12103,2020-03-17T00:00:00Z,LR,Liberia,AFRO,1,1,0,0
12104,2020-03-18T00:00:00Z,LR,Liberia,AFRO,1,2,0,0
12105,2020-03-19T00:00:00Z,LR,Liberia,AFRO,0,2,0,0
12106,2020-03-20T00:00:00Z,LR,Liberia,AFRO,0,2,0,0
12107,2020-03-21T00:00:00Z,LR,Liberia,AFRO,1,3,0,0
12108,2020-03-22T00:00:00Z,LR,Liberia,AFRO,0,3,0,0
12109,2020-03-23T00:00:00Z,LR,Liberia,AFRO,0,3,0,0
12110,2020-03-24T00:00:00Z,LR,Liberia,AFRO,0,3,0,0
12111,2020-03-25T00:00:00Z,LR,Liberia,AFRO,0,3,0,0
12112,2020-03-26T00:00:00Z,LR,Liberia,AFRO,0,3,0,0
12113,2020-03-27T00:00:00Z,LR,Liberia,AFRO,0,3,0,0
12114,2020-03-28T00:00:00Z,LR,Liberia,AFRO,0,3,0,0
12115,2020-03-29T00:00:00Z,LR,Liberia,AFRO,0,3,0,0
12116,2020-03-30T00:00:00Z,LR,Liberia,AFRO,0,3,0,0
12117,2020-03-31T00:00:00Z,LR,Liberia,AFRO,0,3,0,0
12118,2020-04-01T00:00:00Z,LR,Liberia,AFRO,3,6,0,0
12119,2020-04-02T00:00:00Z,LR,Liberia,AFRO,0,6,0,0
12120,2020-04-03T00:00:00Z,LR,Liberia,AFRO,0,6,0,0
12121,2020-04-04T00:00:00Z,LR,Liberia,AFRO,1,7,0,0
12122,2020-04-05T00:00:00Z,LR,Liberia,AFRO,3,10,1,1
12123,2020-04-06T00:00:00Z,LR,Liberia,AFRO,3,13,2,3
12124,2020-04-07T00:00:00Z,LR,Liberia,AFRO,1,14,0,3
12125,2020-04-08T00:00:00Z,LR,Liberia,AFRO,0,14,0,3
12126,2020-04-09T00:00:00Z,LR,Liberia,AFRO,17,31,1,4
12127,2020-04-10T00:00:00Z,LR,Liberia,AFRO,0,31,0,4
12128,2020-04-11T00:00:00Z,LR,Liberia,AFRO,6,37,1,5
12129,2020-04-12T00:00:00Z,LR,Liberia,AFRO,11,48,0,5
12130,2020-04-13T00:00:00Z,LR,Liberia,AFRO,2,50,0,5
12131,2020-04-14T00:00:00Z,LR,Liberia,AFRO,1,51,1,6
12132,2020-04-15T00:00:00Z,LR,Liberia,AFRO,8,59,0,6
12133,2020-04-16T00:00:00Z,LR,Liberia,AFRO,0,59,0,6
12134,2020-04-17T00:00:00Z,LR,Liberia,AFRO,14,73,0,6
12135,2020-04-18T00:00:00Z,LR,Liberia,AFRO,3,76,1,7
12136,2020-04-19T00:00:00Z,LR,Liberia,AFRO,5,81,0,7
12137,2020-04-20T00:00:00Z,LR,Liberia,AFRO,10,91,1,8
12138,2020-04-21T00:00:00Z,LR,Liberia,AFRO,8,99,0,8
12139,2020-04-22T00:00:00Z,LR,Liberia,AFRO,2,101,0,8
12140,2020-04-23T00:00:00Z,LR,Liberia,AFRO,0,101,0,8
12141,2020-04-24T00:00:00Z,LR,Liberia,AFRO,0,101,0,8
12142,2020-04-25T00:00:00Z,LR,Liberia,AFRO,16,117,0,8
12143,2020-04-26T00:00:00Z,LR,Liberia,AFRO,3,120,3,11
12144,2020-04-27T00:00:00Z,LR,Liberia,AFRO,4,124,1,12
12145,2020-04-28T00:00:00Z,LR,Liberia,AFRO,9,133,4,16
12146,2020-04-29T00:00:00Z,LR,Liberia,AFRO,8,141,0,16
12147,2020-04-30T00:00:00Z,LR,Liberia,AFRO,0,141,0,16
12148,2020-05-01T00:00:00Z,LR,Liberia,AFRO,0,141,0,16
12149,2020-05-02T00:00:00Z,LR,Liberia,AFRO,11,152,2,18
12150,2020-05-03T00:00:00Z,LR,Liberia,AFRO,2,154,0,18
12151,2020-05-04T00:00:00Z,LR,Liberia,AFRO,4,158,0,18
12152,2020-05-05T00:00:00Z,LR,Liberia,AFRO,8,166,0,18
12153,2020-05-06T00:00:00Z,LR,Liberia,AFRO,4,170,2,20
12154,2020-05-07T00:00:00Z,LR,Liberia,AFRO,8,178,0,20
12155,2020-05-08T00:00:00Z,LR,Liberia,AFRO,11,189,0,20
12156,2020-05-09T00:00:00Z,LR,Liberia,AFRO,10,199,0,20
12157,2020-05-10T00:00:00Z,LR,Liberia,AFRO,0,199,0,20
12158,2020-05-11T00:00:00Z,LR,Liberia,AFRO,5,204,0,20
12159,2020-05-12T00:00:00Z,LR,Liberia,AFRO,7,211,0,20
12160,2020-05-13T00:00:00Z,LR,Liberia,AFRO,1,212,0,20
12161,2020-05-14T00:00:00Z,LR,Liberia,AFRO,1,213,0,20
12162,2020-05-15T00:00:00Z,LR,Liberia,AFRO,2,215,0,20
12163,2020-05-16T00:00:00Z,LR,Liberia,AFRO,4,219,0,20
12164,2020-05-17T00:00:00Z,LR,Liberia,AFRO,4,223,0,20
12165,2020-05-18T00:00:00Z,LR,Liberia,AFRO,3,226,1,21
12166,2020-05-19T00:00:00Z,LR,Liberia,AFRO,3,229,1,22
12167,2020-05-20T00:00:00Z,LR,Liberia,AFRO,4,233,1,23
12168,2020-05-21T00:00:00Z,LR,Liberia,AFRO,5,238,0,23
12169,2020-05-22T00:00:00Z,LR,Liberia,AFRO,2,240,0,23
12170,2020-05-23T00:00:00Z,LR,Liberia,AFRO,9,249,1,24
12171,2020-05-24T00:00:00Z,LR,Liberia,AFRO,6,255,2,26
12172,2020-05-25T00:00:00Z,LR,Liberia,AFRO,10,265,0,26
12173,2020-05-26T00:00:00Z,LR,Liberia,AFRO,0,265,0,26
12174,2020-05-27T00:00:00Z,LR,Liberia,AFRO,1,266,0,26
12175,2020-05-28T00:00:00Z,LR,Liberia,AFRO,0,266,1,27
12176,2020-05-29T00:00:00Z,LR,Liberia,AFRO,3,269,0,27
12177,2020-05-30T00:00:00Z,LR,Liberia,AFRO,4,273,0,27
12178,2020-05-31T00:00:00Z,LR,Liberia,AFRO,7,280,0,27
12179,2020-06-01T00:00:00Z,LR,Liberia,AFRO,8,288,0,27
12180,2020-06-02T00:00:00Z,LR,Liberia,AFRO,8,296,0,27
12181,2020-06-03T00:00:00Z,LR,Liberia,AFRO,15,311,1,28
12182,2020-06-04T00:00:00Z,LR,Liberia,AFRO,5,316,0,28
12183,2020-06-05T00:00:00Z,LR,Liberia,AFRO,5,321,0,28
12184,2020-06-06T00:00:00Z,LR,Liberia,AFRO,13,334,2,30
12185,2020-06-07T00:00:00Z,LR,Liberia,AFRO,11,345,0,30
12186,2020-06-08T00:00:00Z,LR,Liberia,AFRO,14,359,0,30
12187,2020-06-09T00:00:00Z,LR,Liberia,AFRO,11,370,0,30
12188,2020-06-10T00:00:00Z,LR,Liberia,AFRO,13,383,1,31
12189,2020-06-11T00:00:00Z,LR,Liberia,AFRO,14,397,0,31
12190,2020-06-12T00:00:00Z,LR,Liberia,AFRO,13,410,0,31
12191,2020-06-13T00:00:00Z,LR,Liberia,AFRO,11,421,1,32
12192,2020-06-14T00:00:00Z,LR,Liberia,AFRO,25,446,0,32
12193,2020-06-15T00:00:00Z,LR,Liberia,AFRO,12,458,0,32
12194,2020-06-16T00:00:00Z,LR,Liberia,AFRO,40,498,1,33
12195,2020-06-17T00:00:00Z,LR,Liberia,AFRO,11,509,0,33
12196,2020-06-18T00:00:00Z,LR,Liberia,AFRO,7,516,0,33
12197,2020-06-19T00:00:00Z,LR,Liberia,AFRO,26,542,0,33
12198,2020-06-20T00:00:00Z,LR,Liberia,AFRO,39,581,0,33
12621,2020-03-21T00:00:00Z,MG,Madagascar,AFRO,3,3,0,0
12622,2020-03-22T00:00:00Z,MG,Madagascar,AFRO,0,3,0,0
12623,2020-03-23T00:00:00Z,MG,Madagascar,AFRO,9,12,0,0
12624,2020-03-24T00:00:00Z,MG,Madagascar,AFRO,1,13,0,0
12625,2020-03-25T00:00:00Z,MG,Madagascar,AFRO,6,19,0,0
12626,2020-03-26T00:00:00Z,MG,Madagascar,AFRO,0,19,0,0
12627,2020-03-27T00:00:00Z,MG,Madagascar,AFRO,5,24,0,0
12628,2020-03-28T00:00:00Z,MG,Madagascar,AFRO,2,26,0,0
12629,2020-03-29T00:00:00Z,MG,Madagascar,AFRO,11,37,0,0
12630,2020-03-30T00:00:00Z,MG,Madagascar,AFRO,7,44,0,0
12631,2020-03-31T00:00:00Z,MG,Madagascar,AFRO,2,46,0,0
12632,2020-04-01T00:00:00Z,MG,Madagascar,AFRO,7,53,0,0
12633,2020-04-02T00:00:00Z,MG,Madagascar,AFRO,6,59,0,0
12634,2020-04-03T00:00:00Z,MG,Madagascar,AFRO,6,65,0,0
12635,2020-04-04T00:00:00Z,MG,Madagascar,AFRO,5,70,0,0
12636,2020-04-05T00:00:00Z,MG,Madagascar,AFRO,0,70,0,0
12637,2020-04-06T00:00:00Z,MG,Madagascar,AFRO,7,77,0,0
12638,2020-04-07T00:00:00Z,MG,Madagascar,AFRO,8,85,0,0
12639,2020-04-08T00:00:00Z,MG,Madagascar,AFRO,7,92,0,0
12640,2020-04-09T00:00:00Z,MG,Madagascar,AFRO,1,93,0,0
12641,2020-04-10T00:00:00Z,MG,Madagascar,AFRO,2,95,0,0
12642,2020-04-11T00:00:00Z,MG,Madagascar,AFRO,0,95,0,0
12643,2020-04-12T00:00:00Z,MG,Madagascar,AFRO,9,104,0,0
12644,2020-04-13T00:00:00Z,MG,Madagascar,AFRO,2,106,0,0
12645,2020-04-14T00:00:00Z,MG,Madagascar,AFRO,0,106,0,0
12646,2020-04-15T00:00:00Z,MG,Madagascar,AFRO,4,110,0,0
12647,2020-04-16T00:00:00Z,MG,Madagascar,AFRO,0,110,0,0
12648,2020-04-17T00:00:00Z,MG,Madagascar,AFRO,7,117,0,0
12649,2020-04-18T00:00:00Z,MG,Madagascar,AFRO,0,117,0,0
12650,2020-04-19T00:00:00Z,MG,Madagascar,AFRO,3,120,0,0
12651,2020-04-20T00:00:00Z,MG,Madagascar,AFRO,1,121,0,0
12652,2020-04-21T00:00:00Z,MG,Madagascar,AFRO,0,121,0,0
12653,2020-04-22T00:00:00Z,MG,Madagascar,AFRO,0,121,0,0
12654,2020-04-23T00:00:00Z,MG,Madagascar,AFRO,0,121,0,0
12655,2020-04-24T00:00:00Z,MG,Madagascar,AFRO,0,121,0,0
12656,2020-04-25T00:00:00Z,MG,Madagascar,AFRO,1,122,0,0
12657,2020-04-26T00:00:00Z,MG,Madagascar,AFRO,2,124,0,0
12658,2020-04-27T00:00:00Z,MG,Madagascar,AFRO,4,128,0,0
12659,2020-04-28T00:00:00Z,MG,Madagascar,AFRO,0,128,0,0
12660,2020-04-29T00:00:00Z,MG,Madagascar,AFRO,0,128,0,0
12661,2020-04-30T00:00:00Z,MG,Madagascar,AFRO,0,128,0,0
12662,2020-05-01T00:00:00Z,MG,Madagascar,AFRO,4,132,0,0
12663,2020-05-02T00:00:00Z,MG,Madagascar,AFRO,3,135,0,0
12664,2020-05-03T00:00:00Z,MG,Madagascar,AFRO,14,149,0,0
12665,2020-05-04T00:00:00Z,MG,Madagascar,AFRO,2,151,0,0
12666,2020-05-05T00:00:00Z,MG,Madagascar,AFRO,7,158,0,0
12667,2020-05-06T00:00:00Z,MG,Madagascar,AFRO,0,158,0,0
12668,2020-05-07T00:00:00Z,MG,Madagascar,AFRO,35,193,0,0
12669,2020-05-08T00:00:00Z,MG,Madagascar,AFRO,0,193,0,0
12670,2020-05-09T00:00:00Z,MG,Madagascar,AFRO,-24,169,0,0
12671,2020-05-10T00:00:00Z,MG,Madagascar,AFRO,0,169,0,0
12672,2020-05-11T00:00:00Z,MG,Madagascar,AFRO,0,169,0,0
12673,2020-05-12T00:00:00Z,MG,Madagascar,AFRO,17,186,0,0
12674,2020-05-13T00:00:00Z,MG,Madagascar,AFRO,6,192,0,0
12675,2020-05-14T00:00:00Z,MG,Madagascar,AFRO,20,212,0,0
12676,2020-05-15T00:00:00Z,MG,Madagascar,AFRO,18,230,0,0
12677,2020-05-16T00:00:00Z,MG,Madagascar,AFRO,8,238,0,0
12678,2020-05-17T00:00:00Z,MG,Madagascar,AFRO,45,283,0,0
12679,2020-05-18T00:00:00Z,MG,Madagascar,AFRO,21,304,1,1
12680,2020-05-19T00:00:00Z,MG,Madagascar,AFRO,18,322,0,1
12681,2020-05-20T00:00:00Z,MG,Madagascar,AFRO,4,326,1,2
12682,2020-05-21T00:00:00Z,MG,Madagascar,AFRO,45,371,0,2
12683,2020-05-22T00:00:00Z,MG,Madagascar,AFRO,34,405,0,2
12684,2020-05-23T00:00:00Z,MG,Madagascar,AFRO,43,448,0,2
12685,2020-05-24T00:00:00Z,MG,Madagascar,AFRO,40,488,0,2
12686,2020-05-25T00:00:00Z,MG,Madagascar,AFRO,39,527,0,2
12687,2020-05-26T00:00:00Z,MG,Madagascar,AFRO,15,542,0,2
12688,2020-05-27T00:00:00Z,MG,Madagascar,AFRO,44,586,0,2
12689,2020-05-28T00:00:00Z,MG,Madagascar,AFRO,26,612,0,2
12690,2020-05-29T00:00:00Z,MG,Madagascar,AFRO,44,656,0,2
12691,2020-05-30T00:00:00Z,MG,Madagascar,AFRO,42,698,3,5
12692,2020-05-31T00:00:00Z,MG,Madagascar,AFRO,60,758,1,6
12693,2020-06-01T00:00:00Z,MG,Madagascar,AFRO,13,771,0,6
12694,2020-06-02T00:00:00Z,MG,Madagascar,AFRO,55,826,0,6
12695,2020-06-03T00:00:00Z,MG,Madagascar,AFRO,19,845,0,6
12696,2020-06-04T00:00:00Z,MG,Madagascar,AFRO,63,908,0,6
12697,2020-06-05T00:00:00Z,MG,Madagascar,AFRO,49,957,1,7
12698,2020-06-06T00:00:00Z,MG,Madagascar,AFRO,18,975,0,7
12699,2020-06-07T00:00:00Z,MG,Madagascar,AFRO,51,1026,1,8
12700,2020-06-08T00:00:00Z,MG,Madagascar,AFRO,26,1052,1,9
12701,2020-06-09T00:00:00Z,MG,Madagascar,AFRO,42,1094,0,9
12702,2020-06-10T00:00:00Z,MG,Madagascar,AFRO,44,1138,0,9
12703,2020-06-11T00:00:00Z,MG,Madagascar,AFRO,24,1162,1,10
12704,2020-06-12T00:00:00Z,MG,Madagascar,AFRO,41,1203,0,10
12705,2020-06-13T00:00:00Z,MG,Madagascar,AFRO,27,1230,0,10
12706,2020-06-14T00:00:00Z,MG,Madagascar,AFRO,22,1252,0,10
12707,2020-06-15T00:00:00Z,MG,Madagascar,AFRO,20,1272,0,10
12708,2020-06-16T00:00:00Z,MG,Madagascar,AFRO,18,1290,0,10
12709,2020-06-17T00:00:00Z,MG,Madagascar,AFRO,27,1317,2,12
12710,2020-06-18T00:00:00Z,MG,Madagascar,AFRO,61,1378,0,12
12711,2020-06-19T00:00:00Z,MG,Madagascar,AFRO,25,1403,1,13
12712,2020-06-20T00:00:00Z,MG,Madagascar,AFRO,40,1443,0,13
12713,2020-04-03T00:00:00Z,MW,Malawi,AFRO,3,3,0,0
12714,2020-04-04T00:00:00Z,MW,Malawi,AFRO,0,3,0,0
12715,2020-04-05T00:00:00Z,MW,Malawi,AFRO,0,3,0,0
12716,2020-04-06T00:00:00Z,MW,Malawi,AFRO,1,4,0,0
12717,2020-04-07T00:00:00Z,MW,Malawi,AFRO,0,4,0,0
12718,2020-04-08T00:00:00Z,MW,Malawi,AFRO,4,8,1,1
12719,2020-04-09T00:00:00Z,MW,Malawi,AFRO,0,8,0,1
12720,2020-04-10T00:00:00Z,MW,Malawi,AFRO,0,8,0,1
12721,2020-04-11T00:00:00Z,MW,Malawi,AFRO,1,9,0,1
12722,2020-04-12T00:00:00Z,MW,Malawi,AFRO,3,12,1,2
12723,2020-04-13T00:00:00Z,MW,Malawi,AFRO,1,13,0,2
12724,2020-04-14T00:00:00Z,MW,Malawi,AFRO,3,16,0,2
12725,2020-04-15T00:00:00Z,MW,Malawi,AFRO,0,16,0,2
12726,2020-04-16T00:00:00Z,MW,Malawi,AFRO,0,16,0,2
12727,2020-04-17T00:00:00Z,MW,Malawi,AFRO,0,16,0,2
12728,2020-04-18T00:00:00Z,MW,Malawi,AFRO,1,17,0,2
12729,2020-04-19T00:00:00Z,MW,Malawi,AFRO,0,17,0,2
12730,2020-04-20T00:00:00Z,MW,Malawi,AFRO,0,17,0,2
12731,2020-04-21T00:00:00Z,MW,Malawi,AFRO,0,17,0,2
12732,2020-04-22T00:00:00Z,MW,Malawi,AFRO,1,18,0,2
12733,2020-04-23T00:00:00Z,MW,Malawi,AFRO,5,23,1,3
12734,2020-04-24T00:00:00Z,MW,Malawi,AFRO,10,33,0,3
12735,2020-04-25T00:00:00Z,MW,Malawi,AFRO,0,33,0,3
12736,2020-04-26T00:00:00Z,MW,Malawi,AFRO,0,33,0,3
12737,2020-04-27T00:00:00Z,MW,Malawi,AFRO,1,34,0,3
12738,2020-04-28T00:00:00Z,MW,Malawi,AFRO,2,36,0,3
12739,2020-04-29T00:00:00Z,MW,Malawi,AFRO,0,36,0,3
12740,2020-04-30T00:00:00Z,MW,Malawi,AFRO,0,36,0,3
12741,2020-05-01T00:00:00Z,MW,Malawi,AFRO,1,37,0,3
12742,2020-05-02T00:00:00Z,MW,Malawi,AFRO,0,37,0,3
12743,2020-05-03T00:00:00Z,MW,Malawi,AFRO,1,38,0,3
12744,2020-05-04T00:00:00Z,MW,Malawi,AFRO,1,39,0,3
12745,2020-05-05T00:00:00Z,MW,Malawi,AFRO,2,41,0,3
12746,2020-05-06T00:00:00Z,MW,Malawi,AFRO,0,41,0,3
12747,2020-05-07T00:00:00Z,MW,Malawi,AFRO,2,43,0,3
12748,2020-05-08T00:00:00Z,MW,Malawi,AFRO,0,43,0,3
12749,2020-05-09T00:00:00Z,MW,Malawi,AFRO,0,43,0,3
12750,2020-05-10T00:00:00Z,MW,Malawi,AFRO,13,56,0,3
12751,2020-05-11T00:00:00Z,MW,Malawi,AFRO,0,56,0,3
12752,2020-05-12T00:00:00Z,MW,Malawi,AFRO,1,57,0,3
12753,2020-05-13T00:00:00Z,MW,Malawi,AFRO,1,58,0,3
12754,2020-05-14T00:00:00Z,MW,Malawi,AFRO,5,63,0,3
12755,2020-05-15T00:00:00Z,MW,Malawi,AFRO,0,63,0,3
12756,2020-05-16T00:00:00Z,MW,Malawi,AFRO,0,63,0,3
12757,2020-05-17T00:00:00Z,MW,Malawi,AFRO,2,65,0,3
12758,2020-05-18T00:00:00Z,MW,Malawi,AFRO,5,70,0,3
12759,2020-05-19T00:00:00Z,MW,Malawi,AFRO,0,70,0,3
12760,2020-05-20T00:00:00Z,MW,Malawi,AFRO,1,71,0,3
12761,2020-05-21T00:00:00Z,MW,Malawi,AFRO,1,72,0,3
12762,2020-05-22T00:00:00Z,MW,Malawi,AFRO,0,72,0,3
12763,2020-05-23T00:00:00Z,MW,Malawi,AFRO,10,82,0,3
12764,2020-05-24T00:00:00Z,MW,Malawi,AFRO,1,83,1,4
12765,2020-05-25T00:00:00Z,MW,Malawi,AFRO,0,83,0,4
12766,2020-05-26T00:00:00Z,MW,Malawi,AFRO,18,101,0,4
12767,2020-05-27T00:00:00Z,MW,Malawi,AFRO,0,101,0,4
12768,2020-05-28T00:00:00Z,MW,Malawi,AFRO,0,101,0,4
12769,2020-05-29T00:00:00Z,MW,Malawi,AFRO,102,203,0,4
12770,2020-05-30T00:00:00Z,MW,Malawi,AFRO,70,273,0,4
12771,2020-05-31T00:00:00Z,MW,Malawi,AFRO,6,279,0,4
12772,2020-06-01T00:00:00Z,MW,Malawi,AFRO,5,284,0,4
12773,2020-06-02T00:00:00Z,MW,Malawi,AFRO,52,336,0,4
12774,2020-06-03T00:00:00Z,MW,Malawi,AFRO,22,358,0,4
12775,2020-06-04T00:00:00Z,MW,Malawi,AFRO,11,369,0,4
12776,2020-06-05T00:00:00Z,MW,Malawi,AFRO,24,393,0,4
12777,2020-06-06T00:00:00Z,MW,Malawi,AFRO,16,409,0,4
12778,2020-06-07T00:00:00Z,MW,Malawi,AFRO,0,409,0,4
12779,2020-06-08T00:00:00Z,MW,Malawi,AFRO,29,438,0,4
12780,2020-06-09T00:00:00Z,MW,Malawi,AFRO,5,443,0,4
12781,2020-06-10T00:00:00Z,MW,Malawi,AFRO,12,455,0,4
12782,2020-06-11T00:00:00Z,MW,Malawi,AFRO,0,455,0,4
12783,2020-06-12T00:00:00Z,MW,Malawi,AFRO,26,481,0,4
12784,2020-06-13T00:00:00Z,MW,Malawi,AFRO,0,481,0,4
12785,2020-06-14T00:00:00Z,MW,Malawi,AFRO,48,529,1,5
12786,2020-06-15T00:00:00Z,MW,Malawi,AFRO,18,547,1,6
12787,2020-06-16T00:00:00Z,MW,Malawi,AFRO,9,556,0,6
12788,2020-06-17T00:00:00Z,MW,Malawi,AFRO,8,564,0,6
12789,2020-06-18T00:00:00Z,MW,Malawi,AFRO,8,572,0,6
12790,2020-06-19T00:00:00Z,MW,Malawi,AFRO,20,592,2,8
12791,2020-06-20T00:00:00Z,MW,Malawi,AFRO,56,648,0,8
13046,2020-03-26T00:00:00Z,ML,Mali,AFRO,2,2,0,0
13047,2020-03-27T00:00:00Z,ML,Mali,AFRO,0,2,0,0
13048,2020-03-28T00:00:00Z,ML,Mali,AFRO,7,9,0,0
13049,2020-03-29T00:00:00Z,ML,Mali,AFRO,9,18,0,0
13050,2020-03-30T00:00:00Z,ML,Mali,AFRO,0,18,0,0
13051,2020-03-31T00:00:00Z,ML,Mali,AFRO,0,18,0,0
13052,2020-04-01T00:00:00Z,ML,Mali,AFRO,0,18,0,0
13053,2020-04-02T00:00:00Z,ML,Mali,AFRO,10,28,0,0
13054,2020-04-03T00:00:00Z,ML,Mali,AFRO,0,28,3,3
13055,2020-04-04T00:00:00Z,ML,Mali,AFRO,8,36,0,3
13056,2020-04-05T00:00:00Z,ML,Mali,AFRO,3,39,1,4
13057,2020-04-06T00:00:00Z,ML,Mali,AFRO,0,39,0,4
13058,2020-04-07T00:00:00Z,ML,Mali,AFRO,0,39,0,4
13059,2020-04-08T00:00:00Z,ML,Mali,AFRO,8,47,1,5
13060,2020-04-09T00:00:00Z,ML,Mali,AFRO,9,56,1,6
13061,2020-04-10T00:00:00Z,ML,Mali,AFRO,3,59,1,7
13062,2020-04-11T00:00:00Z,ML,Mali,AFRO,15,74,0,7
13063,2020-04-12T00:00:00Z,ML,Mali,AFRO,13,87,0,7
13064,2020-04-13T00:00:00Z,ML,Mali,AFRO,0,87,0,7
13065,2020-04-14T00:00:00Z,ML,Mali,AFRO,29,116,2,9
13066,2020-04-15T00:00:00Z,ML,Mali,AFRO,7,123,1,10
13067,2020-04-16T00:00:00Z,ML,Mali,AFRO,21,144,3,13
13068,2020-04-17T00:00:00Z,ML,Mali,AFRO,27,171,0,13
13069,2020-04-18T00:00:00Z,ML,Mali,AFRO,19,190,0,13
13070,2020-04-19T00:00:00Z,ML,Mali,AFRO,26,216,0,13
13071,2020-04-20T00:00:00Z,ML,Mali,AFRO,8,224,1,14
13072,2020-04-21T00:00:00Z,ML,Mali,AFRO,22,246,0,14
13073,2020-04-22T00:00:00Z,ML,Mali,AFRO,12,258,0,14
13074,2020-04-23T00:00:00Z,ML,Mali,AFRO,35,293,3,17
13075,2020-04-24T00:00:00Z,ML,Mali,AFRO,16,309,4,21
13076,2020-04-25T00:00:00Z,ML,Mali,AFRO,16,325,0,21
13077,2020-04-26T00:00:00Z,ML,Mali,AFRO,45,370,0,21
13078,2020-04-27T00:00:00Z,ML,Mali,AFRO,19,389,2,23
13079,2020-04-28T00:00:00Z,ML,Mali,AFRO,19,408,0,23
13080,2020-04-29T00:00:00Z,ML,Mali,AFRO,16,424,1,24
13081,2020-04-30T00:00:00Z,ML,Mali,AFRO,58,482,1,25
13082,2020-05-01T00:00:00Z,ML,Mali,AFRO,8,490,1,26
13083,2020-05-02T00:00:00Z,ML,Mali,AFRO,18,508,0,26
13084,2020-05-03T00:00:00Z,ML,Mali,AFRO,36,544,0,26
13085,2020-05-04T00:00:00Z,ML,Mali,AFRO,19,563,1,27
13086,2020-05-05T00:00:00Z,ML,Mali,AFRO,17,580,2,29
13087,2020-05-06T00:00:00Z,ML,Mali,AFRO,32,612,3,32
13088,2020-05-07T00:00:00Z,ML,Mali,AFRO,19,631,0,32
13089,2020-05-08T00:00:00Z,ML,Mali,AFRO,19,650,0,32
13090,2020-05-09T00:00:00Z,ML,Mali,AFRO,18,668,3,35
13091,2020-05-10T00:00:00Z,ML,Mali,AFRO,24,692,2,37
13092,2020-05-11T00:00:00Z,ML,Mali,AFRO,12,704,1,38
13093,2020-05-12T00:00:00Z,ML,Mali,AFRO,8,712,1,39
13094,2020-05-13T00:00:00Z,ML,Mali,AFRO,18,730,1,40
13095,2020-05-14T00:00:00Z,ML,Mali,AFRO,28,758,4,44
13096,2020-05-15T00:00:00Z,ML,Mali,AFRO,21,779,2,46
13097,2020-05-16T00:00:00Z,ML,Mali,AFRO,27,806,0,46
13098,2020-05-17T00:00:00Z,ML,Mali,AFRO,29,835,2,48
13099,2020-05-18T00:00:00Z,ML,Mali,AFRO,25,860,4,52
13100,2020-05-19T00:00:00Z,ML,Mali,AFRO,14,874,0,52
13101,2020-05-20T00:00:00Z,ML,Mali,AFRO,27,901,1,53
13102,2020-05-21T00:00:00Z,ML,Mali,AFRO,30,931,2,55
13103,2020-05-22T00:00:00Z,ML,Mali,AFRO,0,931,0,55
13104,2020-05-23T00:00:00Z,ML,Mali,AFRO,38,969,7,62
13105,2020-05-24T00:00:00Z,ML,Mali,AFRO,46,1015,0,62
13106,2020-05-25T00:00:00Z,ML,Mali,AFRO,15,1030,3,65
13107,2020-05-26T00:00:00Z,ML,Mali,AFRO,29,1059,2,67
13108,2020-05-27T00:00:00Z,ML,Mali,AFRO,18,1077,3,70
13109,2020-05-28T00:00:00Z,ML,Mali,AFRO,39,1116,0,70
13110,2020-05-29T00:00:00Z,ML,Mali,AFRO,78,1194,2,72
13111,2020-05-30T00:00:00Z,ML,Mali,AFRO,32,1226,1,73
13112,2020-05-31T00:00:00Z,ML,Mali,AFRO,24,1250,3,76
13113,2020-06-01T00:00:00Z,ML,Mali,AFRO,15,1265,1,77
13114,2020-06-02T00:00:00Z,ML,Mali,AFRO,50,1315,1,78
13115,2020-06-03T00:00:00Z,ML,Mali,AFRO,36,1351,0,78
13116,2020-06-04T00:00:00Z,ML,Mali,AFRO,35,1386,1,79
13117,2020-06-05T00:00:00Z,ML,Mali,AFRO,75,1461,6,85
13118,2020-06-06T00:00:00Z,ML,Mali,AFRO,24,1485,2,87
13119,2020-06-07T00:00:00Z,ML,Mali,AFRO,38,1523,3,90
13120,2020-06-08T00:00:00Z,ML,Mali,AFRO,10,1533,2,92
13121,2020-06-09T00:00:00Z,ML,Mali,AFRO,14,1547,0,92
13122,2020-06-10T00:00:00Z,ML,Mali,AFRO,39,1586,2,94
13123,2020-06-11T00:00:00Z,ML,Mali,AFRO,81,1667,2,96
13124,2020-06-12T00:00:00Z,ML,Mali,AFRO,55,1722,1,97
13125,2020-06-13T00:00:00Z,ML,Mali,AFRO,30,1752,4,101
13126,2020-06-14T00:00:00Z,ML,Mali,AFRO,24,1776,3,104
13127,2020-06-15T00:00:00Z,ML,Mali,AFRO,33,1809,0,104
13128,2020-06-16T00:00:00Z,ML,Mali,AFRO,51,1860,0,104
13129,2020-06-17T00:00:00Z,ML,Mali,AFRO,25,1885,2,106
13130,2020-06-18T00:00:00Z,ML,Mali,AFRO,5,1890,1,107
13131,2020-06-19T00:00:00Z,ML,Mali,AFRO,16,1906,0,107
13132,2020-06-20T00:00:00Z,ML,Mali,AFRO,17,1923,1,108
13345,2020-03-14T00:00:00Z,MR,Mauritania,AFRO,1,1,0,0
13346,2020-03-15T00:00:00Z,MR,Mauritania,AFRO,0,1,0,0
13347,2020-03-16T00:00:00Z,MR,Mauritania,AFRO,0,1,0,0
13348,2020-03-17T00:00:00Z,MR,Mauritania,AFRO,0,1,0,0
13349,2020-03-18T00:00:00Z,MR,Mauritania,AFRO,1,2,0,0
13350,2020-03-19T00:00:00Z,MR,Mauritania,AFRO,0,2,0,0
13351,2020-03-20T00:00:00Z,MR,Mauritania,AFRO,0,2,0,0
13352,2020-03-21T00:00:00Z,MR,Mauritania,AFRO,0,2,0,0
13353,2020-03-22T00:00:00Z,MR,Mauritania,AFRO,0,2,0,0
13354,2020-03-23T00:00:00Z,MR,Mauritania,AFRO,0,2,0,0
13355,2020-03-24T00:00:00Z,MR,Mauritania,AFRO,0,2,0,0
13356,2020-03-25T00:00:00Z,MR,Mauritania,AFRO,0,2,0,0
13357,2020-03-26T00:00:00Z,MR,Mauritania,AFRO,0,2,0,0
13358,2020-03-27T00:00:00Z,MR,Mauritania,AFRO,1,3,0,0
13359,2020-03-28T00:00:00Z,MR,Mauritania,AFRO,2,5,0,0
13360,2020-03-29T00:00:00Z,MR,Mauritania,AFRO,0,5,0,0
13361,2020-03-30T00:00:00Z,MR,Mauritania,AFRO,0,5,0,0
13362,2020-03-31T00:00:00Z,MR,Mauritania,AFRO,0,5,0,0
13363,2020-04-01T00:00:00Z,MR,Mauritania,AFRO,0,5,0,0
13364,2020-04-02T00:00:00Z,MR,Mauritania,AFRO,0,5,0,0
13365,2020-04-03T00:00:00Z,MR,Mauritania,AFRO,0,5,0,0
13366,2020-04-04T00:00:00Z,MR,Mauritania,AFRO,1,6,1,1
13367,2020-04-05T00:00:00Z,MR,Mauritania,AFRO,0,6,0,1
13368,2020-04-06T00:00:00Z,MR,Mauritania,AFRO,0,6,0,1
13369,2020-04-07T00:00:00Z,MR,Mauritania,AFRO,0,6,0,1
13370,2020-04-08T00:00:00Z,MR,Mauritania,AFRO,0,6,0,1
13371,2020-04-09T00:00:00Z,MR,Mauritania,AFRO,0,6,0,1
13372,2020-04-10T00:00:00Z,MR,Mauritania,AFRO,0,6,0,1
13373,2020-04-11T00:00:00Z,MR,Mauritania,AFRO,1,7,0,1
13374,2020-04-12T00:00:00Z,MR,Mauritania,AFRO,0,7,0,1
13375,2020-04-13T00:00:00Z,MR,Mauritania,AFRO,0,7,0,1
13376,2020-04-14T00:00:00Z,MR,Mauritania,AFRO,0,7,0,1
13377,2020-04-15T00:00:00Z,MR,Mauritania,AFRO,0,7,0,1
13378,2020-04-16T00:00:00Z,MR,Mauritania,AFRO,0,7,0,1
13379,2020-04-17T00:00:00Z,MR,Mauritania,AFRO,0,7,0,1
13380,2020-04-18T00:00:00Z,MR,Mauritania,AFRO,0,7,0,1
13381,2020-04-19T00:00:00Z,MR,Mauritania,AFRO,0,7,0,1
13382,2020-04-20T00:00:00Z,MR,Mauritania,AFRO,0,7,0,1
13383,2020-04-21T00:00:00Z,MR,Mauritania,AFRO,0,7,0,1
13384,2020-04-22T00:00:00Z,MR,Mauritania,AFRO,0,7,0,1
13385,2020-04-23T00:00:00Z,MR,Mauritania,AFRO,0,7,0,1
13386,2020-04-24T00:00:00Z,MR,Mauritania,AFRO,0,7,0,1
13387,2020-04-25T00:00:00Z,MR,Mauritania,AFRO,0,7,0,1
13388,2020-04-26T00:00:00Z,MR,Mauritania,AFRO,0,7,0,1
13389,2020-04-27T00:00:00Z,MR,Mauritania,AFRO,0,7,0,1
13390,2020-04-28T00:00:00Z,MR,Mauritania,AFRO,0,7,0,1
13391,2020-04-29T00:00:00Z,MR,Mauritania,AFRO,0,7,0,1
13392,2020-04-30T00:00:00Z,MR,Mauritania,AFRO,0,7,0,1
13393,2020-05-01T00:00:00Z,MR,Mauritania,AFRO,1,8,0,1
13394,2020-05-02T00:00:00Z,MR,Mauritania,AFRO,0,8,0,1
13395,2020-05-03T00:00:00Z,MR,Mauritania,AFRO,0,8,0,1
13396,2020-05-04T00:00:00Z,MR,Mauritania,AFRO,0,8,0,1
13397,2020-05-05T00:00:00Z,MR,Mauritania,AFRO,0,8,0,1
13398,2020-05-06T00:00:00Z,MR,Mauritania,AFRO,0,8,0,1
13399,2020-05-07T00:00:00Z,MR,Mauritania,AFRO,0,8,0,1
13400,2020-05-08T00:00:00Z,MR,Mauritania,AFRO,0,8,0,1
13401,2020-05-09T00:00:00Z,MR,Mauritania,AFRO,0,8,0,1
13402,2020-05-10T00:00:00Z,MR,Mauritania,AFRO,0,8,0,1
13403,2020-05-11T00:00:00Z,MR,Mauritania,AFRO,0,8,0,1
13404,2020-05-12T00:00:00Z,MR,Mauritania,AFRO,0,8,0,1
13405,2020-05-13T00:00:00Z,MR,Mauritania,AFRO,0,8,0,1
13406,2020-05-14T00:00:00Z,MR,Mauritania,AFRO,1,9,0,1
13407,2020-05-15T00:00:00Z,MR,Mauritania,AFRO,7,16,1,2
13408,2020-05-16T00:00:00Z,MR,Mauritania,AFRO,13,29,1,3
13409,2020-05-17T00:00:00Z,MR,Mauritania,AFRO,11,40,1,4
13410,2020-05-18T00:00:00Z,MR,Mauritania,AFRO,22,62,0,4
13411,2020-05-19T00:00:00Z,MR,Mauritania,AFRO,19,81,0,4
13412,2020-05-20T00:00:00Z,MR,Mauritania,AFRO,50,131,0,4
13413,2020-05-21T00:00:00Z,MR,Mauritania,AFRO,10,141,0,4
13414,2020-05-22T00:00:00Z,MR,Mauritania,AFRO,32,173,1,5
13415,2020-05-23T00:00:00Z,MR,Mauritania,AFRO,0,173,0,5
13416,2020-05-24T00:00:00Z,MR,Mauritania,AFRO,54,227,1,6
13417,2020-05-25T00:00:00Z,MR,Mauritania,AFRO,10,237,0,6
13418,2020-05-26T00:00:00Z,MR,Mauritania,AFRO,25,262,3,9
13419,2020-05-27T00:00:00Z,MR,Mauritania,AFRO,0,262,0,9
13420,2020-05-28T00:00:00Z,MR,Mauritania,AFRO,30,292,7,16
13421,2020-05-29T00:00:00Z,MR,Mauritania,AFRO,54,346,3,19
13422,2020-05-30T00:00:00Z,MR,Mauritania,AFRO,77,423,1,20
13423,2020-05-31T00:00:00Z,MR,Mauritania,AFRO,60,483,1,21
13424,2020-06-01T00:00:00Z,MR,Mauritania,AFRO,47,530,2,23
13425,2020-06-02T00:00:00Z,MR,Mauritania,AFRO,0,530,0,23
13426,2020-06-03T00:00:00Z,MR,Mauritania,AFRO,58,588,3,26
13427,2020-06-04T00:00:00Z,MR,Mauritania,AFRO,80,668,5,31
13428,2020-06-05T00:00:00Z,MR,Mauritania,AFRO,116,784,8,39
13429,2020-06-06T00:00:00Z,MR,Mauritania,AFRO,99,883,4,43
13430,2020-06-07T00:00:00Z,MR,Mauritania,AFRO,64,947,0,43
13431,2020-06-08T00:00:00Z,MR,Mauritania,AFRO,0,947,0,43
13432,2020-06-09T00:00:00Z,MR,Mauritania,AFRO,102,1049,0,43
13433,2020-06-10T00:00:00Z,MR,Mauritania,AFRO,113,1162,20,63
13434,2020-06-11T00:00:00Z,MR,Mauritania,AFRO,121,1283,8,71
13435,2020-06-12T00:00:00Z,MR,Mauritania,AFRO,0,1283,0,71
13436,2020-06-13T00:00:00Z,MR,Mauritania,AFRO,156,1439,3,74
13437,2020-06-14T00:00:00Z,MR,Mauritania,AFRO,134,1573,7,81
13438,2020-06-15T00:00:00Z,MR,Mauritania,AFRO,210,1783,6,87
13439,2020-06-16T00:00:00Z,MR,Mauritania,AFRO,0,1783,0,87
13440,2020-06-17T00:00:00Z,MR,Mauritania,AFRO,104,1887,4,91
13441,2020-06-18T00:00:00Z,MR,Mauritania,AFRO,170,2057,2,93
13442,2020-06-19T00:00:00Z,MR,Mauritania,AFRO,166,2223,2,95
13443,2020-06-20T00:00:00Z,MR,Mauritania,AFRO,201,2424,2,97
13444,2020-03-18T00:00:00Z,MU,Mauritius,AFRO,3,3,0,0
13445,2020-03-19T00:00:00Z,MU,Mauritius,AFRO,4,7,0,0
13446,2020-03-20T00:00:00Z,MU,Mauritius,AFRO,5,12,0,0
13447,2020-03-21T00:00:00Z,MU,Mauritius,AFRO,0,12,0,0
13448,2020-03-22T00:00:00Z,MU,Mauritius,AFRO,0,12,0,0
13449,2020-03-23T00:00:00Z,MU,Mauritius,AFRO,0,12,0,0
13450,2020-03-24T00:00:00Z,MU,Mauritius,AFRO,24,36,0,0
13451,2020-03-25T00:00:00Z,MU,Mauritius,AFRO,6,42,2,2
13452,2020-03-26T00:00:00Z,MU,Mauritius,AFRO,5,47,0,2
13453,2020-03-27T00:00:00Z,MU,Mauritius,AFRO,34,81,0,2
13454,2020-03-28T00:00:00Z,MU,Mauritius,AFRO,15,96,0,2
13455,2020-03-29T00:00:00Z,MU,Mauritius,AFRO,6,102,0,2
13456,2020-03-30T00:00:00Z,MU,Mauritius,AFRO,0,102,0,2
13457,2020-03-31T00:00:00Z,MU,Mauritius,AFRO,26,128,0,2
13458,2020-04-01T00:00:00Z,MU,Mauritius,AFRO,15,143,3,5
13459,2020-04-02T00:00:00Z,MU,Mauritius,AFRO,11,154,0,5
13460,2020-04-03T00:00:00Z,MU,Mauritius,AFRO,15,169,2,7
13461,2020-04-04T00:00:00Z,MU,Mauritius,AFRO,17,186,0,7
13462,2020-04-05T00:00:00Z,MU,Mauritius,AFRO,10,196,0,7
13463,2020-04-06T00:00:00Z,MU,Mauritius,AFRO,31,227,0,7
13464,2020-04-07T00:00:00Z,MU,Mauritius,AFRO,17,244,0,7
13465,2020-04-08T00:00:00Z,MU,Mauritius,AFRO,24,268,0,7
13466,2020-04-09T00:00:00Z,MU,Mauritius,AFRO,5,273,0,7
13467,2020-04-10T00:00:00Z,MU,Mauritius,AFRO,41,314,0,7
13468,2020-04-11T00:00:00Z,MU,Mauritius,AFRO,4,318,2,9
13469,2020-04-12T00:00:00Z,MU,Mauritius,AFRO,1,319,0,9
13470,2020-04-13T00:00:00Z,MU,Mauritius,AFRO,5,324,0,9
13471,2020-04-14T00:00:00Z,MU,Mauritius,AFRO,0,324,0,9
13472,2020-04-15T00:00:00Z,MU,Mauritius,AFRO,0,324,0,9
13473,2020-04-16T00:00:00Z,MU,Mauritius,AFRO,0,324,0,9
13474,2020-04-17T00:00:00Z,MU,Mauritius,AFRO,0,324,0,9
13475,2020-04-18T00:00:00Z,MU,Mauritius,AFRO,0,324,0,9
13476,2020-04-19T00:00:00Z,MU,Mauritius,AFRO,1,325,0,9
13477,2020-04-20T00:00:00Z,MU,Mauritius,AFRO,3,328,0,9
13478,2020-04-21T00:00:00Z,MU,Mauritius,AFRO,0,328,0,9
13479,2020-04-22T00:00:00Z,MU,Mauritius,AFRO,0,328,0,9
13480,2020-04-23T00:00:00Z,MU,Mauritius,AFRO,1,329,0,9
13481,2020-04-24T00:00:00Z,MU,Mauritius,AFRO,2,331,0,9
13482,2020-04-25T00:00:00Z,MU,Mauritius,AFRO,0,331,0,9
13483,2020-04-26T00:00:00Z,MU,Mauritius,AFRO,0,331,0,9
13484,2020-04-27T00:00:00Z,MU,Mauritius,AFRO,1,332,0,9
13485,2020-04-28T00:00:00Z,MU,Mauritius,AFRO,0,332,0,9
13486,2020-04-29T00:00:00Z,MU,Mauritius,AFRO,0,332,1,10
13487,2020-04-30T00:00:00Z,MU,Mauritius,AFRO,0,332,0,10
13488,2020-05-01T00:00:00Z,MU,Mauritius,AFRO,0,332,0,10
13489,2020-05-02T00:00:00Z,MU,Mauritius,AFRO,0,332,0,10
13490,2020-05-03T00:00:00Z,MU,Mauritius,AFRO,0,332,0,10
13491,2020-05-04T00:00:00Z,MU,Mauritius,AFRO,0,332,0,10
13492,2020-05-05T00:00:00Z,MU,Mauritius,AFRO,0,332,0,10
13493,2020-05-06T00:00:00Z,MU,Mauritius,AFRO,0,332,0,10
13494,2020-05-07T00:00:00Z,MU,Mauritius,AFRO,0,332,0,10
13495,2020-05-08T00:00:00Z,MU,Mauritius,AFRO,0,332,0,10
13496,2020-05-09T00:00:00Z,MU,Mauritius,AFRO,0,332,0,10
13497,2020-05-10T00:00:00Z,MU,Mauritius,AFRO,0,332,0,10
13498,2020-05-11T00:00:00Z,MU,Mauritius,AFRO,0,332,0,10
13499,2020-05-12T00:00:00Z,MU,Mauritius,AFRO,0,332,0,10
13500,2020-05-13T00:00:00Z,MU,Mauritius,AFRO,0,332,0,10
13501,2020-05-14T00:00:00Z,MU,Mauritius,AFRO,0,332,0,10
13502,2020-05-15T00:00:00Z,MU,Mauritius,AFRO,0,332,0,10
13503,2020-05-16T00:00:00Z,MU,Mauritius,AFRO,0,332,0,10
13504,2020-05-17T00:00:00Z,MU,Mauritius,AFRO,0,332,0,10
13505,2020-05-18T00:00:00Z,MU,Mauritius,AFRO,0,332,0,10
13506,2020-05-19T00:00:00Z,MU,Mauritius,AFRO,0,332,0,10
13507,2020-05-20T00:00:00Z,MU,Mauritius,AFRO,0,332,0,10
13508,2020-05-21T00:00:00Z,MU,Mauritius,AFRO,0,332,0,10
13509,2020-05-22T00:00:00Z,MU,Mauritius,AFRO,0,332,0,10
13510,2020-05-23T00:00:00Z,MU,Mauritius,AFRO,0,332,0,10
13511,2020-05-24T00:00:00Z,MU,Mauritius,AFRO,0,332,0,10
13512,2020-05-25T00:00:00Z,MU,Mauritius,AFRO,2,334,0,10
13513,2020-05-26T00:00:00Z,MU,Mauritius,AFRO,0,334,0,10
13514,2020-05-27T00:00:00Z,MU,Mauritius,AFRO,0,334,0,10
13515,2020-05-28T00:00:00Z,MU,Mauritius,AFRO,0,334,0,10
13516,2020-05-29T00:00:00Z,MU,Mauritius,AFRO,0,334,0,10
13517,2020-05-30T00:00:00Z,MU,Mauritius,AFRO,1,335,0,10
13518,2020-05-31T00:00:00Z,MU,Mauritius,AFRO,0,335,0,10
13519,2020-06-01T00:00:00Z,MU,Mauritius,AFRO,0,335,0,10
13520,2020-06-02T00:00:00Z,MU,Mauritius,AFRO,0,335,0,10
13521,2020-06-03T00:00:00Z,MU,Mauritius,AFRO,0,335,0,10
13522,2020-06-04T00:00:00Z,MU,Mauritius,AFRO,0,335,0,10
13523,2020-06-05T00:00:00Z,MU,Mauritius,AFRO,0,335,0,10
13524,2020-06-06T00:00:00Z,MU,Mauritius,AFRO,2,337,0,10
13525,2020-06-07T00:00:00Z,MU,Mauritius,AFRO,0,337,0,10
13526,2020-06-08T00:00:00Z,MU,Mauritius,AFRO,0,337,0,10
13527,2020-06-09T00:00:00Z,MU,Mauritius,AFRO,0,337,0,10
13528,2020-06-10T00:00:00Z,MU,Mauritius,AFRO,0,337,0,10
13529,2020-06-11T00:00:00Z,MU,Mauritius,AFRO,0,337,0,10
13530,2020-06-12T00:00:00Z,MU,Mauritius,AFRO,0,337,0,10
13531,2020-06-13T00:00:00Z,MU,Mauritius,AFRO,0,337,0,10
13532,2020-06-14T00:00:00Z,MU,Mauritius,AFRO,0,337,0,10
13533,2020-06-15T00:00:00Z,MU,Mauritius,AFRO,0,337,0,10
13534,2020-06-16T00:00:00Z,MU,Mauritius,AFRO,0,337,0,10
13535,2020-06-17T00:00:00Z,MU,Mauritius,AFRO,0,337,0,10
13536,2020-06-18T00:00:00Z,MU,Mauritius,AFRO,0,337,0,10
13537,2020-06-19T00:00:00Z,MU,Mauritius,AFRO,0,337,0,10
13538,2020-06-20T00:00:00Z,MU,Mauritius,AFRO,0,337,0,10
13539,2020-03-14T00:00:00Z,YT,Mayotte,AFRO,1,1,0,0
13540,2020-03-15T00:00:00Z,YT,Mayotte,AFRO,0,1,0,0
13541,2020-03-16T00:00:00Z,YT,Mayotte,AFRO,0,1,0,0
13542,2020-03-17T00:00:00Z,YT,Mayotte,AFRO,0,1,0,0
13543,2020-03-18T00:00:00Z,YT,Mayotte,AFRO,2,3,0,0
13544,2020-03-19T00:00:00Z,YT,Mayotte,AFRO,1,4,0,0
13545,2020-03-20T00:00:00Z,YT,Mayotte,AFRO,0,4,0,0
13546,2020-03-21T00:00:00Z,YT,Mayotte,AFRO,7,11,0,0
13547,2020-03-22T00:00:00Z,YT,Mayotte,AFRO,0,11,0,0
13548,2020-03-23T00:00:00Z,YT,Mayotte,AFRO,3,14,0,0
13549,2020-03-24T00:00:00Z,YT,Mayotte,AFRO,10,24,0,0
13550,2020-03-25T00:00:00Z,YT,Mayotte,AFRO,6,30,0,0
13551,2020-03-26T00:00:00Z,YT,Mayotte,AFRO,5,35,0,0
13552,2020-03-27T00:00:00Z,YT,Mayotte,AFRO,15,50,0,0
13553,2020-03-28T00:00:00Z,YT,Mayotte,AFRO,0,50,0,0
13554,2020-03-29T00:00:00Z,YT,Mayotte,AFRO,0,50,0,0
13555,2020-03-30T00:00:00Z,YT,Mayotte,AFRO,32,82,0,0
13556,2020-03-31T00:00:00Z,YT,Mayotte,AFRO,0,82,0,0
13557,2020-04-01T00:00:00Z,YT,Mayotte,AFRO,19,101,0,0
13558,2020-04-02T00:00:00Z,YT,Mayotte,AFRO,15,116,2,2
13559,2020-04-03T00:00:00Z,YT,Mayotte,AFRO,12,128,0,2
13560,2020-04-04T00:00:00Z,YT,Mayotte,AFRO,0,128,0,2
13561,2020-04-05T00:00:00Z,YT,Mayotte,AFRO,19,147,0,2
13562,2020-04-06T00:00:00Z,YT,Mayotte,AFRO,0,147,0,2
13563,2020-04-07T00:00:00Z,YT,Mayotte,AFRO,17,164,0,2
13564,2020-04-08T00:00:00Z,YT,Mayotte,AFRO,20,184,0,2
13565,2020-04-09T00:00:00Z,YT,Mayotte,AFRO,2,186,0,2
13566,2020-04-10T00:00:00Z,YT,Mayotte,AFRO,5,191,0,2
13567,2020-04-11T00:00:00Z,YT,Mayotte,AFRO,0,191,0,2
13568,2020-04-12T00:00:00Z,YT,Mayotte,AFRO,0,191,0,2
13569,2020-04-13T00:00:00Z,YT,Mayotte,AFRO,16,207,1,3
13570,2020-04-14T00:00:00Z,YT,Mayotte,AFRO,0,207,0,3
13571,2020-04-15T00:00:00Z,YT,Mayotte,AFRO,10,217,0,3
13572,2020-04-16T00:00:00Z,YT,Mayotte,AFRO,4,221,0,3
13573,2020-04-17T00:00:00Z,YT,Mayotte,AFRO,12,233,0,3
13574,2020-04-18T00:00:00Z,YT,Mayotte,AFRO,12,245,1,4
13575,2020-04-19T00:00:00Z,YT,Mayotte,AFRO,0,245,0,4
13576,2020-04-20T00:00:00Z,YT,Mayotte,AFRO,39,284,0,4
13577,2020-04-21T00:00:00Z,YT,Mayotte,AFRO,0,284,0,4
13578,2020-04-22T00:00:00Z,YT,Mayotte,AFRO,27,311,0,4
13579,2020-04-23T00:00:00Z,YT,Mayotte,AFRO,15,326,0,4
13580,2020-04-24T00:00:00Z,YT,Mayotte,AFRO,13,339,0,4
13581,2020-04-25T00:00:00Z,YT,Mayotte,AFRO,15,354,0,4
13582,2020-04-26T00:00:00Z,YT,Mayotte,AFRO,0,354,0,4
13583,2020-04-27T00:00:00Z,YT,Mayotte,AFRO,47,401,0,4
13584,2020-04-28T00:00:00Z,YT,Mayotte,AFRO,32,433,0,4
13585,2020-04-29T00:00:00Z,YT,Mayotte,AFRO,27,460,0,4
13586,2020-04-30T00:00:00Z,YT,Mayotte,AFRO,0,460,0,4
13587,2020-05-01T00:00:00Z,YT,Mayotte,AFRO,79,539,0,4
13588,2020-05-02T00:00:00Z,YT,Mayotte,AFRO,0,539,0,4
13589,2020-05-03T00:00:00Z,YT,Mayotte,AFRO,57,596,2,6
13590,2020-05-04T00:00:00Z,YT,Mayotte,AFRO,54,650,0,6
13591,2020-05-05T00:00:00Z,YT,Mayotte,AFRO,36,686,0,6
13592,2020-05-06T00:00:00Z,YT,Mayotte,AFRO,53,739,3,9
13593,2020-05-07T00:00:00Z,YT,Mayotte,AFRO,0,739,0,9
13594,2020-05-08T00:00:00Z,YT,Mayotte,AFRO,115,854,1,10
13595,2020-05-09T00:00:00Z,YT,Mayotte,AFRO,36,890,1,11
13596,2020-05-10T00:00:00Z,YT,Mayotte,AFRO,0,890,0,11
13597,2020-05-11T00:00:00Z,YT,Mayotte,AFRO,133,1023,0,11
13598,2020-05-12T00:00:00Z,YT,Mayotte,AFRO,38,1061,1,12
13599,2020-05-13T00:00:00Z,YT,Mayotte,AFRO,34,1095,0,12
13600,2020-05-14T00:00:00Z,YT,Mayotte,AFRO,48,1143,2,14
13601,2020-05-15T00:00:00Z,YT,Mayotte,AFRO,67,1210,2,16
13602,2020-05-16T00:00:00Z,YT,Mayotte,AFRO,48,1258,0,16
13603,2020-05-17T00:00:00Z,YT,Mayotte,AFRO,0,1258,0,16
13604,2020-05-18T00:00:00Z,YT,Mayotte,AFRO,84,1342,2,18
13605,2020-05-19T00:00:00Z,YT,Mayotte,AFRO,28,1370,0,18
13606,2020-05-20T00:00:00Z,YT,Mayotte,AFRO,49,1419,1,19
13607,2020-05-21T00:00:00Z,YT,Mayotte,AFRO,56,1475,0,19
13608,2020-05-22T00:00:00Z,YT,Mayotte,AFRO,19,1494,0,19
13609,2020-05-23T00:00:00Z,YT,Mayotte,AFRO,27,1521,0,19
13610,2020-05-24T00:00:00Z,YT,Mayotte,AFRO,0,1521,0,19
13611,2020-05-25T00:00:00Z,YT,Mayotte,AFRO,66,1587,1,20
13612,2020-05-26T00:00:00Z,YT,Mayotte,AFRO,22,1609,0,20
13613,2020-05-27T00:00:00Z,YT,Mayotte,AFRO,25,1634,0,20
13614,2020-05-28T00:00:00Z,YT,Mayotte,AFRO,11,1645,0,20
13615,2020-05-29T00:00:00Z,YT,Mayotte,AFRO,25,1670,1,21
13616,2020-05-30T00:00:00Z,YT,Mayotte,AFRO,29,1699,0,21
13617,2020-05-31T00:00:00Z,YT,Mayotte,AFRO,44,1743,0,21
13618,2020-06-01T00:00:00Z,YT,Mayotte,AFRO,128,1871,2,23
13619,2020-06-02T00:00:00Z,YT,Mayotte,AFRO,63,1934,1,24
13620,2020-06-03T00:00:00Z,YT,Mayotte,AFRO,52,1986,0,24
13621,2020-06-04T00:00:00Z,YT,Mayotte,AFRO,7,1993,0,24
13622,2020-06-05T00:00:00Z,YT,Mayotte,AFRO,65,2058,1,25
13623,2020-06-06T00:00:00Z,YT,Mayotte,AFRO,21,2079,0,25
13624,2020-06-07T00:00:00Z,YT,Mayotte,AFRO,0,2079,0,25
13625,2020-06-08T00:00:00Z,YT,Mayotte,AFRO,0,2079,0,25
13626,2020-06-09T00:00:00Z,YT,Mayotte,AFRO,72,2151,1,26
13627,2020-06-10T00:00:00Z,YT,Mayotte,AFRO,24,2175,2,28
13628,2020-06-11T00:00:00Z,YT,Mayotte,AFRO,31,2206,0,28
13629,2020-06-12T00:00:00Z,YT,Mayotte,AFRO,34,2240,0,28
13630,2020-06-13T00:00:00Z,YT,Mayotte,AFRO,28,2268,0,28
13631,2020-06-14T00:00:00Z,YT,Mayotte,AFRO,14,2282,1,29
13632,2020-06-15T00:00:00Z,YT,Mayotte,AFRO,0,2282,0,29
13633,2020-06-16T00:00:00Z,YT,Mayotte,AFRO,28,2310,-1,28
13634,2020-06-17T00:00:00Z,YT,Mayotte,AFRO,23,2333,1,29
13635,2020-06-18T00:00:00Z,YT,Mayotte,AFRO,12,2345,0,29
13636,2020-06-19T00:00:00Z,YT,Mayotte,AFRO,38,2383,0,29
13637,2020-06-20T00:00:00Z,YT,Mayotte,AFRO,11,2394,0,29
14270,2020-03-23T00:00:00Z,MZ,Mozambique,AFRO,1,1,0,0
14271,2020-03-24T00:00:00Z,MZ,Mozambique,AFRO,0,1,0,0
14272,2020-03-25T00:00:00Z,MZ,Mozambique,AFRO,2,3,0,0
14273,2020-03-26T00:00:00Z,MZ,Mozambique,AFRO,2,5,0,0
14274,2020-03-27T00:00:00Z,MZ,Mozambique,AFRO,0,5,0,0
14275,2020-03-28T00:00:00Z,MZ,Mozambique,AFRO,2,7,0,0
14276,2020-03-29T00:00:00Z,MZ,Mozambique,AFRO,1,8,0,0
14277,2020-03-30T00:00:00Z,MZ,Mozambique,AFRO,0,8,0,0
14278,2020-03-31T00:00:00Z,MZ,Mozambique,AFRO,0,8,0,0
14279,2020-04-01T00:00:00Z,MZ,Mozambique,AFRO,0,8,0,0
14280,2020-04-02T00:00:00Z,MZ,Mozambique,AFRO,2,10,0,0
14281,2020-04-03T00:00:00Z,MZ,Mozambique,AFRO,0,10,0,0
14282,2020-04-04T00:00:00Z,MZ,Mozambique,AFRO,0,10,0,0
14283,2020-04-05T00:00:00Z,MZ,Mozambique,AFRO,0,10,0,0
14284,2020-04-06T00:00:00Z,MZ,Mozambique,AFRO,0,10,0,0
14285,2020-04-07T00:00:00Z,MZ,Mozambique,AFRO,0,10,0,0
14286,2020-04-08T00:00:00Z,MZ,Mozambique,AFRO,0,10,0,0
14287,2020-04-09T00:00:00Z,MZ,Mozambique,AFRO,7,17,0,0
14288,2020-04-10T00:00:00Z,MZ,Mozambique,AFRO,0,17,0,0
14289,2020-04-11T00:00:00Z,MZ,Mozambique,AFRO,3,20,0,0
14290,2020-04-12T00:00:00Z,MZ,Mozambique,AFRO,0,20,0,0
14291,2020-04-13T00:00:00Z,MZ,Mozambique,AFRO,0,20,0,0
14292,2020-04-14T00:00:00Z,MZ,Mozambique,AFRO,1,21,0,0
14293,2020-04-15T00:00:00Z,MZ,Mozambique,AFRO,7,28,0,0
14294,2020-04-16T00:00:00Z,MZ,Mozambique,AFRO,0,28,0,0
14295,2020-04-17T00:00:00Z,MZ,Mozambique,AFRO,1,29,0,0
14296,2020-04-18T00:00:00Z,MZ,Mozambique,AFRO,2,31,0,0
14297,2020-04-19T00:00:00Z,MZ,Mozambique,AFRO,0,31,0,0
14298,2020-04-20T00:00:00Z,MZ,Mozambique,AFRO,4,35,0,0
14299,2020-04-21T00:00:00Z,MZ,Mozambique,AFRO,0,35,0,0
14300,2020-04-22T00:00:00Z,MZ,Mozambique,AFRO,4,39,0,0
14301,2020-04-23T00:00:00Z,MZ,Mozambique,AFRO,2,41,0,0
14302,2020-04-24T00:00:00Z,MZ,Mozambique,AFRO,0,41,0,0
14303,2020-04-25T00:00:00Z,MZ,Mozambique,AFRO,24,65,0,0
14304,2020-04-26T00:00:00Z,MZ,Mozambique,AFRO,5,70,0,0
14305,2020-04-27T00:00:00Z,MZ,Mozambique,AFRO,6,76,0,0
14306,2020-04-28T00:00:00Z,MZ,Mozambique,AFRO,0,76,0,0
14307,2020-04-29T00:00:00Z,MZ,Mozambique,AFRO,0,76,0,0
14308,2020-04-30T00:00:00Z,MZ,Mozambique,AFRO,0,76,0,0
14309,2020-05-01T00:00:00Z,MZ,Mozambique,AFRO,0,76,0,0
14310,2020-05-02T00:00:00Z,MZ,Mozambique,AFRO,3,79,0,0
14311,2020-05-03T00:00:00Z,MZ,Mozambique,AFRO,0,79,0,0
14312,2020-05-04T00:00:00Z,MZ,Mozambique,AFRO,1,80,0,0
14313,2020-05-05T00:00:00Z,MZ,Mozambique,AFRO,0,80,0,0
14314,2020-05-06T00:00:00Z,MZ,Mozambique,AFRO,0,80,0,0
14315,2020-05-07T00:00:00Z,MZ,Mozambique,AFRO,1,81,0,0
14316,2020-05-08T00:00:00Z,MZ,Mozambique,AFRO,0,81,0,0
14317,2020-05-09T00:00:00Z,MZ,Mozambique,AFRO,1,82,0,0
14318,2020-05-10T00:00:00Z,MZ,Mozambique,AFRO,5,87,0,0
14319,2020-05-11T00:00:00Z,MZ,Mozambique,AFRO,4,91,0,0
14320,2020-05-12T00:00:00Z,MZ,Mozambique,AFRO,12,103,0,0
14321,2020-05-13T00:00:00Z,MZ,Mozambique,AFRO,1,104,0,0
14322,2020-05-14T00:00:00Z,MZ,Mozambique,AFRO,3,107,0,0
14323,2020-05-15T00:00:00Z,MZ,Mozambique,AFRO,8,115,0,0
14324,2020-05-16T00:00:00Z,MZ,Mozambique,AFRO,4,119,0,0
14325,2020-05-17T00:00:00Z,MZ,Mozambique,AFRO,10,129,0,0
14326,2020-05-18T00:00:00Z,MZ,Mozambique,AFRO,8,137,0,0
14327,2020-05-19T00:00:00Z,MZ,Mozambique,AFRO,8,145,0,0
14328,2020-05-20T00:00:00Z,MZ,Mozambique,AFRO,1,146,0,0
14329,2020-05-21T00:00:00Z,MZ,Mozambique,AFRO,10,156,0,0
14330,2020-05-22T00:00:00Z,MZ,Mozambique,AFRO,6,162,0,0
14331,2020-05-23T00:00:00Z,MZ,Mozambique,AFRO,2,164,0,0
14332,2020-05-24T00:00:00Z,MZ,Mozambique,AFRO,4,168,0,0
14333,2020-05-25T00:00:00Z,MZ,Mozambique,AFRO,26,194,0,0
14334,2020-05-26T00:00:00Z,MZ,Mozambique,AFRO,15,209,1,1
14335,2020-05-27T00:00:00Z,MZ,Mozambique,AFRO,4,213,0,1
14336,2020-05-28T00:00:00Z,MZ,Mozambique,AFRO,14,227,0,1
14337,2020-05-29T00:00:00Z,MZ,Mozambique,AFRO,6,233,1,2
14338,2020-05-30T00:00:00Z,MZ,Mozambique,AFRO,1,234,0,2
14339,2020-05-31T00:00:00Z,MZ,Mozambique,AFRO,10,244,0,2
14340,2020-06-01T00:00:00Z,MZ,Mozambique,AFRO,10,254,0,2
14341,2020-06-02T00:00:00Z,MZ,Mozambique,AFRO,0,254,0,2
14342,2020-06-03T00:00:00Z,MZ,Mozambique,AFRO,53,307,0,2
14343,2020-06-04T00:00:00Z,MZ,Mozambique,AFRO,9,316,0,2
14344,2020-06-05T00:00:00Z,MZ,Mozambique,AFRO,36,352,0,2
14345,2020-06-06T00:00:00Z,MZ,Mozambique,AFRO,0,352,0,2
14346,2020-06-07T00:00:00Z,MZ,Mozambique,AFRO,57,409,0,2
14347,2020-06-08T00:00:00Z,MZ,Mozambique,AFRO,15,424,0,2
14348,2020-06-09T00:00:00Z,MZ,Mozambique,AFRO,9,433,0,2
14349,2020-06-10T00:00:00Z,MZ,Mozambique,AFRO,20,453,0,2
14350,2020-06-11T00:00:00Z,MZ,Mozambique,AFRO,19,472,0,2
14351,2020-06-12T00:00:00Z,MZ,Mozambique,AFRO,17,489,0,2
14352,2020-06-13T00:00:00Z,MZ,Mozambique,AFRO,20,509,0,2
14353,2020-06-14T00:00:00Z,MZ,Mozambique,AFRO,44,553,0,2
14354,2020-06-15T00:00:00Z,MZ,Mozambique,AFRO,30,583,0,2
14355,2020-06-16T00:00:00Z,MZ,Mozambique,AFRO,26,609,1,3
14356,2020-06-17T00:00:00Z,MZ,Mozambique,AFRO,29,638,1,4
14357,2020-06-18T00:00:00Z,MZ,Mozambique,AFRO,13,651,0,4
14358,2020-06-19T00:00:00Z,MZ,Mozambique,AFRO,11,662,0,4
14359,2020-06-20T00:00:00Z,MZ,Mozambique,AFRO,6,668,0,4
14449,2020-03-14T00:00:00Z,,Namibia,AFRO,2,2,0,0
14450,2020-03-15T00:00:00Z,,Namibia,AFRO,0,2,0,0
14451,2020-03-16T00:00:00Z,,Namibia,AFRO,0,2,0,0
14452,2020-03-17T00:00:00Z,,Namibia,AFRO,0,2,0,0
14453,2020-03-18T00:00:00Z,,Namibia,AFRO,0,2,0,0
14454,2020-03-19T00:00:00Z,,Namibia,AFRO,1,3,0,0
14455,2020-03-20T00:00:00Z,,Namibia,AFRO,0,3,0,0
14456,2020-03-21T00:00:00Z,,Namibia,AFRO,0,3,0,0
14457,2020-03-22T00:00:00Z,,Namibia,AFRO,0,3,0,0
14458,2020-03-23T00:00:00Z,,Namibia,AFRO,0,3,0,0
14459,2020-03-24T00:00:00Z,,Namibia,AFRO,0,3,0,0
14460,2020-03-25T00:00:00Z,,Namibia,AFRO,1,4,0,0
14461,2020-03-26T00:00:00Z,,Namibia,AFRO,4,8,0,0
14462,2020-03-27T00:00:00Z,,Namibia,AFRO,0,8,0,0
14463,2020-03-28T00:00:00Z,,Namibia,AFRO,0,8,0,0
14464,2020-03-29T00:00:00Z,,Namibia,AFRO,3,11,0,0
14465,2020-03-30T00:00:00Z,,Namibia,AFRO,0,11,0,0
14466,2020-03-31T00:00:00Z,,Namibia,AFRO,0,11,0,0
14467,2020-04-01T00:00:00Z,,Namibia,AFRO,0,11,0,0
14468,2020-04-02T00:00:00Z,,Namibia,AFRO,2,13,0,0
14469,2020-04-03T00:00:00Z,,Namibia,AFRO,0,13,0,0
14470,2020-04-04T00:00:00Z,,Namibia,AFRO,0,13,0,0
14471,2020-04-05T00:00:00Z,,Namibia,AFRO,1,14,0,0
14472,2020-04-06T00:00:00Z,,Namibia,AFRO,2,16,0,0
14473,2020-04-07T00:00:00Z,,Namibia,AFRO,0,16,0,0
14474,2020-04-08T00:00:00Z,,Namibia,AFRO,0,16,0,0
14475,2020-04-09T00:00:00Z,,Namibia,AFRO,0,16,0,0
14476,2020-04-10T00:00:00Z,,Namibia,AFRO,0,16,0,0
14477,2020-04-11T00:00:00Z,,Namibia,AFRO,0,16,0,0
14478,2020-04-12T00:00:00Z,,Namibia,AFRO,0,16,0,0
14479,2020-04-13T00:00:00Z,,Namibia,AFRO,0,16,0,0
14480,2020-04-14T00:00:00Z,,Namibia,AFRO,0,16,0,0
14481,2020-04-15T00:00:00Z,,Namibia,AFRO,0,16,0,0
14482,2020-04-16T00:00:00Z,,Namibia,AFRO,0,16,0,0
14483,2020-04-17T00:00:00Z,,Namibia,AFRO,0,16,0,0
14484,2020-04-18T00:00:00Z,,Namibia,AFRO,0,16,0,0
14485,2020-04-19T00:00:00Z,,Namibia,AFRO,0,16,0,0
14486,2020-04-20T00:00:00Z,,Namibia,AFRO,0,16,0,0
14487,2020-04-21T00:00:00Z,,Namibia,AFRO,0,16,0,0
14488,2020-04-22T00:00:00Z,,Namibia,AFRO,0,16,0,0
14489,2020-04-23T00:00:00Z,,Namibia,AFRO,0,16,0,0
14490,2020-04-24T00:00:00Z,,Namibia,AFRO,0,16,0,0
14491,2020-04-25T00:00:00Z,,Namibia,AFRO,0,16,0,0
14492,2020-04-26T00:00:00Z,,Namibia,AFRO,0,16,0,0
14493,2020-04-27T00:00:00Z,,Namibia,AFRO,0,16,0,0
14494,2020-04-28T00:00:00Z,,Namibia,AFRO,0,16,0,0
14495,2020-04-29T00:00:00Z,,Namibia,AFRO,0,16,0,0
14496,2020-04-30T00:00:00Z,,Namibia,AFRO,0,16,0,0
14497,2020-05-01T00:00:00Z,,Namibia,AFRO,0,16,0,0
14498,2020-05-02T00:00:00Z,,Namibia,AFRO,0,16,0,0
14499,2020-05-03T00:00:00Z,,Namibia,AFRO,0,16,0,0
14500,2020-05-04T00:00:00Z,,Namibia,AFRO,0,16,0,0
14501,2020-05-05T00:00:00Z,,Namibia,AFRO,0,16,0,0
14502,2020-05-06T00:00:00Z,,Namibia,AFRO,0,16,0,0
14503,2020-05-07T00:00:00Z,,Namibia,AFRO,0,16,0,0
14504,2020-05-08T00:00:00Z,,Namibia,AFRO,0,16,0,0
14505,2020-05-09T00:00:00Z,,Namibia,AFRO,0,16,0,0
14506,2020-05-10T00:00:00Z,,Namibia,AFRO,0,16,0,0
14507,2020-05-11T00:00:00Z,,Namibia,AFRO,0,16,0,0
14508,2020-05-12T00:00:00Z,,Namibia,AFRO,0,16,0,0
14509,2020-05-13T00:00:00Z,,Namibia,AFRO,0,16,0,0
14510,2020-05-14T00:00:00Z,,Namibia,AFRO,0,16,0,0
14511,2020-05-15T00:00:00Z,,Namibia,AFRO,0,16,0,0
14512,2020-05-16T00:00:00Z,,Namibia,AFRO,0,16,0,0
14513,2020-05-17T00:00:00Z,,Namibia,AFRO,0,16,0,0
14514,2020-05-18T00:00:00Z,,Namibia,AFRO,0,16,0,0
14515,2020-05-19T00:00:00Z,,Namibia,AFRO,0,16,0,0
14516,2020-05-20T00:00:00Z,,Namibia,AFRO,0,16,0,0
14517,2020-05-21T00:00:00Z,,Namibia,AFRO,0,16,0,0
14518,2020-05-22T00:00:00Z,,Namibia,AFRO,2,18,0,0
14519,2020-05-23T00:00:00Z,,Namibia,AFRO,1,19,0,0
14520,2020-05-24T00:00:00Z,,Namibia,AFRO,1,20,0,0
14521,2020-05-25T00:00:00Z,,Namibia,AFRO,1,21,0,0
14522,2020-05-26T00:00:00Z,,Namibia,AFRO,0,21,0,0
14523,2020-05-27T00:00:00Z,,Namibia,AFRO,0,21,0,0
14524,2020-05-28T00:00:00Z,,Namibia,AFRO,1,22,0,0
14525,2020-05-29T00:00:00Z,,Namibia,AFRO,0,22,0,0
14526,2020-05-30T00:00:00Z,,Namibia,AFRO,1,23,0,0
14527,2020-05-31T00:00:00Z,,Namibia,AFRO,0,23,0,0
14528,2020-06-01T00:00:00Z,,Namibia,AFRO,1,24,0,0
14529,2020-06-02T00:00:00Z,,Namibia,AFRO,1,25,0,0
14530,2020-06-03T00:00:00Z,,Namibia,AFRO,0,25,0,0
14531,2020-06-04T00:00:00Z,,Namibia,AFRO,0,25,0,0
14532,2020-06-05T00:00:00Z,,Namibia,AFRO,0,25,0,0
14533,2020-06-06T00:00:00Z,,Namibia,AFRO,0,25,0,0
14534,2020-06-07T00:00:00Z,,Namibia,AFRO,4,29,0,0
14535,2020-06-08T00:00:00Z,,Namibia,AFRO,0,29,0,0
14536,2020-06-09T00:00:00Z,,Namibia,AFRO,2,31,0,0
14537,2020-06-10T00:00:00Z,,Namibia,AFRO,0,31,0,0
14538,2020-06-11T00:00:00Z,,Namibia,AFRO,0,31,0,0
14539,2020-06-12T00:00:00Z,,Namibia,AFRO,0,31,0,0
14540,2020-06-13T00:00:00Z,,Namibia,AFRO,0,31,0,0
14541,2020-06-14T00:00:00Z,,Namibia,AFRO,1,32,0,0
14542,2020-06-15T00:00:00Z,,Namibia,AFRO,0,32,0,0
14543,2020-06-16T00:00:00Z,,Namibia,AFRO,0,32,0,0
14544,2020-06-17T00:00:00Z,,Namibia,AFRO,2,34,0,0
14545,2020-06-18T00:00:00Z,,Namibia,AFRO,0,34,0,0
14546,2020-06-19T00:00:00Z,,Namibia,AFRO,5,39,0,0
14547,2020-06-20T00:00:00Z,,Namibia,AFRO,6,45,0,0
15115,2020-03-19T00:00:00Z,NE,Niger,AFRO,1,1,0,0
15116,2020-03-20T00:00:00Z,NE,Niger,AFRO,0,1,0,0
15117,2020-03-21T00:00:00Z,NE,Niger,AFRO,0,1,0,0
15118,2020-03-22T00:00:00Z,NE,Niger,AFRO,0,1,0,0
15119,2020-03-23T00:00:00Z,NE,Niger,AFRO,1,2,0,0
15120,2020-03-24T00:00:00Z,NE,Niger,AFRO,0,2,0,0
15121,2020-03-25T00:00:00Z,NE,Niger,AFRO,0,2,0,0
15122,2020-03-26T00:00:00Z,NE,Niger,AFRO,0,2,0,0
15123,2020-03-27T00:00:00Z,NE,Niger,AFRO,8,10,1,1
15124,2020-03-28T00:00:00Z,NE,Niger,AFRO,0,10,0,1
15125,2020-03-29T00:00:00Z,NE,Niger,AFRO,0,10,0,1
15126,2020-03-30T00:00:00Z,NE,Niger,AFRO,10,20,2,3
15127,2020-03-31T00:00:00Z,NE,Niger,AFRO,0,20,0,3
15128,2020-04-01T00:00:00Z,NE,Niger,AFRO,0,20,0,3
15129,2020-04-02T00:00:00Z,NE,Niger,AFRO,54,74,2,5
15130,2020-04-03T00:00:00Z,NE,Niger,AFRO,24,98,0,5
15131,2020-04-04T00:00:00Z,NE,Niger,AFRO,22,120,0,5
15132,2020-04-05T00:00:00Z,NE,Niger,AFRO,24,144,3,8
15133,2020-04-06T00:00:00Z,NE,Niger,AFRO,40,184,2,10
15134,2020-04-07T00:00:00Z,NE,Niger,AFRO,69,253,0,10
15135,2020-04-08T00:00:00Z,NE,Niger,AFRO,25,278,1,11
15136,2020-04-09T00:00:00Z,NE,Niger,AFRO,64,342,0,11
15137,2020-04-10T00:00:00Z,NE,Niger,AFRO,68,410,0,11
15138,2020-04-11T00:00:00Z,NE,Niger,AFRO,28,438,0,11
15139,2020-04-12T00:00:00Z,NE,Niger,AFRO,53,491,0,11
15140,2020-04-13T00:00:00Z,NE,Niger,AFRO,38,529,1,12
15141,2020-04-14T00:00:00Z,NE,Niger,AFRO,19,548,1,13
15142,2020-04-15T00:00:00Z,NE,Niger,AFRO,22,570,1,14
15143,2020-04-16T00:00:00Z,NE,Niger,AFRO,14,584,0,14
15144,2020-04-17T00:00:00Z,NE,Niger,AFRO,25,609,1,15
15145,2020-04-18T00:00:00Z,NE,Niger,AFRO,18,627,3,18
15146,2020-04-19T00:00:00Z,NE,Niger,AFRO,12,639,1,19
15147,2020-04-20T00:00:00Z,NE,Niger,AFRO,9,648,1,20
15148,2020-04-21T00:00:00Z,NE,Niger,AFRO,7,655,0,20
15149,2020-04-22T00:00:00Z,NE,Niger,AFRO,2,657,0,20
15150,2020-04-23T00:00:00Z,NE,Niger,AFRO,5,662,2,22
15151,2020-04-24T00:00:00Z,NE,Niger,AFRO,9,671,2,24
15152,2020-04-25T00:00:00Z,NE,Niger,AFRO,10,681,0,24
15153,2020-04-26T00:00:00Z,NE,Niger,AFRO,3,684,3,27
15154,2020-04-27T00:00:00Z,NE,Niger,AFRO,12,696,2,29
15155,2020-04-28T00:00:00Z,NE,Niger,AFRO,5,701,0,29
15156,2020-04-29T00:00:00Z,NE,Niger,AFRO,8,709,2,31
15157,2020-04-30T00:00:00Z,NE,Niger,AFRO,4,713,1,32
15158,2020-05-01T00:00:00Z,NE,Niger,AFRO,6,719,0,32
15159,2020-05-02T00:00:00Z,NE,Niger,AFRO,9,728,1,33
15160,2020-05-03T00:00:00Z,NE,Niger,AFRO,8,736,2,35
15161,2020-05-04T00:00:00Z,NE,Niger,AFRO,14,750,1,36
15162,2020-05-05T00:00:00Z,NE,Niger,AFRO,5,755,1,37
15163,2020-05-06T00:00:00Z,NE,Niger,AFRO,8,763,1,38
15164,2020-05-07T00:00:00Z,NE,Niger,AFRO,7,770,0,38
15165,2020-05-08T00:00:00Z,NE,Niger,AFRO,11,781,4,42
15166,2020-05-09T00:00:00Z,NE,Niger,AFRO,14,795,2,44
15167,2020-05-10T00:00:00Z,NE,Niger,AFRO,20,815,1,45
15168,2020-05-11T00:00:00Z,NE,Niger,AFRO,6,821,1,46
15169,2020-05-12T00:00:00Z,NE,Niger,AFRO,11,832,0,46
15170,2020-05-13T00:00:00Z,NE,Niger,AFRO,22,854,1,47
15171,2020-05-14T00:00:00Z,NE,Niger,AFRO,6,860,2,49
15172,2020-05-15T00:00:00Z,NE,Niger,AFRO,16,876,1,50
15173,2020-05-16T00:00:00Z,NE,Niger,AFRO,9,885,1,51
15174,2020-05-17T00:00:00Z,NE,Niger,AFRO,4,889,0,51
15175,2020-05-18T00:00:00Z,NE,Niger,AFRO,15,904,3,54
15176,2020-05-19T00:00:00Z,NE,Niger,AFRO,5,909,1,55
15177,2020-05-20T00:00:00Z,NE,Niger,AFRO,5,914,0,55
15178,2020-05-21T00:00:00Z,NE,Niger,AFRO,6,920,3,58
15179,2020-05-22T00:00:00Z,NE,Niger,AFRO,4,924,2,60
15180,2020-05-23T00:00:00Z,NE,Niger,AFRO,13,937,0,60
15181,2020-05-24T00:00:00Z,NE,Niger,AFRO,6,943,1,61
15182,2020-05-25T00:00:00Z,NE,Niger,AFRO,2,945,0,61
15183,2020-05-26T00:00:00Z,NE,Niger,AFRO,6,951,1,62
15184,2020-05-27T00:00:00Z,NE,Niger,AFRO,1,952,1,63
15185,2020-05-28T00:00:00Z,NE,Niger,AFRO,3,955,1,64
15186,2020-05-29T00:00:00Z,NE,Niger,AFRO,0,955,0,64
15187,2020-05-30T00:00:00Z,NE,Niger,AFRO,0,955,0,64
15188,2020-05-31T00:00:00Z,NE,Niger,AFRO,1,956,0,64
15189,2020-06-01T00:00:00Z,NE,Niger,AFRO,2,958,0,64
15190,2020-06-02T00:00:00Z,NE,Niger,AFRO,0,958,0,64
15191,2020-06-03T00:00:00Z,NE,Niger,AFRO,2,960,1,65
15192,2020-06-04T00:00:00Z,NE,Niger,AFRO,1,961,0,65
15193,2020-06-05T00:00:00Z,NE,Niger,AFRO,2,963,0,65
15194,2020-06-06T00:00:00Z,NE,Niger,AFRO,3,966,0,65
15195,2020-06-07T00:00:00Z,NE,Niger,AFRO,4,970,0,65
15196,2020-06-08T00:00:00Z,NE,Niger,AFRO,3,973,0,65
15197,2020-06-09T00:00:00Z,NE,Niger,AFRO,0,973,0,65
15198,2020-06-10T00:00:00Z,NE,Niger,AFRO,1,974,0,65
15199,2020-06-11T00:00:00Z,NE,Niger,AFRO,0,974,0,65
15200,2020-06-12T00:00:00Z,NE,Niger,AFRO,0,974,0,65
15201,2020-06-13T00:00:00Z,NE,Niger,AFRO,4,978,0,65
15202,2020-06-14T00:00:00Z,NE,Niger,AFRO,0,978,0,65
15203,2020-06-15T00:00:00Z,NE,Niger,AFRO,2,980,1,66
15204,2020-06-16T00:00:00Z,NE,Niger,AFRO,0,980,0,66
15205,2020-06-17T00:00:00Z,NE,Niger,AFRO,36,1016,0,66
15206,2020-06-18T00:00:00Z,NE,Niger,AFRO,4,1020,1,67
15207,2020-06-19T00:00:00Z,NE,Niger,AFRO,0,1020,0,67
15208,2020-06-20T00:00:00Z,NE,Niger,AFRO,6,1026,0,67
15209,2020-02-28T00:00:00Z,NG,Nigeria,AFRO,1,1,0,0
15210,2020-02-29T00:00:00Z,NG,Nigeria,AFRO,0,1,0,0
15211,2020-03-01T00:00:00Z,NG,Nigeria,AFRO,0,1,0,0
15212,2020-03-02T00:00:00Z,NG,Nigeria,AFRO,0,1,0,0
15213,2020-03-03T00:00:00Z,NG,Nigeria,AFRO,0,1,0,0
15214,2020-03-04T00:00:00Z,NG,Nigeria,AFRO,0,1,0,0
15215,2020-03-05T00:00:00Z,NG,Nigeria,AFRO,0,1,0,0
15216,2020-03-06T00:00:00Z,NG,Nigeria,AFRO,0,1,0,0
15217,2020-03-07T00:00:00Z,NG,Nigeria,AFRO,0,1,0,0
15218,2020-03-08T00:00:00Z,NG,Nigeria,AFRO,0,1,0,0
15219,2020-03-09T00:00:00Z,NG,Nigeria,AFRO,1,2,0,0
15220,2020-03-10T00:00:00Z,NG,Nigeria,AFRO,0,2,0,0
15221,2020-03-11T00:00:00Z,NG,Nigeria,AFRO,0,2,0,0
15222,2020-03-12T00:00:00Z,NG,Nigeria,AFRO,0,2,0,0
15223,2020-03-13T00:00:00Z,NG,Nigeria,AFRO,0,2,0,0
15224,2020-03-14T00:00:00Z,NG,Nigeria,AFRO,0,2,0,0
15225,2020-03-15T00:00:00Z,NG,Nigeria,AFRO,0,2,0,0
15226,2020-03-16T00:00:00Z,NG,Nigeria,AFRO,0,2,0,0
15227,2020-03-17T00:00:00Z,NG,Nigeria,AFRO,0,2,0,0
15228,2020-03-18T00:00:00Z,NG,Nigeria,AFRO,6,8,0,0
15229,2020-03-19T00:00:00Z,NG,Nigeria,AFRO,4,12,0,0
15230,2020-03-20T00:00:00Z,NG,Nigeria,AFRO,0,12,0,0
15231,2020-03-21T00:00:00Z,NG,Nigeria,AFRO,10,22,0,0
15232,2020-03-22T00:00:00Z,NG,Nigeria,AFRO,0,22,0,0
15233,2020-03-23T00:00:00Z,NG,Nigeria,AFRO,0,22,0,0
15234,2020-03-24T00:00:00Z,NG,Nigeria,AFRO,0,22,0,0
15235,2020-03-25T00:00:00Z,NG,Nigeria,AFRO,20,42,0,0
15236,2020-03-26T00:00:00Z,NG,Nigeria,AFRO,4,46,1,1
15237,2020-03-27T00:00:00Z,NG,Nigeria,AFRO,19,65,0,1
15238,2020-03-28T00:00:00Z,NG,Nigeria,AFRO,0,65,0,1
15239,2020-03-29T00:00:00Z,NG,Nigeria,AFRO,0,65,0,1
15240,2020-03-30T00:00:00Z,NG,Nigeria,AFRO,0,65,0,1
15241,2020-03-31T00:00:00Z,NG,Nigeria,AFRO,46,111,0,1
15242,2020-04-01T00:00:00Z,NG,Nigeria,AFRO,28,139,1,2
15243,2020-04-02T00:00:00Z,NG,Nigeria,AFRO,35,174,0,2
15244,2020-04-03T00:00:00Z,NG,Nigeria,AFRO,16,190,0,2
15245,2020-04-04T00:00:00Z,NG,Nigeria,AFRO,18,208,2,4
15246,2020-04-05T00:00:00Z,NG,Nigeria,AFRO,0,208,0,4
15247,2020-04-06T00:00:00Z,NG,Nigeria,AFRO,24,232,1,5
15248,2020-04-07T00:00:00Z,NG,Nigeria,AFRO,0,232,0,5
15249,2020-04-08T00:00:00Z,NG,Nigeria,AFRO,22,254,1,6
15250,2020-04-09T00:00:00Z,NG,Nigeria,AFRO,22,276,0,6
15251,2020-04-10T00:00:00Z,NG,Nigeria,AFRO,12,288,1,7
15252,2020-04-11T00:00:00Z,NG,Nigeria,AFRO,17,305,0,7
15253,2020-04-12T00:00:00Z,NG,Nigeria,AFRO,13,318,3,10
15254,2020-04-13T00:00:00Z,NG,Nigeria,AFRO,5,323,0,10
15255,2020-04-14T00:00:00Z,NG,Nigeria,AFRO,20,343,0,10
15256,2020-04-15T00:00:00Z,NG,Nigeria,AFRO,0,343,0,10
15257,2020-04-16T00:00:00Z,NG,Nigeria,AFRO,30,373,1,11
15258,2020-04-17T00:00:00Z,NG,Nigeria,AFRO,0,373,0,11
15259,2020-04-18T00:00:00Z,NG,Nigeria,AFRO,0,373,0,11
15260,2020-04-19T00:00:00Z,NG,Nigeria,AFRO,0,373,0,11
15261,2020-04-20T00:00:00Z,NG,Nigeria,AFRO,168,541,8,19
15262,2020-04-21T00:00:00Z,NG,Nigeria,AFRO,0,541,0,19
15263,2020-04-22T00:00:00Z,NG,Nigeria,AFRO,0,541,0,19
15264,2020-04-23T00:00:00Z,NG,Nigeria,AFRO,0,541,0,19
15265,2020-04-24T00:00:00Z,NG,Nigeria,AFRO,440,981,12,31
15266,2020-04-25T00:00:00Z,NG,Nigeria,AFRO,114,1095,1,32
15267,2020-04-26T00:00:00Z,NG,Nigeria,AFRO,87,1182,3,35
15268,2020-04-27T00:00:00Z,NG,Nigeria,AFRO,91,1273,5,40
15269,2020-04-28T00:00:00Z,NG,Nigeria,AFRO,64,1337,0,40
15270,2020-04-29T00:00:00Z,NG,Nigeria,AFRO,0,1337,0,40
15271,2020-04-30T00:00:00Z,NG,Nigeria,AFRO,195,1532,4,44
15272,2020-05-01T00:00:00Z,NG,Nigeria,AFRO,400,1932,14,58
15273,2020-05-02T00:00:00Z,NG,Nigeria,AFRO,238,2170,10,68
15274,2020-05-03T00:00:00Z,NG,Nigeria,AFRO,218,2388,17,85
15275,2020-05-04T00:00:00Z,NG,Nigeria,AFRO,0,2388,0,85
15276,2020-05-05T00:00:00Z,NG,Nigeria,AFRO,414,2802,8,93
15277,2020-05-06T00:00:00Z,NG,Nigeria,AFRO,148,2950,5,98
15278,2020-05-07T00:00:00Z,NG,Nigeria,AFRO,195,3145,5,103
15279,2020-05-08T00:00:00Z,NG,Nigeria,AFRO,381,3526,4,107
15280,2020-05-09T00:00:00Z,NG,Nigeria,AFRO,386,3912,10,117
15281,2020-05-10T00:00:00Z,NG,Nigeria,AFRO,239,4151,11,128
15282,2020-05-11T00:00:00Z,NG,Nigeria,AFRO,248,4399,15,143
15283,2020-05-12T00:00:00Z,NG,Nigeria,AFRO,242,4641,7,150
15284,2020-05-13T00:00:00Z,NG,Nigeria,AFRO,146,4787,8,158
15285,2020-05-14T00:00:00Z,NG,Nigeria,AFRO,184,4971,6,164
15286,2020-05-15T00:00:00Z,NG,Nigeria,AFRO,191,5162,3,167
15287,2020-05-16T00:00:00Z,NG,Nigeria,AFRO,288,5450,4,171
15288,2020-05-17T00:00:00Z,NG,Nigeria,AFRO,171,5621,5,176
15289,2020-05-18T00:00:00Z,NG,Nigeria,AFRO,338,5959,6,182
15290,2020-05-19T00:00:00Z,NG,Nigeria,AFRO,216,6175,9,191
15291,2020-05-20T00:00:00Z,NG,Nigeria,AFRO,226,6401,1,192
15292,2020-05-21T00:00:00Z,NG,Nigeria,AFRO,276,6677,8,200
15293,2020-05-22T00:00:00Z,NG,Nigeria,AFRO,339,7016,11,211
15294,2020-05-23T00:00:00Z,NG,Nigeria,AFRO,245,7261,10,221
15295,2020-05-24T00:00:00Z,NG,Nigeria,AFRO,265,7526,0,221
15296,2020-05-25T00:00:00Z,NG,Nigeria,AFRO,313,7839,5,226
15297,2020-05-26T00:00:00Z,NG,Nigeria,AFRO,229,8068,7,233
15298,2020-05-27T00:00:00Z,NG,Nigeria,AFRO,276,8344,16,249
15299,2020-05-28T00:00:00Z,NG,Nigeria,AFRO,389,8733,5,254
15300,2020-05-29T00:00:00Z,NG,Nigeria,AFRO,182,8915,5,259
15301,2020-05-30T00:00:00Z,NG,Nigeria,AFRO,387,9302,2,261
15302,2020-05-31T00:00:00Z,NG,Nigeria,AFRO,553,9855,12,273
15303,2020-06-01T00:00:00Z,NG,Nigeria,AFRO,307,10162,14,287
15304,2020-06-02T00:00:00Z,NG,Nigeria,AFRO,416,10578,12,299
15305,2020-06-03T00:00:00Z,NG,Nigeria,AFRO,241,10819,15,314
15306,2020-06-04T00:00:00Z,NG,Nigeria,AFRO,347,11166,1,315
15307,2020-06-05T00:00:00Z,NG,Nigeria,AFRO,350,11516,8,323
15308,2020-06-06T00:00:00Z,NG,Nigeria,AFRO,328,11844,10,333
15309,2020-06-07T00:00:00Z,NG,Nigeria,AFRO,389,12233,9,342
15310,2020-06-08T00:00:00Z,NG,Nigeria,AFRO,253,12486,12,354
15311,2020-06-09T00:00:00Z,NG,Nigeria,AFRO,315,12801,7,361
15312,2020-06-10T00:00:00Z,NG,Nigeria,AFRO,663,13464,4,365
15313,2020-06-11T00:00:00Z,NG,Nigeria,AFRO,409,13873,17,382
15314,2020-06-12T00:00:00Z,NG,Nigeria,AFRO,681,14554,5,387
15315,2020-06-13T00:00:00Z,NG,Nigeria,AFRO,0,14554,0,387
15316,2020-06-14T00:00:00Z,NG,Nigeria,AFRO,627,15181,12,399
15317,2020-06-15T00:00:00Z,NG,Nigeria,AFRO,904,16085,21,420
15318,2020-06-16T00:00:00Z,NG,Nigeria,AFRO,573,16658,4,424
15319,2020-06-17T00:00:00Z,NG,Nigeria,AFRO,490,17148,0,424
15320,2020-06-18T00:00:00Z,NG,Nigeria,AFRO,587,17735,45,469
15321,2020-06-19T00:00:00Z,NG,Nigeria,AFRO,745,18480,6,475
15322,2020-06-20T00:00:00Z,NG,Nigeria,AFRO,667,19147,12,487
17359,2020-03-13T00:00:00Z,RE,Réunion,AFRO,3,3,0,0
17360,2020-03-14T00:00:00Z,RE,Réunion,AFRO,3,6,0,0
17361,2020-03-15T00:00:00Z,RE,Réunion,AFRO,3,9,0,0
17362,2020-03-16T00:00:00Z,RE,Réunion,AFRO,0,9,0,0
17363,2020-03-17T00:00:00Z,RE,Réunion,AFRO,0,9,0,0
17364,2020-03-18T00:00:00Z,RE,Réunion,AFRO,3,12,0,0
17365,2020-03-19T00:00:00Z,RE,Réunion,AFRO,3,15,0,0
17366,2020-03-20T00:00:00Z,RE,Réunion,AFRO,13,28,0,0
17367,2020-03-21T00:00:00Z,RE,Réunion,AFRO,19,47,0,0
17368,2020-03-22T00:00:00Z,RE,Réunion,AFRO,0,47,0,0
17369,2020-03-23T00:00:00Z,RE,Réunion,AFRO,17,64,0,0
17370,2020-03-24T00:00:00Z,RE,Réunion,AFRO,7,71,0,0
17371,2020-03-25T00:00:00Z,RE,Réunion,AFRO,12,83,0,0
17372,2020-03-26T00:00:00Z,RE,Réunion,AFRO,11,94,0,0
17373,2020-03-27T00:00:00Z,RE,Réunion,AFRO,41,135,0,0
17374,2020-03-28T00:00:00Z,RE,Réunion,AFRO,8,143,0,0
17375,2020-03-29T00:00:00Z,RE,Réunion,AFRO,0,143,0,0
17376,2020-03-30T00:00:00Z,RE,Réunion,AFRO,64,207,0,0
17377,2020-03-31T00:00:00Z,RE,Réunion,AFRO,0,207,0,0
17378,2020-04-01T00:00:00Z,RE,Réunion,AFRO,40,247,0,0
17379,2020-04-02T00:00:00Z,RE,Réunion,AFRO,34,281,0,0
17380,2020-04-03T00:00:00Z,RE,Réunion,AFRO,27,308,0,0
17381,2020-04-04T00:00:00Z,RE,Réunion,AFRO,13,321,0,0
17382,2020-04-05T00:00:00Z,RE,Réunion,AFRO,13,334,0,0
17383,2020-04-06T00:00:00Z,RE,Réunion,AFRO,10,344,0,0
17384,2020-04-07T00:00:00Z,RE,Réunion,AFRO,5,349,0,0
17385,2020-04-08T00:00:00Z,RE,Réunion,AFRO,9,358,0,0
17386,2020-04-09T00:00:00Z,RE,Réunion,AFRO,4,362,0,0
17387,2020-04-10T00:00:00Z,RE,Réunion,AFRO,14,376,0,0
17388,2020-04-11T00:00:00Z,RE,Réunion,AFRO,6,382,0,0
17389,2020-04-12T00:00:00Z,RE,Réunion,AFRO,6,388,0,0
17390,2020-04-13T00:00:00Z,RE,Réunion,AFRO,1,389,0,0
17391,2020-04-14T00:00:00Z,RE,Réunion,AFRO,1,390,0,0
17392,2020-04-15T00:00:00Z,RE,Réunion,AFRO,0,390,0,0
17393,2020-04-16T00:00:00Z,RE,Réunion,AFRO,0,390,0,0
17394,2020-04-17T00:00:00Z,RE,Réunion,AFRO,4,394,0,0
17395,2020-04-18T00:00:00Z,RE,Réunion,AFRO,8,402,0,0
17396,2020-04-19T00:00:00Z,RE,Réunion,AFRO,5,407,0,0
17397,2020-04-20T00:00:00Z,RE,Réunion,AFRO,1,408,0,0
17398,2020-04-21T00:00:00Z,RE,Réunion,AFRO,0,408,0,0
17399,2020-04-22T00:00:00Z,RE,Réunion,AFRO,2,410,0,0
17400,2020-04-23T00:00:00Z,RE,Réunion,AFRO,0,410,0,0
17401,2020-04-24T00:00:00Z,RE,Réunion,AFRO,1,411,0,0
17402,2020-04-25T00:00:00Z,RE,Réunion,AFRO,0,411,0,0
17403,2020-04-26T00:00:00Z,RE,Réunion,AFRO,0,411,0,0
17404,2020-04-27T00:00:00Z,RE,Réunion,AFRO,5,416,0,0
17405,2020-04-28T00:00:00Z,RE,Réunion,AFRO,1,417,0,0
17406,2020-04-29T00:00:00Z,RE,Réunion,AFRO,0,417,0,0
17407,2020-04-30T00:00:00Z,RE,Réunion,AFRO,3,420,0,0
17408,2020-05-01T00:00:00Z,RE,Réunion,AFRO,0,420,0,0
17409,2020-05-02T00:00:00Z,RE,Réunion,AFRO,0,420,0,0
17410,2020-05-03T00:00:00Z,RE,Réunion,AFRO,0,420,0,0
17411,2020-05-04T00:00:00Z,RE,Réunion,AFRO,3,423,0,0
17412,2020-05-05T00:00:00Z,RE,Réunion,AFRO,1,424,0,0
17413,2020-05-06T00:00:00Z,RE,Réunion,AFRO,1,425,0,0
17414,2020-05-07T00:00:00Z,RE,Réunion,AFRO,0,425,0,0
17415,2020-05-08T00:00:00Z,RE,Réunion,AFRO,2,427,0,0
17416,2020-05-09T00:00:00Z,RE,Réunion,AFRO,3,430,0,0
17417,2020-05-10T00:00:00Z,RE,Réunion,AFRO,0,430,0,0
17418,2020-05-11T00:00:00Z,RE,Réunion,AFRO,6,436,0,0
17419,2020-05-12T00:00:00Z,RE,Réunion,AFRO,0,436,0,0
17420,2020-05-13T00:00:00Z,RE,Réunion,AFRO,1,437,0,0
17421,2020-05-14T00:00:00Z,RE,Réunion,AFRO,2,439,0,0
17422,2020-05-15T00:00:00Z,RE,Réunion,AFRO,1,440,0,0
17423,2020-05-16T00:00:00Z,RE,Réunion,AFRO,1,441,0,0
17424,2020-05-17T00:00:00Z,RE,Réunion,AFRO,2,443,0,0
17425,2020-05-18T00:00:00Z,RE,Réunion,AFRO,0,443,0,0
17426,2020-05-19T00:00:00Z,RE,Réunion,AFRO,3,446,0,0
17427,2020-05-20T00:00:00Z,RE,Réunion,AFRO,0,446,0,0
17428,2020-05-21T00:00:00Z,RE,Réunion,AFRO,1,447,1,1
17429,2020-05-22T00:00:00Z,RE,Réunion,AFRO,2,449,0,1
17430,2020-05-23T00:00:00Z,RE,Réunion,AFRO,0,449,0,1
17431,2020-05-24T00:00:00Z,RE,Réunion,AFRO,3,452,0,1
17432,2020-05-25T00:00:00Z,RE,Réunion,AFRO,0,452,0,1
17433,2020-05-26T00:00:00Z,RE,Réunion,AFRO,4,456,0,1
17434,2020-05-27T00:00:00Z,RE,Réunion,AFRO,3,459,0,1
17435,2020-05-28T00:00:00Z,RE,Réunion,AFRO,1,460,0,1
17436,2020-05-29T00:00:00Z,RE,Réunion,AFRO,5,465,0,1
17437,2020-05-30T00:00:00Z,RE,Réunion,AFRO,5,470,0,1
17438,2020-05-31T00:00:00Z,RE,Réunion,AFRO,1,471,0,1
17439,2020-06-01T00:00:00Z,RE,Réunion,AFRO,0,471,0,1
17440,2020-06-02T00:00:00Z,RE,Réunion,AFRO,2,473,0,1
17441,2020-06-03T00:00:00Z,RE,Réunion,AFRO,4,477,0,1
17442,2020-06-04T00:00:00Z,RE,Réunion,AFRO,1,478,0,1
17443,2020-06-05T00:00:00Z,RE,Réunion,AFRO,1,479,0,1
17444,2020-06-06T00:00:00Z,RE,Réunion,AFRO,1,480,0,1
17445,2020-06-07T00:00:00Z,RE,Réunion,AFRO,0,480,0,1
17446,2020-06-08T00:00:00Z,RE,Réunion,AFRO,0,480,0,1
17447,2020-06-09T00:00:00Z,RE,Réunion,AFRO,1,481,0,1
17448,2020-06-10T00:00:00Z,RE,Réunion,AFRO,0,481,0,1
17449,2020-06-11T00:00:00Z,RE,Réunion,AFRO,5,486,0,1
17450,2020-06-12T00:00:00Z,RE,Réunion,AFRO,1,487,0,1
17451,2020-06-13T00:00:00Z,RE,Réunion,AFRO,1,488,0,1
17452,2020-06-14T00:00:00Z,RE,Réunion,AFRO,1,489,0,1
17453,2020-06-15T00:00:00Z,RE,Réunion,AFRO,6,495,0,1
17454,2020-06-16T00:00:00Z,RE,Réunion,AFRO,1,496,0,1
17455,2020-06-17T00:00:00Z,RE,Réunion,AFRO,-1,495,0,1
17456,2020-06-18T00:00:00Z,RE,Réunion,AFRO,2,497,0,1
17457,2020-06-19T00:00:00Z,RE,Réunion,AFRO,5,502,0,1
17458,2020-06-20T00:00:00Z,RE,Réunion,AFRO,2,504,0,1
17717,2020-03-15T00:00:00Z,RW,Rwanda,AFRO,5,5,0,0
17718,2020-03-16T00:00:00Z,RW,Rwanda,AFRO,0,5,0,0
17719,2020-03-17T00:00:00Z,RW,Rwanda,AFRO,2,7,0,0
17720,2020-03-18T00:00:00Z,RW,Rwanda,AFRO,4,11,0,0
17721,2020-03-19T00:00:00Z,RW,Rwanda,AFRO,0,11,0,0
17722,2020-03-20T00:00:00Z,RW,Rwanda,AFRO,0,11,0,0
17723,2020-03-21T00:00:00Z,RW,Rwanda,AFRO,6,17,0,0
17724,2020-03-22T00:00:00Z,RW,Rwanda,AFRO,0,17,0,0
17725,2020-03-23T00:00:00Z,RW,Rwanda,AFRO,0,17,0,0
17726,2020-03-24T00:00:00Z,RW,Rwanda,AFRO,19,36,0,0
17727,2020-03-25T00:00:00Z,RW,Rwanda,AFRO,4,40,0,0
17728,2020-03-26T00:00:00Z,RW,Rwanda,AFRO,1,41,0,0
17729,2020-03-27T00:00:00Z,RW,Rwanda,AFRO,9,50,0,0
17730,2020-03-28T00:00:00Z,RW,Rwanda,AFRO,4,54,0,0
17731,2020-03-29T00:00:00Z,RW,Rwanda,AFRO,6,60,0,0
17732,2020-03-30T00:00:00Z,RW,Rwanda,AFRO,10,70,0,0
17733,2020-03-31T00:00:00Z,RW,Rwanda,AFRO,0,70,0,0
17734,2020-04-01T00:00:00Z,RW,Rwanda,AFRO,5,75,0,0
17735,2020-04-02T00:00:00Z,RW,Rwanda,AFRO,7,82,0,0
17736,2020-04-03T00:00:00Z,RW,Rwanda,AFRO,2,84,0,0
17737,2020-04-04T00:00:00Z,RW,Rwanda,AFRO,5,89,0,0
17738,2020-04-05T00:00:00Z,RW,Rwanda,AFRO,13,102,0,0
17739,2020-04-06T00:00:00Z,RW,Rwanda,AFRO,0,102,0,0
17740,2020-04-07T00:00:00Z,RW,Rwanda,AFRO,2,104,0,0
17741,2020-04-08T00:00:00Z,RW,Rwanda,AFRO,1,105,0,0
17742,2020-04-09T00:00:00Z,RW,Rwanda,AFRO,5,110,0,0
17743,2020-04-10T00:00:00Z,RW,Rwanda,AFRO,3,113,0,0
17744,2020-04-11T00:00:00Z,RW,Rwanda,AFRO,5,118,0,0
17745,2020-04-12T00:00:00Z,RW,Rwanda,AFRO,2,120,0,0
17746,2020-04-13T00:00:00Z,RW,Rwanda,AFRO,6,126,0,0
17747,2020-04-14T00:00:00Z,RW,Rwanda,AFRO,1,127,0,0
17748,2020-04-15T00:00:00Z,RW,Rwanda,AFRO,7,134,0,0
17749,2020-04-16T00:00:00Z,RW,Rwanda,AFRO,2,136,0,0
17750,2020-04-17T00:00:00Z,RW,Rwanda,AFRO,2,138,0,0
17751,2020-04-18T00:00:00Z,RW,Rwanda,AFRO,0,138,0,0
17752,2020-04-19T00:00:00Z,RW,Rwanda,AFRO,6,144,0,0
17753,2020-04-20T00:00:00Z,RW,Rwanda,AFRO,3,147,0,0
17754,2020-04-21T00:00:00Z,RW,Rwanda,AFRO,0,147,0,0
17755,2020-04-22T00:00:00Z,RW,Rwanda,AFRO,3,150,0,0
17756,2020-04-23T00:00:00Z,RW,Rwanda,AFRO,3,153,0,0
17757,2020-04-24T00:00:00Z,RW,Rwanda,AFRO,1,154,0,0
17758,2020-04-25T00:00:00Z,RW,Rwanda,AFRO,22,176,0,0
17759,2020-04-26T00:00:00Z,RW,Rwanda,AFRO,7,183,0,0
17760,2020-04-27T00:00:00Z,RW,Rwanda,AFRO,8,191,0,0
17761,2020-04-28T00:00:00Z,RW,Rwanda,AFRO,16,207,0,0
17762,2020-04-29T00:00:00Z,RW,Rwanda,AFRO,5,212,0,0
17763,2020-04-30T00:00:00Z,RW,Rwanda,AFRO,13,225,0,0
17764,2020-05-01T00:00:00Z,RW,Rwanda,AFRO,18,243,0,0
17765,2020-05-02T00:00:00Z,RW,Rwanda,AFRO,6,249,0,0
17766,2020-05-03T00:00:00Z,RW,Rwanda,AFRO,6,255,0,0
17767,2020-05-04T00:00:00Z,RW,Rwanda,AFRO,4,259,0,0
17768,2020-05-05T00:00:00Z,RW,Rwanda,AFRO,2,261,0,0
17769,2020-05-06T00:00:00Z,RW,Rwanda,AFRO,0,261,0,0
17770,2020-05-07T00:00:00Z,RW,Rwanda,AFRO,7,268,0,0
17771,2020-05-08T00:00:00Z,RW,Rwanda,AFRO,3,271,0,0
17772,2020-05-09T00:00:00Z,RW,Rwanda,AFRO,2,273,0,0
17773,2020-05-10T00:00:00Z,RW,Rwanda,AFRO,7,280,0,0
17774,2020-05-11T00:00:00Z,RW,Rwanda,AFRO,4,284,0,0
17775,2020-05-12T00:00:00Z,RW,Rwanda,AFRO,1,285,0,0
17776,2020-05-13T00:00:00Z,RW,Rwanda,AFRO,1,286,0,0
17777,2020-05-14T00:00:00Z,RW,Rwanda,AFRO,1,287,0,0
17778,2020-05-15T00:00:00Z,RW,Rwanda,AFRO,0,287,0,0
17779,2020-05-16T00:00:00Z,RW,Rwanda,AFRO,0,287,0,0
17780,2020-05-17T00:00:00Z,RW,Rwanda,AFRO,2,289,0,0
17781,2020-05-18T00:00:00Z,RW,Rwanda,AFRO,3,292,0,0
17782,2020-05-19T00:00:00Z,RW,Rwanda,AFRO,5,297,0,0
17783,2020-05-20T00:00:00Z,RW,Rwanda,AFRO,11,308,0,0
17784,2020-05-21T00:00:00Z,RW,Rwanda,AFRO,6,314,0,0
17785,2020-05-22T00:00:00Z,RW,Rwanda,AFRO,6,320,0,0
17786,2020-05-23T00:00:00Z,RW,Rwanda,AFRO,1,321,0,0
17787,2020-05-24T00:00:00Z,RW,Rwanda,AFRO,4,325,0,0
17788,2020-05-25T00:00:00Z,RW,Rwanda,AFRO,2,327,0,0
17789,2020-05-26T00:00:00Z,RW,Rwanda,AFRO,9,336,0,0
17790,2020-05-27T00:00:00Z,RW,Rwanda,AFRO,3,339,0,0
17791,2020-05-28T00:00:00Z,RW,Rwanda,AFRO,7,346,0,0
17792,2020-05-29T00:00:00Z,RW,Rwanda,AFRO,3,349,0,0
17793,2020-05-30T00:00:00Z,RW,Rwanda,AFRO,6,355,0,0
17794,2020-05-31T00:00:00Z,RW,Rwanda,AFRO,4,359,1,1
17795,2020-06-01T00:00:00Z,RW,Rwanda,AFRO,11,370,0,1
17796,2020-06-02T00:00:00Z,RW,Rwanda,AFRO,7,377,0,1
17797,2020-06-03T00:00:00Z,RW,Rwanda,AFRO,7,384,1,2
17798,2020-06-04T00:00:00Z,RW,Rwanda,AFRO,13,397,0,2
17799,2020-06-05T00:00:00Z,RW,Rwanda,AFRO,13,410,0,2
17800,2020-06-06T00:00:00Z,RW,Rwanda,AFRO,10,420,0,2
17801,2020-06-07T00:00:00Z,RW,Rwanda,AFRO,11,431,0,2
17802,2020-06-08T00:00:00Z,RW,Rwanda,AFRO,8,439,0,2
17803,2020-06-09T00:00:00Z,RW,Rwanda,AFRO,12,451,0,2
17804,2020-06-10T00:00:00Z,RW,Rwanda,AFRO,12,463,0,2
17805,2020-06-11T00:00:00Z,RW,Rwanda,AFRO,13,476,0,2
17806,2020-06-12T00:00:00Z,RW,Rwanda,AFRO,18,494,0,2
17807,2020-06-13T00:00:00Z,RW,Rwanda,AFRO,16,510,0,2
17808,2020-06-14T00:00:00Z,RW,Rwanda,AFRO,31,541,0,2
17809,2020-06-15T00:00:00Z,RW,Rwanda,AFRO,41,582,0,2
17810,2020-06-16T00:00:00Z,RW,Rwanda,AFRO,30,612,0,2
17811,2020-06-17T00:00:00Z,RW,Rwanda,AFRO,24,636,0,2
17812,2020-06-18T00:00:00Z,RW,Rwanda,AFRO,3,639,0,2
17813,2020-06-19T00:00:00Z,RW,Rwanda,AFRO,7,646,0,2
17814,2020-06-20T00:00:00Z,RW,Rwanda,AFRO,15,661,0,2
18510,2020-04-06T00:00:00Z,ST,Sao Tome and Principe,AFRO,4,4,0,0
18511,2020-04-07T00:00:00Z,ST,Sao Tome and Principe,AFRO,0,4,0,0
18512,2020-04-08T00:00:00Z,ST,Sao Tome and Principe,AFRO,0,4,0,0
18513,2020-04-09T00:00:00Z,ST,Sao Tome and Principe,AFRO,0,4,0,0
18514,2020-04-10T00:00:00Z,ST,Sao Tome and Principe,AFRO,0,4,0,0
18515,2020-04-11T00:00:00Z,ST,Sao Tome and Principe,AFRO,0,4,0,0
18516,2020-04-12T00:00:00Z,ST,Sao Tome and Principe,AFRO,0,4,0,0
18517,2020-04-13T00:00:00Z,ST,Sao Tome and Principe,AFRO,0,4,0,0
18518,2020-04-14T00:00:00Z,ST,Sao Tome and Principe,AFRO,0,4,0,0
18519,2020-04-15T00:00:00Z,ST,Sao Tome and Principe,AFRO,0,4,0,0
18520,2020-04-16T00:00:00Z,ST,Sao Tome and Principe,AFRO,0,4,0,0
18521,2020-04-17T00:00:00Z,ST,Sao Tome and Principe,AFRO,0,4,0,0
18522,2020-04-18T00:00:00Z,ST,Sao Tome and Principe,AFRO,0,4,0,0
18523,2020-04-19T00:00:00Z,ST,Sao Tome and Principe,AFRO,0,4,0,0
18524,2020-04-20T00:00:00Z,ST,Sao Tome and Principe,AFRO,0,4,0,0
18525,2020-04-21T00:00:00Z,ST,Sao Tome and Principe,AFRO,0,4,0,0
18526,2020-04-22T00:00:00Z,ST,Sao Tome and Principe,AFRO,0,4,0,0
18527,2020-04-23T00:00:00Z,ST,Sao Tome and Principe,AFRO,3,7,0,0
18528,2020-04-24T00:00:00Z,ST,Sao Tome and Principe,AFRO,1,8,0,0
18529,2020-04-25T00:00:00Z,ST,Sao Tome and Principe,AFRO,0,8,0,0
18530,2020-04-26T00:00:00Z,ST,Sao Tome and Principe,AFRO,0,8,0,0
18531,2020-04-27T00:00:00Z,ST,Sao Tome and Principe,AFRO,0,8,0,0
18532,2020-04-28T00:00:00Z,ST,Sao Tome and Principe,AFRO,0,8,0,0
18533,2020-04-29T00:00:00Z,ST,Sao Tome and Principe,AFRO,3,11,0,0
18534,2020-04-30T00:00:00Z,ST,Sao Tome and Principe,AFRO,0,11,0,0
18535,2020-05-01T00:00:00Z,ST,Sao Tome and Principe,AFRO,5,16,1,1
18536,2020-05-02T00:00:00Z,ST,Sao Tome and Principe,AFRO,0,16,0,1
18537,2020-05-03T00:00:00Z,ST,Sao Tome and Principe,AFRO,7,23,2,3
18538,2020-05-04T00:00:00Z,ST,Sao Tome and Principe,AFRO,0,23,0,3
18539,2020-05-05T00:00:00Z,ST,Sao Tome and Principe,AFRO,138,161,0,3
18540,2020-05-06T00:00:00Z,ST,Sao Tome and Principe,AFRO,10,171,0,3
18541,2020-05-07T00:00:00Z,ST,Sao Tome and Principe,AFRO,3,174,0,3
18542,2020-05-08T00:00:00Z,ST,Sao Tome and Principe,AFRO,-9,165,1,4
18543,2020-05-09T00:00:00Z,ST,Sao Tome and Principe,AFRO,43,208,1,5
18544,2020-05-10T00:00:00Z,ST,Sao Tome and Principe,AFRO,-43,165,-1,4
18545,2020-05-11T00:00:00Z,ST,Sao Tome and Principe,AFRO,0,165,0,4
18546,2020-05-12T00:00:00Z,ST,Sao Tome and Principe,AFRO,0,165,0,4
18547,2020-05-13T00:00:00Z,ST,Sao Tome and Principe,AFRO,0,165,0,4
18548,2020-05-14T00:00:00Z,ST,Sao Tome and Principe,AFRO,0,165,3,7
18549,2020-05-15T00:00:00Z,ST,Sao Tome and Principe,AFRO,1,166,0,7
18550,2020-05-16T00:00:00Z,ST,Sao Tome and Principe,AFRO,0,166,0,7
18551,2020-05-17T00:00:00Z,ST,Sao Tome and Principe,AFRO,3,169,0,7
18552,2020-05-18T00:00:00Z,ST,Sao Tome and Principe,AFRO,0,169,0,7
18553,2020-05-19T00:00:00Z,ST,Sao Tome and Principe,AFRO,-4,165,0,7
18554,2020-05-20T00:00:00Z,ST,Sao Tome and Principe,AFRO,0,165,0,7
18555,2020-05-21T00:00:00Z,ST,Sao Tome and Principe,AFRO,0,165,1,8
18556,2020-05-22T00:00:00Z,ST,Sao Tome and Principe,AFRO,0,165,0,8
18557,2020-05-23T00:00:00Z,ST,Sao Tome and Principe,AFRO,0,165,0,8
18558,2020-05-24T00:00:00Z,ST,Sao Tome and Principe,AFRO,9,174,0,8
18559,2020-05-25T00:00:00Z,ST,Sao Tome and Principe,AFRO,0,174,1,9
18560,2020-05-26T00:00:00Z,ST,Sao Tome and Principe,AFRO,-9,165,1,10
18561,2020-05-27T00:00:00Z,ST,Sao Tome and Principe,AFRO,130,295,0,10
18562,2020-05-28T00:00:00Z,ST,Sao Tome and Principe,AFRO,0,295,0,10
18563,2020-05-29T00:00:00Z,ST,Sao Tome and Principe,AFRO,0,295,0,10
18564,2020-05-30T00:00:00Z,ST,Sao Tome and Principe,AFRO,0,295,0,10
18565,2020-05-31T00:00:00Z,ST,Sao Tome and Principe,AFRO,0,295,0,10
18566,2020-06-01T00:00:00Z,ST,Sao Tome and Principe,AFRO,0,295,0,10
18567,2020-06-02T00:00:00Z,ST,Sao Tome and Principe,AFRO,0,295,0,10
18568,2020-06-03T00:00:00Z,ST,Sao Tome and Principe,AFRO,0,295,0,10
18569,2020-06-04T00:00:00Z,ST,Sao Tome and Principe,AFRO,0,295,0,10
18570,2020-06-05T00:00:00Z,ST,Sao Tome and Principe,AFRO,0,295,0,10
18571,2020-06-06T00:00:00Z,ST,Sao Tome and Principe,AFRO,0,295,0,10
18572,2020-06-07T00:00:00Z,ST,Sao Tome and Principe,AFRO,0,295,0,10
18573,2020-06-08T00:00:00Z,ST,Sao Tome and Principe,AFRO,0,295,0,10
18574,2020-06-09T00:00:00Z,ST,Sao Tome and Principe,AFRO,0,295,0,10
18575,2020-06-10T00:00:00Z,ST,Sao Tome and Principe,AFRO,0,295,0,10
18576,2020-06-11T00:00:00Z,ST,Sao Tome and Principe,AFRO,93,388,0,10
18577,2020-06-12T00:00:00Z,ST,Sao Tome and Principe,AFRO,0,388,0,10
18578,2020-06-13T00:00:00Z,ST,Sao Tome and Principe,AFRO,0,388,0,10
18579,2020-06-14T00:00:00Z,ST,Sao Tome and Principe,AFRO,0,388,0,10
18580,2020-06-15T00:00:00Z,ST,Sao Tome and Principe,AFRO,0,388,0,10
18581,2020-06-16T00:00:00Z,ST,Sao Tome and Principe,AFRO,0,388,0,10
18582,2020-06-17T00:00:00Z,ST,Sao Tome and Principe,AFRO,10,398,0,10
18583,2020-06-18T00:00:00Z,ST,Sao Tome and Principe,AFRO,-10,388,0,10
18584,2020-06-19T00:00:00Z,ST,Sao Tome and Principe,AFRO,0,388,0,10
18585,2020-06-20T00:00:00Z,ST,Sao Tome and Principe,AFRO,0,388,0,10
18697,2020-03-02T00:00:00Z,SN,Senegal,AFRO,1,1,0,0
18698,2020-03-03T00:00:00Z,SN,Senegal,AFRO,0,1,0,0
18699,2020-03-04T00:00:00Z,SN,Senegal,AFRO,3,4,0,0
18700,2020-03-05T00:00:00Z,SN,Senegal,AFRO,0,4,0,0
18701,2020-03-06T00:00:00Z,SN,Senegal,AFRO,0,4,0,0
18702,2020-03-07T00:00:00Z,SN,Senegal,AFRO,0,4,0,0
18703,2020-03-08T00:00:00Z,SN,Senegal,AFRO,0,4,0,0
18704,2020-03-09T00:00:00Z,SN,Senegal,AFRO,0,4,0,0
18705,2020-03-10T00:00:00Z,SN,Senegal,AFRO,0,4,0,0
18706,2020-03-11T00:00:00Z,SN,Senegal,AFRO,0,4,0,0
18707,2020-03-12T00:00:00Z,SN,Senegal,AFRO,6,10,0,0
18708,2020-03-13T00:00:00Z,SN,Senegal,AFRO,0,10,0,0
18709,2020-03-14T00:00:00Z,SN,Senegal,AFRO,11,21,0,0
18710,2020-03-15T00:00:00Z,SN,Senegal,AFRO,5,26,0,0
18711,2020-03-16T00:00:00Z,SN,Senegal,AFRO,0,26,0,0
18712,2020-03-17T00:00:00Z,SN,Senegal,AFRO,1,27,0,0
18713,2020-03-18T00:00:00Z,SN,Senegal,AFRO,9,36,0,0
18714,2020-03-19T00:00:00Z,SN,Senegal,AFRO,2,38,0,0
18715,2020-03-20T00:00:00Z,SN,Senegal,AFRO,0,38,0,0
18716,2020-03-21T00:00:00Z,SN,Senegal,AFRO,18,56,0,0
18717,2020-03-22T00:00:00Z,SN,Senegal,AFRO,0,56,0,0
18718,2020-03-23T00:00:00Z,SN,Senegal,AFRO,11,67,0,0
18719,2020-03-24T00:00:00Z,SN,Senegal,AFRO,12,79,0,0
18720,2020-03-25T00:00:00Z,SN,Senegal,AFRO,7,86,0,0
18721,2020-03-26T00:00:00Z,SN,Senegal,AFRO,13,99,0,0
18722,2020-03-27T00:00:00Z,SN,Senegal,AFRO,6,105,0,0
18723,2020-03-28T00:00:00Z,SN,Senegal,AFRO,14,119,0,0
18724,2020-03-29T00:00:00Z,SN,Senegal,AFRO,11,130,0,0
18725,2020-03-30T00:00:00Z,SN,Senegal,AFRO,12,142,0,0
18726,2020-03-31T00:00:00Z,SN,Senegal,AFRO,20,162,0,0
18727,2020-04-01T00:00:00Z,SN,Senegal,AFRO,13,175,0,0
18728,2020-04-02T00:00:00Z,SN,Senegal,AFRO,15,190,1,1
18729,2020-04-03T00:00:00Z,SN,Senegal,AFRO,5,195,0,1
18730,2020-04-04T00:00:00Z,SN,Senegal,AFRO,24,219,1,2
18731,2020-04-05T00:00:00Z,SN,Senegal,AFRO,0,219,0,2
18732,2020-04-06T00:00:00Z,SN,Senegal,AFRO,7,226,0,2
18733,2020-04-07T00:00:00Z,SN,Senegal,AFRO,0,226,0,2
18734,2020-04-08T00:00:00Z,SN,Senegal,AFRO,11,237,0,2
18735,2020-04-09T00:00:00Z,SN,Senegal,AFRO,7,244,0,2
18736,2020-04-10T00:00:00Z,SN,Senegal,AFRO,6,250,0,2
18737,2020-04-11T00:00:00Z,SN,Senegal,AFRO,15,265,0,2
18738,2020-04-12T00:00:00Z,SN,Senegal,AFRO,13,278,0,2
18739,2020-04-13T00:00:00Z,SN,Senegal,AFRO,2,280,0,2
18740,2020-04-14T00:00:00Z,SN,Senegal,AFRO,11,291,0,2
18741,2020-04-15T00:00:00Z,SN,Senegal,AFRO,8,299,0,2
18742,2020-04-16T00:00:00Z,SN,Senegal,AFRO,15,314,0,2
18743,2020-04-17T00:00:00Z,SN,Senegal,AFRO,21,335,0,2
18744,2020-04-18T00:00:00Z,SN,Senegal,AFRO,7,342,1,3
18745,2020-04-19T00:00:00Z,SN,Senegal,AFRO,8,350,0,3
18746,2020-04-20T00:00:00Z,SN,Senegal,AFRO,17,367,0,3
18747,2020-04-21T00:00:00Z,SN,Senegal,AFRO,10,377,2,5
18748,2020-04-22T00:00:00Z,SN,Senegal,AFRO,35,412,0,5
18749,2020-04-23T00:00:00Z,SN,Senegal,AFRO,30,442,1,6
18750,2020-04-24T00:00:00Z,SN,Senegal,AFRO,37,479,0,6
18751,2020-04-25T00:00:00Z,SN,Senegal,AFRO,66,545,1,7
18752,2020-04-26T00:00:00Z,SN,Senegal,AFRO,69,614,0,7
18753,2020-04-27T00:00:00Z,SN,Senegal,AFRO,57,671,2,9
18754,2020-04-28T00:00:00Z,SN,Senegal,AFRO,64,735,0,9
18755,2020-04-29T00:00:00Z,SN,Senegal,AFRO,88,823,0,9
18756,2020-04-30T00:00:00Z,SN,Senegal,AFRO,59,882,0,9
18757,2020-05-01T00:00:00Z,SN,Senegal,AFRO,51,933,0,9
18758,2020-05-02T00:00:00Z,SN,Senegal,AFRO,91,1024,0,9
18759,2020-05-03T00:00:00Z,SN,Senegal,AFRO,89,1113,0,9
18760,2020-05-04T00:00:00Z,SN,Senegal,AFRO,158,1271,0,9
18761,2020-05-05T00:00:00Z,SN,Senegal,AFRO,0,1271,1,10
18762,2020-05-06T00:00:00Z,SN,Senegal,AFRO,58,1329,1,11
18763,2020-05-07T00:00:00Z,SN,Senegal,AFRO,104,1433,1,12
18764,2020-05-08T00:00:00Z,SN,Senegal,AFRO,59,1492,1,13
18765,2020-05-09T00:00:00Z,SN,Senegal,AFRO,59,1551,0,13
18766,2020-05-10T00:00:00Z,SN,Senegal,AFRO,83,1634,4,17
18767,2020-05-11T00:00:00Z,SN,Senegal,AFRO,75,1709,2,19
18768,2020-05-12T00:00:00Z,SN,Senegal,AFRO,177,1886,0,19
18769,2020-05-13T00:00:00Z,SN,Senegal,AFRO,109,1995,0,19
18770,2020-05-14T00:00:00Z,SN,Senegal,AFRO,110,2105,3,22
18771,2020-05-15T00:00:00Z,SN,Senegal,AFRO,84,2189,1,23
18772,2020-05-16T00:00:00Z,SN,Senegal,AFRO,121,2310,0,23
18773,2020-05-17T00:00:00Z,SN,Senegal,AFRO,119,2429,2,25
18774,2020-05-18T00:00:00Z,SN,Senegal,AFRO,51,2480,0,25
18775,2020-05-19T00:00:00Z,SN,Senegal,AFRO,64,2544,1,26
18776,2020-05-20T00:00:00Z,SN,Senegal,AFRO,73,2617,4,30
18777,2020-05-21T00:00:00Z,SN,Senegal,AFRO,97,2714,0,30
18778,2020-05-22T00:00:00Z,SN,Senegal,AFRO,101,2815,3,33
18779,2020-05-23T00:00:00Z,SN,Senegal,AFRO,94,2909,0,33
18780,2020-05-24T00:00:00Z,SN,Senegal,AFRO,67,2976,1,34
18781,2020-05-25T00:00:00Z,SN,Senegal,AFRO,71,3047,1,35
18782,2020-05-26T00:00:00Z,SN,Senegal,AFRO,83,3130,0,35
18783,2020-05-27T00:00:00Z,SN,Senegal,AFRO,31,3161,2,37
18784,2020-05-28T00:00:00Z,SN,Senegal,AFRO,92,3253,2,39
18785,2020-05-29T00:00:00Z,SN,Senegal,AFRO,95,3348,2,41
18786,2020-05-30T00:00:00Z,SN,Senegal,AFRO,81,3429,0,41
18787,2020-05-31T00:00:00Z,SN,Senegal,AFRO,106,3535,1,42
18788,2020-06-01T00:00:00Z,SN,Senegal,AFRO,110,3645,0,42
18789,2020-06-02T00:00:00Z,SN,Senegal,AFRO,94,3739,0,42
18790,2020-06-03T00:00:00Z,SN,Senegal,AFRO,97,3836,1,43
18791,2020-06-04T00:00:00Z,SN,Senegal,AFRO,96,3932,2,45
18792,2020-06-05T00:00:00Z,SN,Senegal,AFRO,89,4021,0,45
18793,2020-06-06T00:00:00Z,SN,Senegal,AFRO,134,4155,0,45
18794,2020-06-07T00:00:00Z,SN,Senegal,AFRO,94,4249,2,47
18795,2020-06-08T00:00:00Z,SN,Senegal,AFRO,79,4328,2,49
18796,2020-06-09T00:00:00Z,SN,Senegal,AFRO,102,4430,0,49
18797,2020-06-10T00:00:00Z,SN,Senegal,AFRO,86,4516,3,52
18798,2020-06-11T00:00:00Z,SN,Senegal,AFRO,124,4640,2,54
18799,2020-06-12T00:00:00Z,SN,Senegal,AFRO,119,4759,1,55
18800,2020-06-13T00:00:00Z,SN,Senegal,AFRO,92,4851,1,56
18801,2020-06-14T00:00:00Z,SN,Senegal,AFRO,145,4996,4,60
18802,2020-06-15T00:00:00Z,SN,Senegal,AFRO,94,5090,0,60
18803,2020-06-16T00:00:00Z,SN,Senegal,AFRO,0,5090,0,60
18804,2020-06-17T00:00:00Z,SN,Senegal,AFRO,157,5247,10,70
18805,2020-06-18T00:00:00Z,SN,Senegal,AFRO,122,5369,3,73
18806,2020-06-19T00:00:00Z,SN,Senegal,AFRO,106,5475,3,76
18807,2020-06-20T00:00:00Z,SN,Senegal,AFRO,164,5639,3,79
18915,2020-03-15T00:00:00Z,SC,Seychelles,AFRO,2,2,0,0
18916,2020-03-16T00:00:00Z,SC,Seychelles,AFRO,2,4,0,0
18917,2020-03-17T00:00:00Z,SC,Seychelles,AFRO,0,4,0,0
18918,2020-03-18T00:00:00Z,SC,Seychelles,AFRO,2,6,0,0
18919,2020-03-19T00:00:00Z,SC,Seychelles,AFRO,0,6,0,0
18920,2020-03-20T00:00:00Z,SC,Seychelles,AFRO,0,6,0,0
18921,2020-03-21T00:00:00Z,SC,Seychelles,AFRO,1,7,0,0
18922,2020-03-22T00:00:00Z,SC,Seychelles,AFRO,0,7,0,0
18923,2020-03-23T00:00:00Z,SC,Seychelles,AFRO,0,7,0,0
18924,2020-03-24T00:00:00Z,SC,Seychelles,AFRO,0,7,0,0
18925,2020-03-25T00:00:00Z,SC,Seychelles,AFRO,0,7,0,0
18926,2020-03-26T00:00:00Z,SC,Seychelles,AFRO,0,7,0,0
18927,2020-03-27T00:00:00Z,SC,Seychelles,AFRO,0,7,0,0
18928,2020-03-28T00:00:00Z,SC,Seychelles,AFRO,0,7,0,0
18929,2020-03-29T00:00:00Z,SC,Seychelles,AFRO,1,8,0,0
18930,2020-03-30T00:00:00Z,SC,Seychelles,AFRO,0,8,0,0
18931,2020-03-31T00:00:00Z,SC,Seychelles,AFRO,0,8,0,0
18932,2020-04-01T00:00:00Z,SC,Seychelles,AFRO,0,8,0,0
18933,2020-04-02T00:00:00Z,SC,Seychelles,AFRO,2,10,0,0
18934,2020-04-03T00:00:00Z,SC,Seychelles,AFRO,0,10,0,0
18935,2020-04-04T00:00:00Z,SC,Seychelles,AFRO,0,10,0,0
18936,2020-04-05T00:00:00Z,SC,Seychelles,AFRO,0,10,0,0
18937,2020-04-06T00:00:00Z,SC,Seychelles,AFRO,0,10,0,0
18938,2020-04-07T00:00:00Z,SC,Seychelles,AFRO,1,11,0,0
18939,2020-04-08T00:00:00Z,SC,Seychelles,AFRO,0,11,0,0
18940,2020-04-09T00:00:00Z,SC,Seychelles,AFRO,0,11,0,0
18941,2020-04-10T00:00:00Z,SC,Seychelles,AFRO,0,11,0,0
18942,2020-04-11T00:00:00Z,SC,Seychelles,AFRO,0,11,0,0
18943,2020-04-12T00:00:00Z,SC,Seychelles,AFRO,0,11,0,0
18944,2020-04-13T00:00:00Z,SC,Seychelles,AFRO,0,11,0,0
18945,2020-04-14T00:00:00Z,SC,Seychelles,AFRO,0,11,0,0
18946,2020-04-15T00:00:00Z,SC,Seychelles,AFRO,0,11,0,0
18947,2020-04-16T00:00:00Z,SC,Seychelles,AFRO,0,11,0,0
18948,2020-04-17T00:00:00Z,SC,Seychelles,AFRO,0,11,0,0
18949,2020-04-18T00:00:00Z,SC,Seychelles,AFRO,0,11,0,0
18950,2020-04-19T00:00:00Z,SC,Seychelles,AFRO,0,11,0,0
18951,2020-04-20T00:00:00Z,SC,Seychelles,AFRO,0,11,0,0
18952,2020-04-21T00:00:00Z,SC,Seychelles,AFRO,0,11,0,0
18953,2020-04-22T00:00:00Z,SC,Seychelles,AFRO,0,11,0,0
18954,2020-04-23T00:00:00Z,SC,Seychelles,AFRO,0,11,0,0
18955,2020-04-24T00:00:00Z,SC,Seychelles,AFRO,0,11,0,0
18956,2020-04-25T00:00:00Z,SC,Seychelles,AFRO,0,11,0,0
18957,2020-04-26T00:00:00Z,SC,Seychelles,AFRO,0,11,0,0
18958,2020-04-27T00:00:00Z,SC,Seychelles,AFRO,0,11,0,0
18959,2020-04-28T00:00:00Z,SC,Seychelles,AFRO,0,11,0,0
18960,2020-04-29T00:00:00Z,SC,Seychelles,AFRO,0,11,0,0
18961,2020-04-30T00:00:00Z,SC,Seychelles,AFRO,0,11,0,0
18962,2020-05-01T00:00:00Z,SC,Seychelles,AFRO,0,11,0,0
18963,2020-05-02T00:00:00Z,SC,Seychelles,AFRO,0,11,0,0
18964,2020-05-03T00:00:00Z,SC,Seychelles,AFRO,0,11,0,0
18965,2020-05-04T00:00:00Z,SC,Seychelles,AFRO,0,11,0,0
18966,2020-05-05T00:00:00Z,SC,Seychelles,AFRO,0,11,0,0
18967,2020-05-06T00:00:00Z,SC,Seychelles,AFRO,0,11,0,0
18968,2020-05-07T00:00:00Z,SC,Seychelles,AFRO,0,11,0,0
18969,2020-05-08T00:00:00Z,SC,Seychelles,AFRO,0,11,0,0
18970,2020-05-09T00:00:00Z,SC,Seychelles,AFRO,0,11,0,0
18971,2020-05-10T00:00:00Z,SC,Seychelles,AFRO,0,11,0,0
18972,2020-05-11T00:00:00Z,SC,Seychelles,AFRO,0,11,0,0
18973,2020-05-12T00:00:00Z,SC,Seychelles,AFRO,0,11,0,0
18974,2020-05-13T00:00:00Z,SC,Seychelles,AFRO,0,11,0,0
18975,2020-05-14T00:00:00Z,SC,Seychelles,AFRO,0,11,0,0
18976,2020-05-15T00:00:00Z,SC,Seychelles,AFRO,0,11,0,0
18977,2020-05-16T00:00:00Z,SC,Seychelles,AFRO,0,11,0,0
18978,2020-05-17T00:00:00Z,SC,Seychelles,AFRO,0,11,0,0
18979,2020-05-18T00:00:00Z,SC,Seychelles,AFRO,0,11,0,0
18980,2020-05-19T00:00:00Z,SC,Seychelles,AFRO,0,11,0,0
18981,2020-05-20T00:00:00Z,SC,Seychelles,AFRO,0,11,0,0
18982,2020-05-21T00:00:00Z,SC,Seychelles,AFRO,0,11,0,0
18983,2020-05-22T00:00:00Z,SC,Seychelles,AFRO,0,11,0,0
18984,2020-05-23T00:00:00Z,SC,Seychelles,AFRO,0,11,0,0
18985,2020-05-24T00:00:00Z,SC,Seychelles,AFRO,0,11,0,0
18986,2020-05-25T00:00:00Z,SC,Seychelles,AFRO,0,11,0,0
18987,2020-05-26T00:00:00Z,SC,Seychelles,AFRO,0,11,0,0
18988,2020-05-27T00:00:00Z,SC,Seychelles,AFRO,0,11,0,0
18989,2020-05-28T00:00:00Z,SC,Seychelles,AFRO,0,11,0,0
18990,2020-05-29T00:00:00Z,SC,Seychelles,AFRO,0,11,0,0
18991,2020-05-30T00:00:00Z,SC,Seychelles,AFRO,0,11,0,0
18992,2020-05-31T00:00:00Z,SC,Seychelles,AFRO,0,11,0,0
18993,2020-06-01T00:00:00Z,SC,Seychelles,AFRO,0,11,0,0
18994,2020-06-02T00:00:00Z,SC,Seychelles,AFRO,0,11,0,0
18995,2020-06-03T00:00:00Z,SC,Seychelles,AFRO,0,11,0,0
18996,2020-06-04T00:00:00Z,SC,Seychelles,AFRO,0,11,0,0
18997,2020-06-05T00:00:00Z,SC,Seychelles,AFRO,0,11,0,0
18998,2020-06-06T00:00:00Z,SC,Seychelles,AFRO,0,11,0,0
18999,2020-06-07T00:00:00Z,SC,Seychelles,AFRO,0,11,0,0
19000,2020-06-08T00:00:00Z,SC,Seychelles,AFRO,0,11,0,0
19001,2020-06-09T00:00:00Z,SC,Seychelles,AFRO,0,11,0,0
19002,2020-06-10T00:00:00Z,SC,Seychelles,AFRO,0,11,0,0
19003,2020-06-11T00:00:00Z,SC,Seychelles,AFRO,0,11,0,0
19004,2020-06-12T00:00:00Z,SC,Seychelles,AFRO,0,11,0,0
19005,2020-06-13T00:00:00Z,SC,Seychelles,AFRO,0,11,0,0
19006,2020-06-14T00:00:00Z,SC,Seychelles,AFRO,0,11,0,0
19007,2020-06-15T00:00:00Z,SC,Seychelles,AFRO,0,11,0,0
19008,2020-06-16T00:00:00Z,SC,Seychelles,AFRO,0,11,0,0
19009,2020-06-17T00:00:00Z,SC,Seychelles,AFRO,0,11,0,0
19010,2020-06-18T00:00:00Z,SC,Seychelles,AFRO,0,11,0,0
19011,2020-06-19T00:00:00Z,SC,Seychelles,AFRO,0,11,0,0
19012,2020-06-20T00:00:00Z,SC,Seychelles,AFRO,0,11,0,0
19013,2020-04-01T00:00:00Z,SL,Sierra Leone,AFRO,1,1,0,0
19014,2020-04-02T00:00:00Z,SL,Sierra Leone,AFRO,1,2,0,0
19015,2020-04-03T00:00:00Z,SL,Sierra Leone,AFRO,0,2,0,0
19016,2020-04-04T00:00:00Z,SL,Sierra Leone,AFRO,0,2,0,0
19017,2020-04-05T00:00:00Z,SL,Sierra Leone,AFRO,2,4,0,0
19018,2020-04-06T00:00:00Z,SL,Sierra Leone,AFRO,2,6,0,0
19019,2020-04-07T00:00:00Z,SL,Sierra Leone,AFRO,0,6,0,0
19020,2020-04-08T00:00:00Z,SL,Sierra Leone,AFRO,0,6,0,0
19021,2020-04-09T00:00:00Z,SL,Sierra Leone,AFRO,1,7,0,0
19022,2020-04-10T00:00:00Z,SL,Sierra Leone,AFRO,0,7,0,0
19023,2020-04-11T00:00:00Z,SL,Sierra Leone,AFRO,0,7,0,0
19024,2020-04-12T00:00:00Z,SL,Sierra Leone,AFRO,1,8,0,0
19025,2020-04-13T00:00:00Z,SL,Sierra Leone,AFRO,2,10,0,0
19026,2020-04-14T00:00:00Z,SL,Sierra Leone,AFRO,0,10,0,0
19027,2020-04-15T00:00:00Z,SL,Sierra Leone,AFRO,1,11,0,0
19028,2020-04-16T00:00:00Z,SL,Sierra Leone,AFRO,2,13,0,0
19029,2020-04-17T00:00:00Z,SL,Sierra Leone,AFRO,2,15,0,0
19030,2020-04-18T00:00:00Z,SL,Sierra Leone,AFRO,11,26,0,0
19031,2020-04-19T00:00:00Z,SL,Sierra Leone,AFRO,4,30,0,0
19032,2020-04-20T00:00:00Z,SL,Sierra Leone,AFRO,5,35,0,0
19033,2020-04-21T00:00:00Z,SL,Sierra Leone,AFRO,8,43,0,0
19034,2020-04-22T00:00:00Z,SL,Sierra Leone,AFRO,7,50,0,0
19035,2020-04-23T00:00:00Z,SL,Sierra Leone,AFRO,11,61,1,1
19036,2020-04-24T00:00:00Z,SL,Sierra Leone,AFRO,3,64,0,1
19037,2020-04-25T00:00:00Z,SL,Sierra Leone,AFRO,18,82,2,3
19038,2020-04-26T00:00:00Z,SL,Sierra Leone,AFRO,4,86,0,3
19039,2020-04-27T00:00:00Z,SL,Sierra Leone,AFRO,7,93,1,4
19040,2020-04-28T00:00:00Z,SL,Sierra Leone,AFRO,6,99,0,4
19041,2020-04-29T00:00:00Z,SL,Sierra Leone,AFRO,5,104,0,4
19042,2020-04-30T00:00:00Z,SL,Sierra Leone,AFRO,12,116,1,5
19043,2020-05-01T00:00:00Z,SL,Sierra Leone,AFRO,8,124,2,7
19044,2020-05-02T00:00:00Z,SL,Sierra Leone,AFRO,12,136,1,8
19045,2020-05-03T00:00:00Z,SL,Sierra Leone,AFRO,19,155,0,8
19046,2020-05-04T00:00:00Z,SL,Sierra Leone,AFRO,2,157,0,8
19047,2020-05-05T00:00:00Z,SL,Sierra Leone,AFRO,21,178,1,9
19048,2020-05-06T00:00:00Z,SL,Sierra Leone,AFRO,21,199,2,11
19049,2020-05-07T00:00:00Z,SL,Sierra Leone,AFRO,26,225,3,14
19050,2020-05-08T00:00:00Z,SL,Sierra Leone,AFRO,6,231,0,14
19051,2020-05-09T00:00:00Z,SL,Sierra Leone,AFRO,26,257,3,17
19052,2020-05-10T00:00:00Z,SL,Sierra Leone,AFRO,34,291,1,18
19053,2020-05-11T00:00:00Z,SL,Sierra Leone,AFRO,16,307,0,18
19054,2020-05-12T00:00:00Z,SL,Sierra Leone,AFRO,31,338,1,19
19055,2020-05-13T00:00:00Z,SL,Sierra Leone,AFRO,0,338,1,20
19056,2020-05-14T00:00:00Z,SL,Sierra Leone,AFRO,49,387,1,21
19057,2020-05-15T00:00:00Z,SL,Sierra Leone,AFRO,21,408,5,26
19058,2020-05-16T00:00:00Z,SL,Sierra Leone,AFRO,39,447,1,27
19059,2020-05-17T00:00:00Z,SL,Sierra Leone,AFRO,15,462,2,29
19060,2020-05-18T00:00:00Z,SL,Sierra Leone,AFRO,43,505,3,32
19061,2020-05-19T00:00:00Z,SL,Sierra Leone,AFRO,14,519,1,33
19062,2020-05-20T00:00:00Z,SL,Sierra Leone,AFRO,15,534,0,33
19063,2020-05-21T00:00:00Z,SL,Sierra Leone,AFRO,36,570,1,34
19064,2020-05-22T00:00:00Z,SL,Sierra Leone,AFRO,15,585,1,35
19065,2020-05-23T00:00:00Z,SL,Sierra Leone,AFRO,21,606,3,38
19066,2020-05-24T00:00:00Z,SL,Sierra Leone,AFRO,15,621,1,39
19067,2020-05-25T00:00:00Z,SL,Sierra Leone,AFRO,100,721,1,40
19068,2020-05-26T00:00:00Z,SL,Sierra Leone,AFRO,14,735,2,42
19069,2020-05-27T00:00:00Z,SL,Sierra Leone,AFRO,19,754,2,44
19070,2020-05-28T00:00:00Z,SL,Sierra Leone,AFRO,28,782,1,45
19071,2020-05-29T00:00:00Z,SL,Sierra Leone,AFRO,30,812,0,45
19072,2020-05-30T00:00:00Z,SL,Sierra Leone,AFRO,17,829,0,45
19073,2020-05-31T00:00:00Z,SL,Sierra Leone,AFRO,23,852,1,46
19074,2020-06-01T00:00:00Z,SL,Sierra Leone,AFRO,9,861,0,46
19075,2020-06-02T00:00:00Z,SL,Sierra Leone,AFRO,4,865,0,46
19076,2020-06-03T00:00:00Z,SL,Sierra Leone,AFRO,31,896,0,46
19077,2020-06-04T00:00:00Z,SL,Sierra Leone,AFRO,13,909,1,47
19078,2020-06-05T00:00:00Z,SL,Sierra Leone,AFRO,5,914,0,47
19079,2020-06-06T00:00:00Z,SL,Sierra Leone,AFRO,15,929,0,47
19080,2020-06-07T00:00:00Z,SL,Sierra Leone,AFRO,17,946,1,48
19081,2020-06-08T00:00:00Z,SL,Sierra Leone,AFRO,23,969,0,48
19082,2020-06-09T00:00:00Z,SL,Sierra Leone,AFRO,32,1001,1,49
19083,2020-06-10T00:00:00Z,SL,Sierra Leone,AFRO,24,1025,1,50
19084,2020-06-11T00:00:00Z,SL,Sierra Leone,AFRO,37,1062,0,50
19085,2020-06-12T00:00:00Z,SL,Sierra Leone,AFRO,23,1085,0,50
19086,2020-06-13T00:00:00Z,SL,Sierra Leone,AFRO,18,1103,1,51
19087,2020-06-14T00:00:00Z,SL,Sierra Leone,AFRO,29,1132,0,51
19088,2020-06-15T00:00:00Z,SL,Sierra Leone,AFRO,37,1169,0,51
19089,2020-06-16T00:00:00Z,SL,Sierra Leone,AFRO,7,1176,0,51
19090,2020-06-17T00:00:00Z,SL,Sierra Leone,AFRO,49,1225,0,51
19091,2020-06-18T00:00:00Z,SL,Sierra Leone,AFRO,24,1249,0,51
19092,2020-06-19T00:00:00Z,SL,Sierra Leone,AFRO,23,1272,0,51
19093,2020-06-20T00:00:00Z,SL,Sierra Leone,AFRO,26,1298,2,53
19652,2020-03-05T00:00:00Z,ZA,South Africa,AFRO,1,1,0,0
19653,2020-03-06T00:00:00Z,ZA,South Africa,AFRO,0,1,0,0
19654,2020-03-07T00:00:00Z,ZA,South Africa,AFRO,1,2,0,0
19655,2020-03-08T00:00:00Z,ZA,South Africa,AFRO,1,3,0,0
19656,2020-03-09T00:00:00Z,ZA,South Africa,AFRO,0,3,0,0
19657,2020-03-10T00:00:00Z,ZA,South Africa,AFRO,4,7,0,0
19658,2020-03-11T00:00:00Z,ZA,South Africa,AFRO,0,7,0,0
19659,2020-03-12T00:00:00Z,ZA,South Africa,AFRO,10,17,0,0
19660,2020-03-13T00:00:00Z,ZA,South Africa,AFRO,0,17,0,0
19661,2020-03-14T00:00:00Z,ZA,South Africa,AFRO,21,38,0,0
19662,2020-03-15T00:00:00Z,ZA,South Africa,AFRO,0,38,0,0
19663,2020-03-16T00:00:00Z,ZA,South Africa,AFRO,13,51,0,0
19664,2020-03-17T00:00:00Z,ZA,South Africa,AFRO,11,62,0,0
19665,2020-03-18T00:00:00Z,ZA,South Africa,AFRO,54,116,0,0
19666,2020-03-19T00:00:00Z,ZA,South Africa,AFRO,34,150,0,0
19667,2020-03-20T00:00:00Z,ZA,South Africa,AFRO,55,205,0,0
19668,2020-03-21T00:00:00Z,ZA,South Africa,AFRO,35,240,0,0
19669,2020-03-22T00:00:00Z,ZA,South Africa,AFRO,0,240,0,0
19670,2020-03-23T00:00:00Z,ZA,South Africa,AFRO,34,274,0,0
19671,2020-03-24T00:00:00Z,ZA,South Africa,AFRO,128,402,0,0
19672,2020-03-25T00:00:00Z,ZA,South Africa,AFRO,152,554,0,0
19673,2020-03-26T00:00:00Z,ZA,South Africa,AFRO,373,927,0,0
19674,2020-03-27T00:00:00Z,ZA,South Africa,AFRO,0,927,0,0
19675,2020-03-28T00:00:00Z,ZA,South Africa,AFRO,243,1170,1,1
19676,2020-03-29T00:00:00Z,ZA,South Africa,AFRO,17,1187,0,1
19677,2020-03-30T00:00:00Z,ZA,South Africa,AFRO,93,1280,0,1
19678,2020-03-31T00:00:00Z,ZA,South Africa,AFRO,46,1326,2,3
19679,2020-04-01T00:00:00Z,ZA,South Africa,AFRO,27,1353,2,5
19680,2020-04-02T00:00:00Z,ZA,South Africa,AFRO,27,1380,0,5
19681,2020-04-03T00:00:00Z,ZA,South Africa,AFRO,82,1462,0,5
19682,2020-04-04T00:00:00Z,ZA,South Africa,AFRO,43,1505,2,7
19683,2020-04-05T00:00:00Z,ZA,South Africa,AFRO,80,1585,2,9
19684,2020-04-06T00:00:00Z,ZA,South Africa,AFRO,70,1655,2,11
19685,2020-04-07T00:00:00Z,ZA,South Africa,AFRO,31,1686,1,12
19686,2020-04-08T00:00:00Z,ZA,South Africa,AFRO,63,1749,1,13
19687,2020-04-09T00:00:00Z,ZA,South Africa,AFRO,96,1845,5,18
19688,2020-04-10T00:00:00Z,ZA,South Africa,AFRO,89,1934,0,18
19689,2020-04-11T00:00:00Z,ZA,South Africa,AFRO,69,2003,6,24
19690,2020-04-12T00:00:00Z,ZA,South Africa,AFRO,25,2028,1,25
19691,2020-04-13T00:00:00Z,ZA,South Africa,AFRO,145,2173,0,25
19692,2020-04-14T00:00:00Z,ZA,South Africa,AFRO,99,2272,2,27
19693,2020-04-15T00:00:00Z,ZA,South Africa,AFRO,143,2415,0,27
19694,2020-04-16T00:00:00Z,ZA,South Africa,AFRO,91,2506,7,34
19695,2020-04-17T00:00:00Z,ZA,South Africa,AFRO,99,2605,14,48
19696,2020-04-18T00:00:00Z,ZA,South Africa,AFRO,178,2783,2,50
19697,2020-04-19T00:00:00Z,ZA,South Africa,AFRO,251,3034,2,52
19698,2020-04-20T00:00:00Z,ZA,South Africa,AFRO,124,3158,2,54
19699,2020-04-21T00:00:00Z,ZA,South Africa,AFRO,142,3300,4,58
19700,2020-04-22T00:00:00Z,ZA,South Africa,AFRO,165,3465,0,58
19701,2020-04-23T00:00:00Z,ZA,South Africa,AFRO,170,3635,7,65
19702,2020-04-24T00:00:00Z,ZA,South Africa,AFRO,318,3953,10,75
19703,2020-04-25T00:00:00Z,ZA,South Africa,AFRO,267,4220,4,79
19704,2020-04-26T00:00:00Z,ZA,South Africa,AFRO,141,4361,7,86
19705,2020-04-27T00:00:00Z,ZA,South Africa,AFRO,185,4546,1,87
19706,2020-04-28T00:00:00Z,ZA,South Africa,AFRO,247,4793,3,90
19707,2020-04-29T00:00:00Z,ZA,South Africa,AFRO,203,4996,3,93
19708,2020-04-30T00:00:00Z,ZA,South Africa,AFRO,354,5350,10,103
19709,2020-05-01T00:00:00Z,ZA,South Africa,AFRO,297,5647,0,103
19710,2020-05-02T00:00:00Z,ZA,South Africa,AFRO,304,5951,13,116
19711,2020-05-03T00:00:00Z,ZA,South Africa,AFRO,385,6336,7,123
19712,2020-05-04T00:00:00Z,ZA,South Africa,AFRO,447,6783,8,131
19713,2020-05-05T00:00:00Z,ZA,South Africa,AFRO,437,7220,7,138
19714,2020-05-06T00:00:00Z,ZA,South Africa,AFRO,219,7439,10,148
19715,2020-05-07T00:00:00Z,ZA,South Africa,AFRO,369,7808,5,153
19716,2020-05-08T00:00:00Z,ZA,South Africa,AFRO,424,8232,8,161
19717,2020-05-09T00:00:00Z,ZA,South Africa,AFRO,663,8895,17,178
19718,2020-05-10T00:00:00Z,ZA,South Africa,AFRO,525,9420,8,186
19719,2020-05-11T00:00:00Z,ZA,South Africa,AFRO,595,10015,8,194
19720,2020-05-12T00:00:00Z,ZA,South Africa,AFRO,637,10652,12,206
19721,2020-05-13T00:00:00Z,ZA,South Africa,AFRO,698,11350,0,206
19722,2020-05-14T00:00:00Z,ZA,South Africa,AFRO,724,12074,13,219
19723,2020-05-15T00:00:00Z,ZA,South Africa,AFRO,665,12739,19,238
19724,2020-05-16T00:00:00Z,ZA,South Africa,AFRO,785,13524,9,247
19725,2020-05-17T00:00:00Z,ZA,South Africa,AFRO,831,14355,14,261
19726,2020-05-18T00:00:00Z,ZA,South Africa,AFRO,1160,15515,3,264
19727,2020-05-19T00:00:00Z,ZA,South Africa,AFRO,918,16433,22,286
19728,2020-05-20T00:00:00Z,ZA,South Africa,AFRO,767,17200,26,312
19729,2020-05-21T00:00:00Z,ZA,South Africa,AFRO,803,18003,27,339
19730,2020-05-22T00:00:00Z,ZA,South Africa,AFRO,1134,19137,30,369
19731,2020-05-23T00:00:00Z,ZA,South Africa,AFRO,988,20125,28,397
19732,2020-05-24T00:00:00Z,ZA,South Africa,AFRO,1218,21343,10,407
19733,2020-05-25T00:00:00Z,ZA,South Africa,AFRO,1240,22583,22,429
19734,2020-05-26T00:00:00Z,ZA,South Africa,AFRO,1032,23615,52,481
19735,2020-05-27T00:00:00Z,ZA,South Africa,AFRO,649,24264,43,524
19736,2020-05-28T00:00:00Z,ZA,South Africa,AFRO,1673,25937,28,552
19737,2020-05-29T00:00:00Z,ZA,South Africa,AFRO,1466,27403,25,577
19738,2020-05-30T00:00:00Z,ZA,South Africa,AFRO,1837,29240,34,611
19739,2020-05-31T00:00:00Z,ZA,South Africa,AFRO,1727,30967,32,643
19740,2020-06-01T00:00:00Z,ZA,South Africa,AFRO,1716,32683,40,683
19741,2020-06-02T00:00:00Z,ZA,South Africa,AFRO,1674,34357,22,705
19742,2020-06-03T00:00:00Z,ZA,South Africa,AFRO,1455,35812,50,755
19743,2020-06-04T00:00:00Z,ZA,South Africa,AFRO,1713,37525,37,792
19744,2020-06-05T00:00:00Z,ZA,South Africa,AFRO,3267,40792,56,848
19745,2020-06-06T00:00:00Z,ZA,South Africa,AFRO,2642,43434,60,908
19746,2020-06-07T00:00:00Z,ZA,South Africa,AFRO,2539,45973,44,952
19747,2020-06-08T00:00:00Z,ZA,South Africa,AFRO,2312,48285,46,998
19748,2020-06-09T00:00:00Z,ZA,South Africa,AFRO,2594,50879,82,1080
19749,2020-06-10T00:00:00Z,ZA,South Africa,AFRO,2112,52991,82,1162
19750,2020-06-11T00:00:00Z,ZA,South Africa,AFRO,2430,55421,48,1210
19751,2020-06-12T00:00:00Z,ZA,South Africa,AFRO,3147,58568,74,1284
19752,2020-06-13T00:00:00Z,ZA,South Africa,AFRO,3359,61927,70,1354
19753,2020-06-14T00:00:00Z,ZA,South Africa,AFRO,3809,65736,69,1423
19754,2020-06-15T00:00:00Z,ZA,South Africa,AFRO,4302,70038,57,1480
19755,2020-06-16T00:00:00Z,ZA,South Africa,AFRO,3495,73533,88,1568
19756,2020-06-17T00:00:00Z,ZA,South Africa,AFRO,2801,76334,57,1625
19757,2020-06-18T00:00:00Z,ZA,South Africa,AFRO,4078,80412,49,1674
19758,2020-06-19T00:00:00Z,ZA,South Africa,AFRO,3478,83890,63,1737
19759,2020-06-20T00:00:00Z,ZA,South Africa,AFRO,3825,87715,94,1831
19760,2020-04-06T00:00:00Z,SS,South Sudan,AFRO,1,1,0,0
19761,2020-04-07T00:00:00Z,SS,South Sudan,AFRO,0,1,0,0
19762,2020-04-08T00:00:00Z,SS,South Sudan,AFRO,0,1,0,0
19763,2020-04-09T00:00:00Z,SS,South Sudan,AFRO,0,1,0,0
19764,2020-04-10T00:00:00Z,SS,South Sudan,AFRO,2,3,0,0
19765,2020-04-11T00:00:00Z,SS,South Sudan,AFRO,0,3,0,0
19766,2020-04-12T00:00:00Z,SS,South Sudan,AFRO,1,4,0,0
19767,2020-04-13T00:00:00Z,SS,South Sudan,AFRO,0,4,0,0
19768,2020-04-14T00:00:00Z,SS,South Sudan,AFRO,0,4,0,0
19769,2020-04-15T00:00:00Z,SS,South Sudan,AFRO,0,4,0,0
19770,2020-04-16T00:00:00Z,SS,South Sudan,AFRO,0,4,0,0
19771,2020-04-17T00:00:00Z,SS,South Sudan,AFRO,0,4,0,0
19772,2020-04-18T00:00:00Z,SS,South Sudan,AFRO,0,4,0,0
19773,2020-04-19T00:00:00Z,SS,South Sudan,AFRO,0,4,0,0
19774,2020-04-20T00:00:00Z,SS,South Sudan,AFRO,0,4,0,0
19775,2020-04-21T00:00:00Z,SS,South Sudan,AFRO,0,4,0,0
19776,2020-04-22T00:00:00Z,SS,South Sudan,AFRO,0,4,0,0
19777,2020-04-23T00:00:00Z,SS,South Sudan,AFRO,0,4,0,0
19778,2020-04-24T00:00:00Z,SS,South Sudan,AFRO,0,4,0,0
19779,2020-04-25T00:00:00Z,SS,South Sudan,AFRO,1,5,0,0
19780,2020-04-26T00:00:00Z,SS,South Sudan,AFRO,0,5,0,0
19781,2020-04-27T00:00:00Z,SS,South Sudan,AFRO,1,6,0,0
19782,2020-04-28T00:00:00Z,SS,South Sudan,AFRO,0,6,0,0
19783,2020-04-29T00:00:00Z,SS,South Sudan,AFRO,28,34,0,0
19784,2020-04-30T00:00:00Z,SS,South Sudan,AFRO,0,34,0,0
19785,2020-05-01T00:00:00Z,SS,South Sudan,AFRO,1,35,0,0
19786,2020-05-02T00:00:00Z,SS,South Sudan,AFRO,10,45,0,0
19787,2020-05-03T00:00:00Z,SS,South Sudan,AFRO,0,45,0,0
19788,2020-05-04T00:00:00Z,SS,South Sudan,AFRO,1,46,0,0
19789,2020-05-05T00:00:00Z,SS,South Sudan,AFRO,3,49,0,0
19790,2020-05-06T00:00:00Z,SS,South Sudan,AFRO,0,49,0,0
19791,2020-05-07T00:00:00Z,SS,South Sudan,AFRO,9,58,0,0
19792,2020-05-08T00:00:00Z,SS,South Sudan,AFRO,32,90,0,0
19793,2020-05-09T00:00:00Z,SS,South Sudan,AFRO,30,120,0,0
19794,2020-05-10T00:00:00Z,SS,South Sudan,AFRO,0,120,0,0
19795,2020-05-11T00:00:00Z,SS,South Sudan,AFRO,36,156,0,0
19796,2020-05-12T00:00:00Z,SS,South Sudan,AFRO,18,174,0,0
19797,2020-05-13T00:00:00Z,SS,South Sudan,AFRO,0,174,0,0
19798,2020-05-14T00:00:00Z,SS,South Sudan,AFRO,20,194,0,0
19799,2020-05-15T00:00:00Z,SS,South Sudan,AFRO,37,231,1,1
19800,2020-05-16T00:00:00Z,SS,South Sudan,AFRO,0,231,0,1
19801,2020-05-17T00:00:00Z,SS,South Sudan,AFRO,0,231,0,1
19802,2020-05-18T00:00:00Z,SS,South Sudan,AFRO,51,282,3,4
19803,2020-05-19T00:00:00Z,SS,South Sudan,AFRO,0,282,0,4
19804,2020-05-20T00:00:00Z,SS,South Sudan,AFRO,0,282,0,4
19805,2020-05-21T00:00:00Z,SS,South Sudan,AFRO,57,339,2,6
19806,2020-05-22T00:00:00Z,SS,South Sudan,AFRO,134,473,0,6
19807,2020-05-23T00:00:00Z,SS,South Sudan,AFRO,0,473,-1,5
19808,2020-05-24T00:00:00Z,SS,South Sudan,AFRO,90,563,1,6
19809,2020-05-25T00:00:00Z,SS,South Sudan,AFRO,92,655,2,8
19810,2020-05-26T00:00:00Z,SS,South Sudan,AFRO,0,655,0,8
19811,2020-05-27T00:00:00Z,SS,South Sudan,AFRO,151,806,0,8
19812,2020-05-28T00:00:00Z,SS,South Sudan,AFRO,0,806,0,8
19813,2020-05-29T00:00:00Z,SS,South Sudan,AFRO,188,994,2,10
19814,2020-05-30T00:00:00Z,SS,South Sudan,AFRO,0,994,0,10
19815,2020-05-31T00:00:00Z,SS,South Sudan,AFRO,0,994,0,10
19816,2020-06-01T00:00:00Z,SS,South Sudan,AFRO,0,994,0,10
19817,2020-06-02T00:00:00Z,SS,South Sudan,AFRO,0,994,0,10
19818,2020-06-03T00:00:00Z,SS,South Sudan,AFRO,0,994,0,10
19819,2020-06-04T00:00:00Z,SS,South Sudan,AFRO,323,1317,4,14
19820,2020-06-05T00:00:00Z,SS,South Sudan,AFRO,0,1317,0,14
19821,2020-06-06T00:00:00Z,SS,South Sudan,AFRO,0,1317,0,14
19822,2020-06-07T00:00:00Z,SS,South Sudan,AFRO,0,1317,0,14
19823,2020-06-08T00:00:00Z,SS,South Sudan,AFRO,0,1317,0,14
19824,2020-06-09T00:00:00Z,SS,South Sudan,AFRO,287,1604,5,19
19825,2020-06-10T00:00:00Z,SS,South Sudan,AFRO,2,1606,1,20
19826,2020-06-11T00:00:00Z,SS,South Sudan,AFRO,0,1606,0,20
19827,2020-06-12T00:00:00Z,SS,South Sudan,AFRO,0,1606,2,22
19828,2020-06-13T00:00:00Z,SS,South Sudan,AFRO,64,1670,0,22
19829,2020-06-14T00:00:00Z,SS,South Sudan,AFRO,14,1684,3,25
19830,2020-06-15T00:00:00Z,SS,South Sudan,AFRO,9,1693,2,27
19831,2020-06-16T00:00:00Z,SS,South Sudan,AFRO,62,1755,3,30
19832,2020-06-17T00:00:00Z,SS,South Sudan,AFRO,21,1776,0,30
19833,2020-06-18T00:00:00Z,SS,South Sudan,AFRO,31,1807,1,31
19834,2020-06-19T00:00:00Z,SS,South Sudan,AFRO,6,1813,0,31
19835,2020-06-20T00:00:00Z,SS,South Sudan,AFRO,17,1830,1,32
21116,2020-03-07T00:00:00Z,TG,Togo,AFRO,1,1,0,0
21117,2020-03-08T00:00:00Z,TG,Togo,AFRO,0,1,0,0
21118,2020-03-09T00:00:00Z,TG,Togo,AFRO,0,1,0,0
21119,2020-03-10T00:00:00Z,TG,Togo,AFRO,0,1,0,0
21120,2020-03-11T00:00:00Z,TG,Togo,AFRO,0,1,0,0
21121,2020-03-12T00:00:00Z,TG,Togo,AFRO,0,1,0,0
21122,2020-03-13T00:00:00Z,TG,Togo,AFRO,0,1,0,0
21123,2020-03-14T00:00:00Z,TG,Togo,AFRO,0,1,0,0
21124,2020-03-15T00:00:00Z,TG,Togo,AFRO,0,1,0,0
21125,2020-03-16T00:00:00Z,TG,Togo,AFRO,0,1,0,0
21126,2020-03-17T00:00:00Z,TG,Togo,AFRO,0,1,0,0
21127,2020-03-18T00:00:00Z,TG,Togo,AFRO,0,1,0,0
21128,2020-03-19T00:00:00Z,TG,Togo,AFRO,8,9,0,0
21129,2020-03-20T00:00:00Z,TG,Togo,AFRO,0,9,0,0
21130,2020-03-21T00:00:00Z,TG,Togo,AFRO,6,15,0,0
21131,2020-03-22T00:00:00Z,TG,Togo,AFRO,0,15,0,0
21132,2020-03-23T00:00:00Z,TG,Togo,AFRO,1,16,0,0
21133,2020-03-24T00:00:00Z,TG,Togo,AFRO,2,18,0,0
21134,2020-03-25T00:00:00Z,TG,Togo,AFRO,2,20,0,0
21135,2020-03-26T00:00:00Z,TG,Togo,AFRO,3,23,0,0
21136,2020-03-27T00:00:00Z,TG,Togo,AFRO,1,24,0,0
21137,2020-03-28T00:00:00Z,TG,Togo,AFRO,1,25,0,0
21138,2020-03-29T00:00:00Z,TG,Togo,AFRO,3,28,1,1
21139,2020-03-30T00:00:00Z,TG,Togo,AFRO,0,28,0,1
21140,2020-03-31T00:00:00Z,TG,Togo,AFRO,6,34,0,1
21141,2020-04-01T00:00:00Z,TG,Togo,AFRO,0,34,0,1
21142,2020-04-02T00:00:00Z,TG,Togo,AFRO,2,36,1,2
21143,2020-04-03T00:00:00Z,TG,Togo,AFRO,3,39,0,2
21144,2020-04-04T00:00:00Z,TG,Togo,AFRO,0,39,0,2
21145,2020-04-05T00:00:00Z,TG,Togo,AFRO,1,40,1,3
21146,2020-04-06T00:00:00Z,TG,Togo,AFRO,4,44,0,3
21147,2020-04-07T00:00:00Z,TG,Togo,AFRO,0,44,0,3
21148,2020-04-08T00:00:00Z,TG,Togo,AFRO,14,58,0,3
21149,2020-04-09T00:00:00Z,TG,Togo,AFRO,12,70,0,3
21150,2020-04-10T00:00:00Z,TG,Togo,AFRO,3,73,0,3
21151,2020-04-11T00:00:00Z,TG,Togo,AFRO,0,73,0,3
21152,2020-04-12T00:00:00Z,TG,Togo,AFRO,0,73,0,3
21153,2020-04-13T00:00:00Z,TG,Togo,AFRO,3,76,0,3
21154,2020-04-14T00:00:00Z,TG,Togo,AFRO,0,76,0,3
21155,2020-04-15T00:00:00Z,TG,Togo,AFRO,1,77,0,3
21156,2020-04-16T00:00:00Z,TG,Togo,AFRO,0,77,0,3
21157,2020-04-17T00:00:00Z,TG,Togo,AFRO,4,81,2,5
21158,2020-04-18T00:00:00Z,TG,Togo,AFRO,2,83,0,5
21159,2020-04-19T00:00:00Z,TG,Togo,AFRO,0,83,0,5
21160,2020-04-20T00:00:00Z,TG,Togo,AFRO,0,83,0,5
21161,2020-04-21T00:00:00Z,TG,Togo,AFRO,1,84,0,5
21162,2020-04-22T00:00:00Z,TG,Togo,AFRO,2,86,1,6
21163,2020-04-23T00:00:00Z,TG,Togo,AFRO,2,88,0,6
21164,2020-04-24T00:00:00Z,TG,Togo,AFRO,0,88,0,6
21165,2020-04-25T00:00:00Z,TG,Togo,AFRO,2,90,0,6
21166,2020-04-26T00:00:00Z,TG,Togo,AFRO,6,96,0,6
21167,2020-04-27T00:00:00Z,TG,Togo,AFRO,2,98,0,6
21168,2020-04-28T00:00:00Z,TG,Togo,AFRO,1,99,0,6
21169,2020-04-29T00:00:00Z,TG,Togo,AFRO,0,99,0,6
21170,2020-04-30T00:00:00Z,TG,Togo,AFRO,10,109,1,7
21171,2020-05-01T00:00:00Z,TG,Togo,AFRO,7,116,2,9
21172,2020-05-02T00:00:00Z,TG,Togo,AFRO,7,123,0,9
21173,2020-05-03T00:00:00Z,TG,Togo,AFRO,0,123,0,9
21174,2020-05-04T00:00:00Z,TG,Togo,AFRO,1,124,0,9
21175,2020-05-05T00:00:00Z,TG,Togo,AFRO,2,126,0,9
21176,2020-05-06T00:00:00Z,TG,Togo,AFRO,2,128,0,9
21177,2020-05-07T00:00:00Z,TG,Togo,AFRO,0,128,0,9
21178,2020-05-08T00:00:00Z,TG,Togo,AFRO,7,135,0,9
21179,2020-05-09T00:00:00Z,TG,Togo,AFRO,10,145,1,10
21180,2020-05-10T00:00:00Z,TG,Togo,AFRO,8,153,0,10
21181,2020-05-11T00:00:00Z,TG,Togo,AFRO,20,173,1,11
21182,2020-05-12T00:00:00Z,TG,Togo,AFRO,8,181,0,11
21183,2020-05-13T00:00:00Z,TG,Togo,AFRO,18,199,0,11
21184,2020-05-14T00:00:00Z,TG,Togo,AFRO,20,219,0,11
21185,2020-05-15T00:00:00Z,TG,Togo,AFRO,19,238,0,11
21186,2020-05-16T00:00:00Z,TG,Togo,AFRO,25,263,0,11
21187,2020-05-17T00:00:00Z,TG,Togo,AFRO,35,298,0,11
21188,2020-05-18T00:00:00Z,TG,Togo,AFRO,3,301,0,11
21189,2020-05-19T00:00:00Z,TG,Togo,AFRO,29,330,1,12
21190,2020-05-20T00:00:00Z,TG,Togo,AFRO,8,338,0,12
21191,2020-05-21T00:00:00Z,TG,Togo,AFRO,0,338,0,12
21192,2020-05-22T00:00:00Z,TG,Togo,AFRO,16,354,0,12
21193,2020-05-23T00:00:00Z,TG,Togo,AFRO,9,363,0,12
21194,2020-05-24T00:00:00Z,TG,Togo,AFRO,10,373,0,12
21195,2020-05-25T00:00:00Z,TG,Togo,AFRO,8,381,0,12
21196,2020-05-26T00:00:00Z,TG,Togo,AFRO,5,386,1,13
21197,2020-05-27T00:00:00Z,TG,Togo,AFRO,5,391,0,13
21198,2020-05-28T00:00:00Z,TG,Togo,AFRO,4,395,0,13
21199,2020-05-29T00:00:00Z,TG,Togo,AFRO,27,422,0,13
21200,2020-05-30T00:00:00Z,TG,Togo,AFRO,6,428,0,13
21201,2020-05-31T00:00:00Z,TG,Togo,AFRO,0,428,0,13
21202,2020-06-01T00:00:00Z,TG,Togo,AFRO,14,442,0,13
21203,2020-06-02T00:00:00Z,TG,Togo,AFRO,1,443,0,13
21204,2020-06-03T00:00:00Z,TG,Togo,AFRO,2,445,0,13
21205,2020-06-04T00:00:00Z,TG,Togo,AFRO,7,452,0,13
21206,2020-06-05T00:00:00Z,TG,Togo,AFRO,13,465,0,13
21207,2020-06-06T00:00:00Z,TG,Togo,AFRO,20,485,0,13
21208,2020-06-07T00:00:00Z,TG,Togo,AFRO,2,487,0,13
21209,2020-06-08T00:00:00Z,TG,Togo,AFRO,8,495,0,13
21210,2020-06-09T00:00:00Z,TG,Togo,AFRO,2,497,0,13
21211,2020-06-10T00:00:00Z,TG,Togo,AFRO,0,497,0,13
21212,2020-06-11T00:00:00Z,TG,Togo,AFRO,25,522,0,13
21213,2020-06-12T00:00:00Z,TG,Togo,AFRO,0,522,0,13
21214,2020-06-13T00:00:00Z,TG,Togo,AFRO,2,524,0,13
21215,2020-06-14T00:00:00Z,TG,Togo,AFRO,1,525,0,13
21216,2020-06-15T00:00:00Z,TG,Togo,AFRO,5,530,0,13
21217,2020-06-16T00:00:00Z,TG,Togo,AFRO,1,531,0,13
21218,2020-06-17T00:00:00Z,TG,Togo,AFRO,6,537,0,13
21219,2020-06-18T00:00:00Z,TG,Togo,AFRO,0,537,0,13
21220,2020-06-19T00:00:00Z,TG,Togo,AFRO,7,544,0,13
21221,2020-06-20T00:00:00Z,TG,Togo,AFRO,11,555,0,13
21624,2020-03-21T00:00:00Z,UG,Uganda,AFRO,1,1,0,0
21625,2020-03-22T00:00:00Z,UG,Uganda,AFRO,0,1,0,0
21626,2020-03-23T00:00:00Z,UG,Uganda,AFRO,0,1,0,0
21627,2020-03-24T00:00:00Z,UG,Uganda,AFRO,8,9,0,0
21628,2020-03-25T00:00:00Z,UG,Uganda,AFRO,0,9,0,0
21629,2020-03-26T00:00:00Z,UG,Uganda,AFRO,5,14,0,0
21630,2020-03-27T00:00:00Z,UG,Uganda,AFRO,0,14,0,0
21631,2020-03-28T00:00:00Z,UG,Uganda,AFRO,0,14,0,0
21632,2020-03-29T00:00:00Z,UG,Uganda,AFRO,16,30,0,0
21633,2020-03-30T00:00:00Z,UG,Uganda,AFRO,3,33,0,0
21634,2020-03-31T00:00:00Z,UG,Uganda,AFRO,0,33,0,0
21635,2020-04-01T00:00:00Z,UG,Uganda,AFRO,0,33,0,0
21636,2020-04-02T00:00:00Z,UG,Uganda,AFRO,11,44,0,0
21637,2020-04-03T00:00:00Z,UG,Uganda,AFRO,1,45,0,0
21638,2020-04-04T00:00:00Z,UG,Uganda,AFRO,3,48,0,0
21639,2020-04-05T00:00:00Z,UG,Uganda,AFRO,0,48,0,0
21640,2020-04-06T00:00:00Z,UG,Uganda,AFRO,0,48,0,0
21641,2020-04-07T00:00:00Z,UG,Uganda,AFRO,4,52,0,0
21642,2020-04-08T00:00:00Z,UG,Uganda,AFRO,0,52,0,0
21643,2020-04-09T00:00:00Z,UG,Uganda,AFRO,1,53,0,0
21644,2020-04-10T00:00:00Z,UG,Uganda,AFRO,0,53,0,0
21645,2020-04-11T00:00:00Z,UG,Uganda,AFRO,0,53,0,0
21646,2020-04-12T00:00:00Z,UG,Uganda,AFRO,0,53,0,0
21647,2020-04-13T00:00:00Z,UG,Uganda,AFRO,1,54,0,0
21648,2020-04-14T00:00:00Z,UG,Uganda,AFRO,0,54,0,0
21649,2020-04-15T00:00:00Z,UG,Uganda,AFRO,0,54,0,0
21650,2020-04-16T00:00:00Z,UG,Uganda,AFRO,1,55,0,0
21651,2020-04-17T00:00:00Z,UG,Uganda,AFRO,0,55,0,0
21652,2020-04-18T00:00:00Z,UG,Uganda,AFRO,0,55,0,0
21653,2020-04-19T00:00:00Z,UG,Uganda,AFRO,0,55,0,0
21654,2020-04-20T00:00:00Z,UG,Uganda,AFRO,0,55,0,0
21655,2020-04-21T00:00:00Z,UG,Uganda,AFRO,0,55,0,0
21656,2020-04-22T00:00:00Z,UG,Uganda,AFRO,1,56,0,0
21657,2020-04-23T00:00:00Z,UG,Uganda,AFRO,5,61,0,0
21658,2020-04-24T00:00:00Z,UG,Uganda,AFRO,2,63,0,0
21659,2020-04-25T00:00:00Z,UG,Uganda,AFRO,12,75,0,0
21660,2020-04-26T00:00:00Z,UG,Uganda,AFRO,0,75,0,0
21661,2020-04-27T00:00:00Z,UG,Uganda,AFRO,0,75,0,0
21662,2020-04-28T00:00:00Z,UG,Uganda,AFRO,4,79,0,0
21663,2020-04-29T00:00:00Z,UG,Uganda,AFRO,0,79,0,0
21664,2020-04-30T00:00:00Z,UG,Uganda,AFRO,0,79,0,0
21665,2020-05-01T00:00:00Z,UG,Uganda,AFRO,2,81,0,0
21666,2020-05-02T00:00:00Z,UG,Uganda,AFRO,2,83,0,0
21667,2020-05-03T00:00:00Z,UG,Uganda,AFRO,2,85,0,0
21668,2020-05-04T00:00:00Z,UG,Uganda,AFRO,3,88,0,0
21669,2020-05-05T00:00:00Z,UG,Uganda,AFRO,1,89,0,0
21670,2020-05-06T00:00:00Z,UG,Uganda,AFRO,8,97,0,0
21671,2020-05-07T00:00:00Z,UG,Uganda,AFRO,1,98,0,0
21672,2020-05-08T00:00:00Z,UG,Uganda,AFRO,3,101,0,0
21673,2020-05-09T00:00:00Z,UG,Uganda,AFRO,0,101,0,0
21674,2020-05-10T00:00:00Z,UG,Uganda,AFRO,15,116,0,0
21675,2020-05-11T00:00:00Z,UG,Uganda,AFRO,5,121,0,0
21676,2020-05-12T00:00:00Z,UG,Uganda,AFRO,1,122,0,0
21677,2020-05-13T00:00:00Z,UG,Uganda,AFRO,4,126,0,0
21678,2020-05-14T00:00:00Z,UG,Uganda,AFRO,13,139,0,0
21679,2020-05-15T00:00:00Z,UG,Uganda,AFRO,21,160,0,0
21680,2020-05-16T00:00:00Z,UG,Uganda,AFRO,43,203,0,0
21681,2020-05-17T00:00:00Z,UG,Uganda,AFRO,24,227,0,0
21682,2020-05-18T00:00:00Z,UG,Uganda,AFRO,0,227,0,0
21683,2020-05-19T00:00:00Z,UG,Uganda,AFRO,33,260,0,0
21684,2020-05-20T00:00:00Z,UG,Uganda,AFRO,0,260,0,0
21685,2020-05-21T00:00:00Z,UG,Uganda,AFRO,4,264,0,0
21686,2020-05-22T00:00:00Z,UG,Uganda,AFRO,0,264,0,0
21687,2020-05-23T00:00:00Z,UG,Uganda,AFRO,10,274,0,0
21688,2020-05-24T00:00:00Z,UG,Uganda,AFRO,38,312,0,0
21689,2020-05-25T00:00:00Z,UG,Uganda,AFRO,-8,304,0,0
21690,2020-05-26T00:00:00Z,UG,Uganda,AFRO,0,304,0,0
21691,2020-05-27T00:00:00Z,UG,Uganda,AFRO,37,341,0,0
21692,2020-05-28T00:00:00Z,UG,Uganda,AFRO,10,351,0,0
21693,2020-05-29T00:00:00Z,UG,Uganda,AFRO,59,410,0,0
21694,2020-05-30T00:00:00Z,UG,Uganda,AFRO,0,410,0,0
21695,2020-05-31T00:00:00Z,UG,Uganda,AFRO,36,446,0,0
21696,2020-06-01T00:00:00Z,UG,Uganda,AFRO,12,458,0,0
21697,2020-06-02T00:00:00Z,UG,Uganda,AFRO,0,458,0,0
21698,2020-06-03T00:00:00Z,UG,Uganda,AFRO,128,586,0,0
21699,2020-06-04T00:00:00Z,UG,Uganda,AFRO,50,636,0,0
21700,2020-06-05T00:00:00Z,UG,Uganda,AFRO,15,651,0,0
21701,2020-06-06T00:00:00Z,UG,Uganda,AFRO,35,686,0,0
21702,2020-06-07T00:00:00Z,UG,Uganda,AFRO,36,722,0,0
21703,2020-06-08T00:00:00Z,UG,Uganda,AFRO,23,745,0,0
21704,2020-06-09T00:00:00Z,UG,Uganda,AFRO,30,775,0,0
21705,2020-06-10T00:00:00Z,UG,Uganda,AFRO,0,775,0,0
21706,2020-06-11T00:00:00Z,UG,Uganda,AFRO,19,794,0,0
21707,2020-06-12T00:00:00Z,UG,Uganda,AFRO,14,808,0,0
21708,2020-06-13T00:00:00Z,UG,Uganda,AFRO,0,808,0,0
21709,2020-06-14T00:00:00Z,UG,Uganda,AFRO,15,823,0,0
21710,2020-06-15T00:00:00Z,UG,Uganda,AFRO,0,823,0,0
21711,2020-06-16T00:00:00Z,UG,Uganda,AFRO,0,823,0,0
21712,2020-06-17T00:00:00Z,UG,Uganda,AFRO,0,823,0,0
21713,2020-06-18T00:00:00Z,UG,Uganda,AFRO,0,823,0,0
21714,2020-06-19T00:00:00Z,UG,Uganda,AFRO,0,823,0,0
21715,2020-06-20T00:00:00Z,UG,Uganda,AFRO,0,823,0,0
21970,2020-03-17T00:00:00Z,TZ,United Republic of Tanzania,AFRO,1,1,0,0
21971,2020-03-18T00:00:00Z,TZ,United Republic of Tanzania,AFRO,2,3,0,0
21972,2020-03-19T00:00:00Z,TZ,United Republic of Tanzania,AFRO,3,6,0,0
21973,2020-03-20T00:00:00Z,TZ,United Republic of Tanzania,AFRO,0,6,0,0
21974,2020-03-21T00:00:00Z,TZ,United Republic of Tanzania,AFRO,0,6,0,0
21975,2020-03-22T00:00:00Z,TZ,United Republic of Tanzania,AFRO,0,6,0,0
21976,2020-03-23T00:00:00Z,TZ,United Republic of Tanzania,AFRO,6,12,0,0
21977,2020-03-24T00:00:00Z,TZ,United Republic of Tanzania,AFRO,0,12,0,0
21978,2020-03-25T00:00:00Z,TZ,United Republic of Tanzania,AFRO,0,12,0,0
21979,2020-03-26T00:00:00Z,TZ,United Republic of Tanzania,AFRO,1,13,0,0
21980,2020-03-27T00:00:00Z,TZ,United Republic of Tanzania,AFRO,0,13,0,0
21981,2020-03-28T00:00:00Z,TZ,United Republic of Tanzania,AFRO,0,13,0,0
21982,2020-03-29T00:00:00Z,TZ,United Republic of Tanzania,AFRO,1,14,0,0
21983,2020-03-30T00:00:00Z,TZ,United Republic of Tanzania,AFRO,5,19,0,0
21984,2020-03-31T00:00:00Z,TZ,United Republic of Tanzania,AFRO,0,19,0,0
21985,2020-04-01T00:00:00Z,TZ,United Republic of Tanzania,AFRO,1,20,1,1
21986,2020-04-02T00:00:00Z,TZ,United Republic of Tanzania,AFRO,0,20,0,1
21987,2020-04-03T00:00:00Z,TZ,United Republic of Tanzania,AFRO,0,20,0,1
21988,2020-04-04T00:00:00Z,TZ,United Republic of Tanzania,AFRO,0,20,0,1
21989,2020-04-05T00:00:00Z,TZ,United Republic of Tanzania,AFRO,0,20,0,1
21990,2020-04-06T00:00:00Z,TZ,United Republic of Tanzania,AFRO,2,22,0,1
21991,2020-04-07T00:00:00Z,TZ,United Republic of Tanzania,AFRO,2,24,0,1
21992,2020-04-08T00:00:00Z,TZ,United Republic of Tanzania,AFRO,0,24,0,1
21993,2020-04-09T00:00:00Z,TZ,United Republic of Tanzania,AFRO,1,25,0,1
21994,2020-04-10T00:00:00Z,TZ,United Republic of Tanzania,AFRO,0,25,0,1
21995,2020-04-11T00:00:00Z,TZ,United Republic of Tanzania,AFRO,7,32,2,3
21996,2020-04-12T00:00:00Z,TZ,United Republic of Tanzania,AFRO,0,32,0,3
21997,2020-04-13T00:00:00Z,TZ,United Republic of Tanzania,AFRO,0,32,0,3
21998,2020-04-14T00:00:00Z,TZ,United Republic of Tanzania,AFRO,17,49,0,3
21999,2020-04-15T00:00:00Z,TZ,United Republic of Tanzania,AFRO,4,53,0,3
22000,2020-04-16T00:00:00Z,TZ,United Republic of Tanzania,AFRO,35,88,1,4
22001,2020-04-17T00:00:00Z,TZ,United Republic of Tanzania,AFRO,6,94,0,4
22002,2020-04-18T00:00:00Z,TZ,United Republic of Tanzania,AFRO,54,148,1,5
22003,2020-04-19T00:00:00Z,TZ,United Republic of Tanzania,AFRO,0,148,0,5
22004,2020-04-20T00:00:00Z,TZ,United Republic of Tanzania,AFRO,23,171,2,7
22005,2020-04-21T00:00:00Z,TZ,United Republic of Tanzania,AFRO,84,255,3,10
22006,2020-04-22T00:00:00Z,TZ,United Republic of Tanzania,AFRO,0,255,0,10
22007,2020-04-23T00:00:00Z,TZ,United Republic of Tanzania,AFRO,30,285,0,10
22008,2020-04-24T00:00:00Z,TZ,United Republic of Tanzania,AFRO,0,285,0,10
22009,2020-04-25T00:00:00Z,TZ,United Republic of Tanzania,AFRO,15,300,0,10
22010,2020-04-26T00:00:00Z,TZ,United Republic of Tanzania,AFRO,0,300,0,10
22011,2020-04-27T00:00:00Z,TZ,United Republic of Tanzania,AFRO,0,300,0,10
22012,2020-04-28T00:00:00Z,TZ,United Republic of Tanzania,AFRO,0,300,0,10
22013,2020-04-29T00:00:00Z,TZ,United Republic of Tanzania,AFRO,0,300,0,10
22014,2020-04-30T00:00:00Z,TZ,United Republic of Tanzania,AFRO,180,480,6,16
22015,2020-05-01T00:00:00Z,TZ,United Republic of Tanzania,AFRO,0,480,1,17
22016,2020-05-02T00:00:00Z,TZ,United Republic of Tanzania,AFRO,0,480,0,17
22017,2020-05-03T00:00:00Z,TZ,United Republic of Tanzania,AFRO,0,480,1,18
22018,2020-05-04T00:00:00Z,TZ,United Republic of Tanzania,AFRO,0,480,0,18
22019,2020-05-05T00:00:00Z,TZ,United Republic of Tanzania,AFRO,0,480,0,18
22020,2020-05-06T00:00:00Z,TZ,United Republic of Tanzania,AFRO,0,480,0,18
22021,2020-05-07T00:00:00Z,TZ,United Republic of Tanzania,AFRO,0,480,0,18
22022,2020-05-08T00:00:00Z,TZ,United Republic of Tanzania,AFRO,29,509,3,21
22023,2020-05-09T00:00:00Z,TZ,United Republic of Tanzania,AFRO,0,509,0,21
22024,2020-05-10T00:00:00Z,TZ,United Republic of Tanzania,AFRO,0,509,0,21
22025,2020-05-11T00:00:00Z,TZ,United Republic of Tanzania,AFRO,0,509,0,21
22026,2020-05-12T00:00:00Z,TZ,United Republic of Tanzania,AFRO,0,509,0,21
22027,2020-05-13T00:00:00Z,TZ,United Republic of Tanzania,AFRO,0,509,0,21
22028,2020-05-14T00:00:00Z,TZ,United Republic of Tanzania,AFRO,0,509,0,21
22029,2020-05-15T00:00:00Z,TZ,United Republic of Tanzania,AFRO,0,509,0,21
22030,2020-05-16T00:00:00Z,TZ,United Republic of Tanzania,AFRO,0,509,0,21
22031,2020-05-17T00:00:00Z,TZ,United Republic of Tanzania,AFRO,0,509,0,21
22032,2020-05-18T00:00:00Z,TZ,United Republic of Tanzania,AFRO,0,509,0,21
22033,2020-05-19T00:00:00Z,TZ,United Republic of Tanzania,AFRO,0,509,0,21
22034,2020-05-20T00:00:00Z,TZ,United Republic of Tanzania,AFRO,0,509,0,21
22035,2020-05-21T00:00:00Z,TZ,United Republic of Tanzania,AFRO,0,509,0,21
22036,2020-05-22T00:00:00Z,TZ,United Republic of Tanzania,AFRO,0,509,0,21
22037,2020-05-23T00:00:00Z,TZ,United Republic of Tanzania,AFRO,0,509,0,21
22038,2020-05-24T00:00:00Z,TZ,United Republic of Tanzania,AFRO,0,509,0,21
22039,2020-05-25T00:00:00Z,TZ,United Republic of Tanzania,AFRO,0,509,0,21
22040,2020-05-26T00:00:00Z,TZ,United Republic of Tanzania,AFRO,0,509,0,21
22041,2020-05-27T00:00:00Z,TZ,United Republic of Tanzania,AFRO,0,509,0,21
22042,2020-05-28T00:00:00Z,TZ,United Republic of Tanzania,AFRO,0,509,0,21
22043,2020-05-29T00:00:00Z,TZ,United Republic of Tanzania,AFRO,0,509,0,21
22044,2020-05-30T00:00:00Z,TZ,United Republic of Tanzania,AFRO,0,509,0,21
22045,2020-05-31T00:00:00Z,TZ,United Republic of Tanzania,AFRO,0,509,0,21
22046,2020-06-01T00:00:00Z,TZ,United Republic of Tanzania,AFRO,0,509,0,21
22047,2020-06-02T00:00:00Z,TZ,United Republic of Tanzania,AFRO,0,509,0,21
22048,2020-06-03T00:00:00Z,TZ,United Republic of Tanzania,AFRO,0,509,0,21
22049,2020-06-04T00:00:00Z,TZ,United Republic of Tanzania,AFRO,0,509,0,21
22050,2020-06-05T00:00:00Z,TZ,United Republic of Tanzania,AFRO,0,509,0,21
22051,2020-06-06T00:00:00Z,TZ,United Republic of Tanzania,AFRO,0,509,0,21
22052,2020-06-07T00:00:00Z,TZ,United Republic of Tanzania,AFRO,0,509,0,21
22053,2020-06-08T00:00:00Z,TZ,United Republic of Tanzania,AFRO,0,509,0,21
22054,2020-06-09T00:00:00Z,TZ,United Republic of Tanzania,AFRO,0,509,0,21
22055,2020-06-10T00:00:00Z,TZ,United Republic of Tanzania,AFRO,0,509,0,21
22056,2020-06-11T00:00:00Z,TZ,United Republic of Tanzania,AFRO,0,509,0,21
22057,2020-06-12T00:00:00Z,TZ,United Republic of Tanzania,AFRO,0,509,0,21
22058,2020-06-13T00:00:00Z,TZ,United Republic of Tanzania,AFRO,0,509,0,21
22059,2020-06-14T00:00:00Z,TZ,United Republic of Tanzania,AFRO,0,509,0,21
22060,2020-06-15T00:00:00Z,TZ,United Republic of Tanzania,AFRO,0,509,0,21
22061,2020-06-16T00:00:00Z,TZ,United Republic of Tanzania,AFRO,0,509,0,21
22062,2020-06-17T00:00:00Z,TZ,United Republic of Tanzania,AFRO,0,509,0,21
22063,2020-06-18T00:00:00Z,TZ,United Republic of Tanzania,AFRO,0,509,0,21
22064,2020-06-19T00:00:00Z,TZ,United Republic of Tanzania,AFRO,0,509,0,21
22065,2020-06-20T00:00:00Z,TZ,United Republic of Tanzania,AFRO,0,509,0,21
22834,2020-03-18T00:00:00Z,ZM,Zambia,AFRO,2,2,0,0
22835,2020-03-19T00:00:00Z,ZM,Zambia,AFRO,0,2,0,0
22836,2020-03-20T00:00:00Z,ZM,Zambia,AFRO,0,2,0,0
22837,2020-03-21T00:00:00Z,ZM,Zambia,AFRO,0,2,0,0
22838,2020-03-22T00:00:00Z,ZM,Zambia,AFRO,0,2,0,0
22839,2020-03-23T00:00:00Z,ZM,Zambia,AFRO,1,3,0,0
22840,2020-03-24T00:00:00Z,ZM,Zambia,AFRO,0,3,0,0
22841,2020-03-25T00:00:00Z,ZM,Zambia,AFRO,0,3,0,0
22842,2020-03-26T00:00:00Z,ZM,Zambia,AFRO,0,3,0,0
22843,2020-03-27T00:00:00Z,ZM,Zambia,AFRO,10,13,0,0
22844,2020-03-28T00:00:00Z,ZM,Zambia,AFRO,0,13,0,0
22845,2020-03-29T00:00:00Z,ZM,Zambia,AFRO,3,16,0,0
22846,2020-03-30T00:00:00Z,ZM,Zambia,AFRO,19,35,0,0
22847,2020-03-31T00:00:00Z,ZM,Zambia,AFRO,0,35,0,0
22848,2020-04-01T00:00:00Z,ZM,Zambia,AFRO,0,35,0,0
22849,2020-04-02T00:00:00Z,ZM,Zambia,AFRO,1,36,0,0
22850,2020-04-03T00:00:00Z,ZM,Zambia,AFRO,3,39,1,1
22851,2020-04-04T00:00:00Z,ZM,Zambia,AFRO,0,39,0,1
22852,2020-04-05T00:00:00Z,ZM,Zambia,AFRO,0,39,0,1
22853,2020-04-06T00:00:00Z,ZM,Zambia,AFRO,0,39,0,1
22854,2020-04-07T00:00:00Z,ZM,Zambia,AFRO,0,39,0,1
22855,2020-04-08T00:00:00Z,ZM,Zambia,AFRO,0,39,0,1
22856,2020-04-09T00:00:00Z,ZM,Zambia,AFRO,0,39,0,1
22857,2020-04-10T00:00:00Z,ZM,Zambia,AFRO,0,39,0,1
22858,2020-04-11T00:00:00Z,ZM,Zambia,AFRO,1,40,1,2
22859,2020-04-12T00:00:00Z,ZM,Zambia,AFRO,0,40,0,2
22860,2020-04-13T00:00:00Z,ZM,Zambia,AFRO,3,43,0,2
22861,2020-04-14T00:00:00Z,ZM,Zambia,AFRO,2,45,0,2
22862,2020-04-15T00:00:00Z,ZM,Zambia,AFRO,0,45,0,2
22863,2020-04-16T00:00:00Z,ZM,Zambia,AFRO,3,48,0,2
22864,2020-04-17T00:00:00Z,ZM,Zambia,AFRO,0,48,0,2
22865,2020-04-18T00:00:00Z,ZM,Zambia,AFRO,4,52,0,2
22866,2020-04-19T00:00:00Z,ZM,Zambia,AFRO,5,57,0,2
22867,2020-04-20T00:00:00Z,ZM,Zambia,AFRO,4,61,1,3
22868,2020-04-21T00:00:00Z,ZM,Zambia,AFRO,4,65,0,3
22869,2020-04-22T00:00:00Z,ZM,Zambia,AFRO,5,70,0,3
22870,2020-04-23T00:00:00Z,ZM,Zambia,AFRO,4,74,0,3
22871,2020-04-24T00:00:00Z,ZM,Zambia,AFRO,2,76,0,3
22872,2020-04-25T00:00:00Z,ZM,Zambia,AFRO,8,84,0,3
22873,2020-04-26T00:00:00Z,ZM,Zambia,AFRO,0,84,0,3
22874,2020-04-27T00:00:00Z,ZM,Zambia,AFRO,4,88,0,3
22875,2020-04-28T00:00:00Z,ZM,Zambia,AFRO,1,89,0,3
22876,2020-04-29T00:00:00Z,ZM,Zambia,AFRO,6,95,0,3
22877,2020-04-30T00:00:00Z,ZM,Zambia,AFRO,2,97,0,3
22878,2020-05-01T00:00:00Z,ZM,Zambia,AFRO,9,106,0,3
22879,2020-05-02T00:00:00Z,ZM,Zambia,AFRO,3,109,0,3
22880,2020-05-03T00:00:00Z,ZM,Zambia,AFRO,10,119,0,3
22881,2020-05-04T00:00:00Z,ZM,Zambia,AFRO,5,124,0,3
22882,2020-05-05T00:00:00Z,ZM,Zambia,AFRO,13,137,0,3
22883,2020-05-06T00:00:00Z,ZM,Zambia,AFRO,0,137,1,4
22884,2020-05-07T00:00:00Z,ZM,Zambia,AFRO,2,139,0,4
22885,2020-05-08T00:00:00Z,ZM,Zambia,AFRO,14,153,0,4
22886,2020-05-09T00:00:00Z,ZM,Zambia,AFRO,14,167,0,4
22887,2020-05-10T00:00:00Z,ZM,Zambia,AFRO,85,252,0,4
22888,2020-05-11T00:00:00Z,ZM,Zambia,AFRO,15,267,3,7
22889,2020-05-12T00:00:00Z,ZM,Zambia,AFRO,0,267,0,7
22890,2020-05-13T00:00:00Z,ZM,Zambia,AFRO,174,441,0,7
22891,2020-05-14T00:00:00Z,ZM,Zambia,AFRO,5,446,0,7
22892,2020-05-15T00:00:00Z,ZM,Zambia,AFRO,208,654,0,7
22893,2020-05-16T00:00:00Z,ZM,Zambia,AFRO,14,668,0,7
22894,2020-05-17T00:00:00Z,ZM,Zambia,AFRO,11,679,0,7
22895,2020-05-18T00:00:00Z,ZM,Zambia,AFRO,74,753,0,7
22896,2020-05-19T00:00:00Z,ZM,Zambia,AFRO,8,761,0,7
22897,2020-05-20T00:00:00Z,ZM,Zambia,AFRO,11,772,0,7
22898,2020-05-21T00:00:00Z,ZM,Zambia,AFRO,60,832,0,7
22899,2020-05-22T00:00:00Z,ZM,Zambia,AFRO,34,866,0,7
22900,2020-05-23T00:00:00Z,ZM,Zambia,AFRO,54,920,0,7
22901,2020-05-24T00:00:00Z,ZM,Zambia,AFRO,0,920,0,7
22902,2020-05-25T00:00:00Z,ZM,Zambia,AFRO,0,920,0,7
22903,2020-05-26T00:00:00Z,ZM,Zambia,AFRO,0,920,0,7
22904,2020-05-27T00:00:00Z,ZM,Zambia,AFRO,0,920,0,7
22905,2020-05-28T00:00:00Z,ZM,Zambia,AFRO,137,1057,0,7
22906,2020-05-29T00:00:00Z,ZM,Zambia,AFRO,0,1057,0,7
22907,2020-05-30T00:00:00Z,ZM,Zambia,AFRO,0,1057,0,7
22908,2020-05-31T00:00:00Z,ZM,Zambia,AFRO,0,1057,0,7
22909,2020-06-01T00:00:00Z,ZM,Zambia,AFRO,0,1057,0,7
22910,2020-06-02T00:00:00Z,ZM,Zambia,AFRO,32,1089,0,7
22911,2020-06-03T00:00:00Z,ZM,Zambia,AFRO,0,1089,0,7
22912,2020-06-04T00:00:00Z,ZM,Zambia,AFRO,0,1089,0,7
22913,2020-06-05T00:00:00Z,ZM,Zambia,AFRO,22,1111,0,7
22914,2020-06-06T00:00:00Z,ZM,Zambia,AFRO,0,1111,0,7
22915,2020-06-07T00:00:00Z,ZM,Zambia,AFRO,43,1154,0,7
22916,2020-06-08T00:00:00Z,ZM,Zambia,AFRO,0,1154,0,7
22917,2020-06-09T00:00:00Z,ZM,Zambia,AFRO,46,1200,3,10
22918,2020-06-10T00:00:00Z,ZM,Zambia,AFRO,0,1200,0,10
22919,2020-06-11T00:00:00Z,ZM,Zambia,AFRO,52,1252,0,10
22920,2020-06-12T00:00:00Z,ZM,Zambia,AFRO,0,1252,0,10
22921,2020-06-13T00:00:00Z,ZM,Zambia,AFRO,69,1321,0,10
22922,2020-06-14T00:00:00Z,ZM,Zambia,AFRO,36,1357,0,10
22923,2020-06-15T00:00:00Z,ZM,Zambia,AFRO,1,1358,1,11
22924,2020-06-16T00:00:00Z,ZM,Zambia,AFRO,24,1382,0,11
22925,2020-06-17T00:00:00Z,ZM,Zambia,AFRO,23,1405,0,11
22926,2020-06-18T00:00:00Z,ZM,Zambia,AFRO,7,1412,0,11
22927,2020-06-19T00:00:00Z,ZM,Zambia,AFRO,4,1416,0,11
22928,2020-06-20T00:00:00Z,ZM,Zambia,AFRO,14,1430,0,11
22929,2020-03-20T00:00:00Z,ZW,Zimbabwe,AFRO,1,1,0,0
22930,2020-03-21T00:00:00Z,ZW,Zimbabwe,AFRO,1,2,0,0
22931,2020-03-22T00:00:00Z,ZW,Zimbabwe,AFRO,0,2,0,0
22932,2020-03-23T00:00:00Z,ZW,Zimbabwe,AFRO,0,2,0,0
22933,2020-03-24T00:00:00Z,ZW,Zimbabwe,AFRO,0,2,1,1
22934,2020-03-25T00:00:00Z,ZW,Zimbabwe,AFRO,0,2,0,1
22935,2020-03-26T00:00:00Z,ZW,Zimbabwe,AFRO,0,2,0,1
22936,2020-03-27T00:00:00Z,ZW,Zimbabwe,AFRO,3,5,0,1
22937,2020-03-28T00:00:00Z,ZW,Zimbabwe,AFRO,0,5,0,1
22938,2020-03-29T00:00:00Z,ZW,Zimbabwe,AFRO,0,5,0,1
22939,2020-03-30T00:00:00Z,ZW,Zimbabwe,AFRO,0,5,0,1
22940,2020-03-31T00:00:00Z,ZW,Zimbabwe,AFRO,3,8,0,1
22941,2020-04-01T00:00:00Z,ZW,Zimbabwe,AFRO,0,8,0,1
22942,2020-04-02T00:00:00Z,ZW,Zimbabwe,AFRO,0,8,0,1
22943,2020-04-03T00:00:00Z,ZW,Zimbabwe,AFRO,1,9,0,1
22944,2020-04-04T00:00:00Z,ZW,Zimbabwe,AFRO,0,9,0,1
22945,2020-04-05T00:00:00Z,ZW,Zimbabwe,AFRO,0,9,0,1
22946,2020-04-06T00:00:00Z,ZW,Zimbabwe,AFRO,0,9,0,1
22947,2020-04-07T00:00:00Z,ZW,Zimbabwe,AFRO,0,9,0,1
22948,2020-04-08T00:00:00Z,ZW,Zimbabwe,AFRO,2,11,1,2
22949,2020-04-09T00:00:00Z,ZW,Zimbabwe,AFRO,0,11,1,3
22950,2020-04-10T00:00:00Z,ZW,Zimbabwe,AFRO,0,11,0,3
22951,2020-04-11T00:00:00Z,ZW,Zimbabwe,AFRO,0,11,0,3
22952,2020-04-12T00:00:00Z,ZW,Zimbabwe,AFRO,2,13,0,3
22953,2020-04-13T00:00:00Z,ZW,Zimbabwe,AFRO,1,14,0,3
22954,2020-04-14T00:00:00Z,ZW,Zimbabwe,AFRO,3,17,0,3
22955,2020-04-15T00:00:00Z,ZW,Zimbabwe,AFRO,1,18,0,3
22956,2020-04-16T00:00:00Z,ZW,Zimbabwe,AFRO,5,23,0,3
22957,2020-04-17T00:00:00Z,ZW,Zimbabwe,AFRO,0,23,0,3
22958,2020-04-18T00:00:00Z,ZW,Zimbabwe,AFRO,1,24,0,3
22959,2020-04-19T00:00:00Z,ZW,Zimbabwe,AFRO,1,25,0,3
22960,2020-04-20T00:00:00Z,ZW,Zimbabwe,AFRO,0,25,0,3
22961,2020-04-21T00:00:00Z,ZW,Zimbabwe,AFRO,0,25,0,3
22962,2020-04-22T00:00:00Z,ZW,Zimbabwe,AFRO,3,28,0,3
22963,2020-04-23T00:00:00Z,ZW,Zimbabwe,AFRO,0,28,1,4
22964,2020-04-24T00:00:00Z,ZW,Zimbabwe,AFRO,0,28,0,4
22965,2020-04-25T00:00:00Z,ZW,Zimbabwe,AFRO,1,29,0,4
22966,2020-04-26T00:00:00Z,ZW,Zimbabwe,AFRO,2,31,0,4
22967,2020-04-27T00:00:00Z,ZW,Zimbabwe,AFRO,0,31,0,4
22968,2020-04-28T00:00:00Z,ZW,Zimbabwe,AFRO,0,31,0,4
22969,2020-04-29T00:00:00Z,ZW,Zimbabwe,AFRO,1,32,0,4
22970,2020-04-30T00:00:00Z,ZW,Zimbabwe,AFRO,0,32,0,4
22971,2020-05-01T00:00:00Z,ZW,Zimbabwe,AFRO,0,32,0,4
22972,2020-05-02T00:00:00Z,ZW,Zimbabwe,AFRO,2,34,0,4
22973,2020-05-03T00:00:00Z,ZW,Zimbabwe,AFRO,0,34,0,4
22974,2020-05-04T00:00:00Z,ZW,Zimbabwe,AFRO,0,34,0,4
22975,2020-05-05T00:00:00Z,ZW,Zimbabwe,AFRO,0,34,0,4
22976,2020-05-06T00:00:00Z,ZW,Zimbabwe,AFRO,0,34,0,4
22977,2020-05-07T00:00:00Z,ZW,Zimbabwe,AFRO,0,34,0,4
22978,2020-05-08T00:00:00Z,ZW,Zimbabwe,AFRO,0,34,0,4
22979,2020-05-09T00:00:00Z,ZW,Zimbabwe,AFRO,0,34,0,4
22980,2020-05-10T00:00:00Z,ZW,Zimbabwe,AFRO,1,35,0,4
22981,2020-05-11T00:00:00Z,ZW,Zimbabwe,AFRO,1,36,0,4
22982,2020-05-12T00:00:00Z,ZW,Zimbabwe,AFRO,0,36,0,4
22983,2020-05-13T00:00:00Z,ZW,Zimbabwe,AFRO,1,37,0,4
22984,2020-05-14T00:00:00Z,ZW,Zimbabwe,AFRO,0,37,0,4
22985,2020-05-15T00:00:00Z,ZW,Zimbabwe,AFRO,0,37,0,4
22986,2020-05-16T00:00:00Z,ZW,Zimbabwe,AFRO,5,42,0,4
22987,2020-05-17T00:00:00Z,ZW,Zimbabwe,AFRO,2,44,0,4
22988,2020-05-18T00:00:00Z,ZW,Zimbabwe,AFRO,0,44,0,4
22989,2020-05-19T00:00:00Z,ZW,Zimbabwe,AFRO,2,46,0,4
22990,2020-05-20T00:00:00Z,ZW,Zimbabwe,AFRO,0,46,0,4
22991,2020-05-21T00:00:00Z,ZW,Zimbabwe,AFRO,2,48,0,4
22992,2020-05-22T00:00:00Z,ZW,Zimbabwe,AFRO,3,51,0,4
22993,2020-05-23T00:00:00Z,ZW,Zimbabwe,AFRO,0,51,0,4
22994,2020-05-24T00:00:00Z,ZW,Zimbabwe,AFRO,5,56,0,4
22995,2020-05-25T00:00:00Z,ZW,Zimbabwe,AFRO,0,56,0,4
22996,2020-05-26T00:00:00Z,ZW,Zimbabwe,AFRO,0,56,0,4
22997,2020-05-27T00:00:00Z,ZW,Zimbabwe,AFRO,0,56,0,4
22998,2020-05-28T00:00:00Z,ZW,Zimbabwe,AFRO,76,132,0,4
22999,2020-05-29T00:00:00Z,ZW,Zimbabwe,AFRO,0,132,0,4
23000,2020-05-30T00:00:00Z,ZW,Zimbabwe,AFRO,17,149,0,4
23001,2020-05-31T00:00:00Z,ZW,Zimbabwe,AFRO,25,174,0,4
23002,2020-06-01T00:00:00Z,ZW,Zimbabwe,AFRO,4,178,0,4
23003,2020-06-02T00:00:00Z,ZW,Zimbabwe,AFRO,0,178,0,4
23004,2020-06-03T00:00:00Z,ZW,Zimbabwe,AFRO,28,206,0,4
23005,2020-06-04T00:00:00Z,ZW,Zimbabwe,AFRO,16,222,0,4
23006,2020-06-05T00:00:00Z,ZW,Zimbabwe,AFRO,0,222,0,4
23007,2020-06-06T00:00:00Z,ZW,Zimbabwe,AFRO,43,265,0,4
23008,2020-06-07T00:00:00Z,ZW,Zimbabwe,AFRO,14,279,0,4
23009,2020-06-08T00:00:00Z,ZW,Zimbabwe,AFRO,0,279,0,4
23010,2020-06-09T00:00:00Z,ZW,Zimbabwe,AFRO,8,287,0,4
23011,2020-06-10T00:00:00Z,ZW,Zimbabwe,AFRO,27,314,0,4
23012,2020-06-11T00:00:00Z,ZW,Zimbabwe,AFRO,6,320,0,4
23013,2020-06-12T00:00:00Z,ZW,Zimbabwe,AFRO,12,332,0,4
23014,2020-06-13T00:00:00Z,ZW,Zimbabwe,AFRO,11,343,0,4
23015,2020-06-14T00:00:00Z,ZW,Zimbabwe,AFRO,13,356,0,4
23016,2020-06-15T00:00:00Z,ZW,Zimbabwe,AFRO,27,383,0,4
23017,2020-06-16T00:00:00Z,ZW,Zimbabwe,AFRO,4,387,0,4
23018,2020-06-17T00:00:00Z,ZW,Zimbabwe,AFRO,4,391,0,4
23019,2020-06-18T00:00:00Z,ZW,Zimbabwe,AFRO,10,401,0,4
23020,2020-06-19T00:00:00Z,ZW,Zimbabwe,AFRO,62,463,0,4
23021,2020-06-20T00:00:00Z,ZW,Zimbabwe,AFRO,16,479,0,4
