index,Date_reported,Country_code,Country,WHO_region,New_cases,Cumulative_cases,New_deaths,Cumulative_deaths
118,2020-03-09T00:00:00Z,AL,Albania,EURO,2,2,0,0
119,2020-03-10T00:00:00Z,AL,Albania,EURO,4,6,0,0
120,2020-03-11T00:00:00Z,AL,Albania,EURO,4,10,0,0
121,2020-03-12T00:00:00Z,AL,Albania,EURO,13,23,0,0
122,2020-03-13T00:00:00Z,AL,Albania,EURO,10,33,1,1
123,2020-03-14T00:00:00Z,AL,Albania,EURO,5,38,0,1
124,2020-03-15T00:00:00Z,AL,Albania,EURO,4,42,0,1
125,2020-03-16T00:00:00Z,AL,Albania,EURO,9,51,0,1
126,2020-03-17T00:00:00Z,AL,Albania,EURO,4,55,0,1
127,2020-03-18T00:00:00Z,AL,Albania,EURO,4,59,1,2
128,2020-03-19T00:00:00Z,AL,Albania,EURO,11,70,0,2
129,2020-03-20T00:00:00Z,AL,Albania,EURO,0,70,0,2
130,2020-03-21T00:00:00Z,AL,Albania,EURO,6,76,0,2
131,2020-03-22T00:00:00Z,AL,Albania,EURO,0,76,0,2
132,2020-03-23T00:00:00Z,AL,Albania,EURO,13,89,0,2
133,2020-03-24T00:00:00Z,AL,Albania,EURO,34,123,2,4
134,2020-03-25T00:00:00Z,AL,Albania,EURO,23,146,1,5
135,2020-03-26T00:00:00Z,AL,Albania,EURO,28,174,0,5
136,2020-03-27T00:00:00Z,AL,Albania,EURO,12,186,3,8
137,2020-03-28T00:00:00Z,AL,Albania,EURO,11,197,1,9
138,2020-03-29T00:00:00Z,AL,Albania,EURO,15,212,1,10
139,2020-03-30T00:00:00Z,AL,Albania,EURO,11,223,0,10
140,2020-03-31T00:00:00Z,AL,Albania,EURO,0,223,1,11
141,2020-04-01T00:00:00Z,AL,Albania,EURO,20,243,2,13
142,2020-04-02T00:00:00Z,AL,Albania,EURO,34,277,2,15
143,2020-04-03T00:00:00Z,AL,Albania,EURO,0,277,1,16
144,2020-04-04T00:00:00Z,AL,Albania,EURO,56,333,1,17
145,2020-04-05T00:00:00Z,AL,Albania,EURO,0,333,1,18
146,2020-04-06T00:00:00Z,AL,Albania,EURO,44,377,3,21
147,2020-04-07T00:00:00Z,AL,Albania,EURO,0,377,1,22
148,2020-04-08T00:00:00Z,AL,Albania,EURO,23,400,0,22
149,2020-04-09T00:00:00Z,AL,Albania,EURO,9,409,0,22
150,2020-04-10T00:00:00Z,AL,Albania,EURO,7,416,1,23
151,2020-04-11T00:00:00Z,AL,Albania,EURO,0,416,0,23
152,2020-04-12T00:00:00Z,AL,Albania,EURO,30,446,0,23
153,2020-04-13T00:00:00Z,AL,Albania,EURO,0,446,0,23
154,2020-04-14T00:00:00Z,AL,Albania,EURO,29,475,0,23
155,2020-04-15T00:00:00Z,AL,Albania,EURO,0,475,1,24
156,2020-04-16T00:00:00Z,AL,Albania,EURO,19,494,1,25
157,2020-04-17T00:00:00Z,AL,Albania,EURO,24,518,1,26
158,2020-04-18T00:00:00Z,AL,Albania,EURO,30,548,0,26
159,2020-04-19T00:00:00Z,AL,Albania,EURO,0,548,0,26
160,2020-04-20T00:00:00Z,AL,Albania,EURO,14,562,0,26
161,2020-04-21T00:00:00Z,AL,Albania,EURO,47,609,0,26
162,2020-04-22T00:00:00Z,AL,Albania,EURO,25,634,0,26
163,2020-04-23T00:00:00Z,AL,Albania,EURO,0,634,1,27
164,2020-04-24T00:00:00Z,AL,Albania,EURO,44,678,0,27
165,2020-04-25T00:00:00Z,AL,Albania,EURO,0,678,0,27
166,2020-04-26T00:00:00Z,AL,Albania,EURO,34,712,0,27
167,2020-04-27T00:00:00Z,AL,Albania,EURO,14,726,1,28
168,2020-04-28T00:00:00Z,AL,Albania,EURO,10,736,0,28
169,2020-04-29T00:00:00Z,AL,Albania,EURO,30,766,2,30
170,2020-04-30T00:00:00Z,AL,Albania,EURO,7,773,1,31
171,2020-05-01T00:00:00Z,AL,Albania,EURO,0,773,0,31
172,2020-05-02T00:00:00Z,AL,Albania,EURO,16,789,0,31
173,2020-05-03T00:00:00Z,AL,Albania,EURO,6,795,0,31
174,2020-05-04T00:00:00Z,AL,Albania,EURO,8,803,0,31
175,2020-05-05T00:00:00Z,AL,Albania,EURO,17,820,0,31
176,2020-05-06T00:00:00Z,AL,Albania,EURO,12,832,0,31
177,2020-05-07T00:00:00Z,AL,Albania,EURO,0,832,0,31
178,2020-05-08T00:00:00Z,AL,Albania,EURO,18,850,0,31
179,2020-05-09T00:00:00Z,AL,Albania,EURO,6,856,0,31
180,2020-05-10T00:00:00Z,AL,Albania,EURO,12,868,0,31
181,2020-05-11T00:00:00Z,AL,Albania,EURO,0,868,0,31
182,2020-05-12T00:00:00Z,AL,Albania,EURO,4,872,0,31
183,2020-05-13T00:00:00Z,AL,Albania,EURO,4,876,0,31
184,2020-05-14T00:00:00Z,AL,Albania,EURO,4,880,0,31
185,2020-05-15T00:00:00Z,AL,Albania,EURO,18,898,0,31
186,2020-05-16T00:00:00Z,AL,Albania,EURO,35,933,0,31
187,2020-05-17T00:00:00Z,AL,Albania,EURO,13,946,0,31
188,2020-05-18T00:00:00Z,AL,Albania,EURO,2,948,0,31
189,2020-05-19T00:00:00Z,AL,Albania,EURO,0,948,0,31
190,2020-05-20T00:00:00Z,AL,Albania,EURO,16,964,0,31
191,2020-05-21T00:00:00Z,AL,Albania,EURO,5,969,0,31
192,2020-05-22T00:00:00Z,AL,Albania,EURO,0,969,0,31
193,2020-05-23T00:00:00Z,AL,Albania,EURO,12,981,0,31
194,2020-05-24T00:00:00Z,AL,Albania,EURO,8,989,1,32
195,2020-05-25T00:00:00Z,AL,Albania,EURO,15,1004,0,32
196,2020-05-26T00:00:00Z,AL,Albania,EURO,25,1029,1,33
197,2020-05-27T00:00:00Z,AL,Albania,EURO,21,1050,0,33
198,2020-05-28T00:00:00Z,AL,Albania,EURO,26,1076,0,33
199,2020-05-29T00:00:00Z,AL,Albania,EURO,23,1099,0,33
200,2020-05-30T00:00:00Z,AL,Albania,EURO,23,1122,0,33
201,2020-05-31T00:00:00Z,AL,Albania,EURO,14,1136,0,33
202,2020-06-01T00:00:00Z,AL,Albania,EURO,7,1143,0,33
203,2020-06-02T00:00:00Z,AL,Albania,EURO,21,1164,0,33
204,2020-06-03T00:00:00Z,AL,Albania,EURO,12,1176,0,33
205,2020-06-04T00:00:00Z,AL,Albania,EURO,21,1197,0,33
206,2020-06-05T00:00:00Z,AL,Albania,EURO,15,1212,0,33
207,2020-06-06T00:00:00Z,AL,Albania,EURO,20,1232,1,34
208,2020-06-07T00:00:00Z,AL,Albania,EURO,14,1246,0,34
209,2020-06-08T00:00:00Z,AL,Albania,EURO,17,1263,0,34
210,2020-06-09T00:00:00Z,AL,Albania,EURO,36,1299,0,34
211,2020-06-10T00:00:00Z,AL,Albania,EURO,42,1341,0,34
212,2020-06-11T00:00:00Z,AL,Albania,EURO,44,1385,0,34
213,2020-06-12T00:00:00Z,AL,Albania,EURO,31,1416,2,36
214,2020-06-13T00:00:00Z,AL,Albania,EURO,48,1464,0,36
215,2020-06-14T00:00:00Z,AL,Albania,EURO,57,1521,0,36
216,2020-06-15T00:00:00Z,AL,Albania,EURO,69,1590,0,36
217,2020-06-16T00:00:00Z,AL,Albania,EURO,82,1672,1,37
218,2020-06-17T00:00:00Z,AL,Albania,EURO,50,1722,1,38
219,2020-06-18T00:00:00Z,AL,Albania,EURO,66,1788,1,39
220,2020-06-19T00:00:00Z,AL,Albania,EURO,50,1838,3,42
221,2020-06-20T00:00:00Z,AL,Albania,EURO,0,1838,0,42
339,2020-03-02T00:00:00Z,AD,Andorra,EURO,1,1,0,0
340,2020-03-03T00:00:00Z,AD,Andorra,EURO,0,1,0,0
341,2020-03-04T00:00:00Z,AD,Andorra,EURO,0,1,0,0
342,2020-03-05T00:00:00Z,AD,Andorra,EURO,0,1,0,0
343,2020-03-06T00:00:00Z,AD,Andorra,EURO,0,1,0,0
344,2020-03-07T00:00:00Z,AD,Andorra,EURO,0,1,0,0
345,2020-03-08T00:00:00Z,AD,Andorra,EURO,0,1,0,0
346,2020-03-09T00:00:00Z,AD,Andorra,EURO,0,1,0,0
347,2020-03-10T00:00:00Z,AD,Andorra,EURO,0,1,0,0
348,2020-03-11T00:00:00Z,AD,Andorra,EURO,0,1,0,0
349,2020-03-12T00:00:00Z,AD,Andorra,EURO,0,1,0,0
350,2020-03-13T00:00:00Z,AD,Andorra,EURO,1,2,0,0
351,2020-03-14T00:00:00Z,AD,Andorra,EURO,0,2,0,0
352,2020-03-15T00:00:00Z,AD,Andorra,EURO,0,2,0,0
353,2020-03-16T00:00:00Z,AD,Andorra,EURO,12,14,0,0
354,2020-03-17T00:00:00Z,AD,Andorra,EURO,2,16,0,0
355,2020-03-18T00:00:00Z,AD,Andorra,EURO,23,39,0,0
356,2020-03-19T00:00:00Z,AD,Andorra,EURO,36,75,0,0
357,2020-03-20T00:00:00Z,AD,Andorra,EURO,0,75,0,0
358,2020-03-21T00:00:00Z,AD,Andorra,EURO,13,88,0,0
359,2020-03-22T00:00:00Z,AD,Andorra,EURO,0,88,0,0
360,2020-03-23T00:00:00Z,AD,Andorra,EURO,25,113,0,0
361,2020-03-24T00:00:00Z,AD,Andorra,EURO,51,164,1,1
362,2020-03-25T00:00:00Z,AD,Andorra,EURO,24,188,0,1
363,2020-03-26T00:00:00Z,AD,Andorra,EURO,25,213,2,3
364,2020-03-27T00:00:00Z,AD,Andorra,EURO,18,231,0,3
365,2020-03-28T00:00:00Z,AD,Andorra,EURO,58,289,0,3
366,2020-03-29T00:00:00Z,AD,Andorra,EURO,32,321,1,4
367,2020-03-30T00:00:00Z,AD,Andorra,EURO,20,341,2,6
368,2020-03-31T00:00:00Z,AD,Andorra,EURO,29,370,2,8
369,2020-04-01T00:00:00Z,AD,Andorra,EURO,6,376,4,12
370,2020-04-02T00:00:00Z,AD,Andorra,EURO,20,396,1,13
371,2020-04-03T00:00:00Z,AD,Andorra,EURO,33,429,2,15
372,2020-04-04T00:00:00Z,AD,Andorra,EURO,13,442,1,16
373,2020-04-05T00:00:00Z,AD,Andorra,EURO,24,466,1,17
374,2020-04-06T00:00:00Z,AD,Andorra,EURO,57,523,0,17
375,2020-04-07T00:00:00Z,AD,Andorra,EURO,17,540,4,21
376,2020-04-08T00:00:00Z,AD,Andorra,EURO,11,551,1,22
377,2020-04-09T00:00:00Z,AD,Andorra,EURO,15,566,2,24
378,2020-04-10T00:00:00Z,AD,Andorra,EURO,23,589,2,26
379,2020-04-11T00:00:00Z,AD,Andorra,EURO,13,602,0,26
380,2020-04-12T00:00:00Z,AD,Andorra,EURO,20,622,2,28
381,2020-04-13T00:00:00Z,AD,Andorra,EURO,17,639,1,29
382,2020-04-14T00:00:00Z,AD,Andorra,EURO,12,651,0,29
383,2020-04-15T00:00:00Z,AD,Andorra,EURO,8,659,2,31
384,2020-04-16T00:00:00Z,AD,Andorra,EURO,14,673,2,33
385,2020-04-17T00:00:00Z,AD,Andorra,EURO,21,694,1,34
386,2020-04-18T00:00:00Z,AD,Andorra,EURO,9,703,1,35
387,2020-04-19T00:00:00Z,AD,Andorra,EURO,1,704,0,35
388,2020-04-20T00:00:00Z,AD,Andorra,EURO,13,717,1,36
389,2020-04-21T00:00:00Z,AD,Andorra,EURO,1,718,0,36
390,2020-04-22T00:00:00Z,AD,Andorra,EURO,5,723,1,37
391,2020-04-23T00:00:00Z,AD,Andorra,EURO,1,724,0,37
392,2020-04-24T00:00:00Z,AD,Andorra,EURO,2,726,1,38
393,2020-04-25T00:00:00Z,AD,Andorra,EURO,7,733,2,40
394,2020-04-26T00:00:00Z,AD,Andorra,EURO,5,738,0,40
395,2020-04-27T00:00:00Z,AD,Andorra,EURO,2,740,0,40
396,2020-04-28T00:00:00Z,AD,Andorra,EURO,1,741,0,40
397,2020-04-29T00:00:00Z,AD,Andorra,EURO,1,742,1,41
398,2020-04-30T00:00:00Z,AD,Andorra,EURO,2,744,0,41
399,2020-05-01T00:00:00Z,AD,Andorra,EURO,2,746,1,42
400,2020-05-02T00:00:00Z,AD,Andorra,EURO,0,746,1,43
401,2020-05-03T00:00:00Z,AD,Andorra,EURO,1,747,1,44
402,2020-05-04T00:00:00Z,AD,Andorra,EURO,2,749,1,45
403,2020-05-05T00:00:00Z,AD,Andorra,EURO,2,751,0,45
404,2020-05-06T00:00:00Z,AD,Andorra,EURO,0,751,1,46
405,2020-05-07T00:00:00Z,AD,Andorra,EURO,1,752,1,47
406,2020-05-08T00:00:00Z,AD,Andorra,EURO,0,752,0,47
407,2020-05-09T00:00:00Z,AD,Andorra,EURO,2,754,0,47
408,2020-05-10T00:00:00Z,AD,Andorra,EURO,0,754,1,48
409,2020-05-11T00:00:00Z,AD,Andorra,EURO,2,756,0,48
410,2020-05-12T00:00:00Z,AD,Andorra,EURO,0,756,0,48
411,2020-05-13T00:00:00Z,AD,Andorra,EURO,3,759,0,48
412,2020-05-14T00:00:00Z,AD,Andorra,EURO,2,761,1,49
413,2020-05-15T00:00:00Z,AD,Andorra,EURO,0,761,0,49
414,2020-05-16T00:00:00Z,AD,Andorra,EURO,0,761,0,49
415,2020-05-17T00:00:00Z,AD,Andorra,EURO,0,761,2,51
416,2020-05-18T00:00:00Z,AD,Andorra,EURO,0,761,0,51
417,2020-05-19T00:00:00Z,AD,Andorra,EURO,0,761,0,51
418,2020-05-20T00:00:00Z,AD,Andorra,EURO,0,761,0,51
419,2020-05-21T00:00:00Z,AD,Andorra,EURO,1,762,0,51
420,2020-05-22T00:00:00Z,AD,Andorra,EURO,0,762,0,51
421,2020-05-23T00:00:00Z,AD,Andorra,EURO,0,762,0,51
422,2020-05-24T00:00:00Z,AD,Andorra,EURO,1,763,0,51
423,2020-05-25T00:00:00Z,AD,Andorra,EURO,0,763,0,51
424,2020-05-26T00:00:00Z,AD,Andorra,EURO,0,763,0,51
425,2020-05-27T00:00:00Z,AD,Andorra,EURO,0,763,0,51
426,2020-05-28T00:00:00Z,AD,Andorra,EURO,0,763,0,51
427,2020-05-29T00:00:00Z,AD,Andorra,EURO,1,764,0,51
428,2020-05-30T00:00:00Z,AD,Andorra,EURO,0,764,0,51
429,2020-05-31T00:00:00Z,AD,Andorra,EURO,0,764,0,51
430,2020-06-01T00:00:00Z,AD,Andorra,EURO,0,764,0,51
431,2020-06-02T00:00:00Z,AD,Andorra,EURO,1,765,0,51
432,2020-06-03T00:00:00Z,AD,Andorra,EURO,79,844,0,51
433,2020-06-04T00:00:00Z,AD,Andorra,EURO,7,851,0,51
434,2020-06-05T00:00:00Z,AD,Andorra,EURO,1,852,0,51
435,2020-06-06T00:00:00Z,AD,Andorra,EURO,0,852,0,51
436,2020-06-07T00:00:00Z,AD,Andorra,EURO,0,852,0,51
437,2020-06-08T00:00:00Z,AD,Andorra,EURO,0,852,0,51
438,2020-06-09T00:00:00Z,AD,Andorra,EURO,0,852,0,51
439,2020-06-10T00:00:00Z,AD,Andorra,EURO,0,852,0,51
440,2020-06-11T00:00:00Z,AD,Andorra,EURO,0,852,0,51
441,2020-06-12T00:00:00Z,AD,Andorra,EURO,0,852,0,51
442,2020-06-13T00:00:00Z,AD,Andorra,EURO,1,853,0,51
443,2020-06-14T00:00:00Z,AD,Andorra,EURO,0,853,0,51
444,2020-06-15T00:00:00Z,AD,Andorra,EURO,0,853,0,51
445,2020-06-16T00:00:00Z,AD,Andorra,EURO,0,853,0,51
446,2020-06-17T00:00:00Z,AD,Andorra,EURO,1,854,1,52
447,2020-06-18T00:00:00Z,AD,Andorra,EURO,0,854,0,52
448,2020-06-19T00:00:00Z,AD,Andorra,EURO,1,855,0,52
449,2020-06-20T00:00:00Z,AD,Andorra,EURO,0,855,0,52
839,2020-03-01T00:00:00Z,AM,Armenia,EURO,1,1,0,0
840,2020-03-02T00:00:00Z,AM,Armenia,EURO,0,1,0,0
841,2020-03-03T00:00:00Z,AM,Armenia,EURO,0,1,0,0
842,2020-03-04T00:00:00Z,AM,Armenia,EURO,0,1,0,0
843,2020-03-05T00:00:00Z,AM,Armenia,EURO,0,1,0,0
844,2020-03-06T00:00:00Z,AM,Armenia,EURO,0,1,0,0
845,2020-03-07T00:00:00Z,AM,Armenia,EURO,0,1,0,0
846,2020-03-08T00:00:00Z,AM,Armenia,EURO,0,1,0,0
847,2020-03-09T00:00:00Z,AM,Armenia,EURO,0,1,0,0
848,2020-03-10T00:00:00Z,AM,Armenia,EURO,0,1,0,0
849,2020-03-11T00:00:00Z,AM,Armenia,EURO,0,1,0,0
850,2020-03-12T00:00:00Z,AM,Armenia,EURO,0,1,0,0
851,2020-03-13T00:00:00Z,AM,Armenia,EURO,7,8,0,0
852,2020-03-14T00:00:00Z,AM,Armenia,EURO,0,8,0,0
853,2020-03-15T00:00:00Z,AM,Armenia,EURO,18,26,0,0
854,2020-03-16T00:00:00Z,AM,Armenia,EURO,26,52,0,0
855,2020-03-17T00:00:00Z,AM,Armenia,EURO,0,52,0,0
856,2020-03-18T00:00:00Z,AM,Armenia,EURO,32,84,0,0
857,2020-03-19T00:00:00Z,AM,Armenia,EURO,38,122,0,0
858,2020-03-20T00:00:00Z,AM,Armenia,EURO,14,136,0,0
859,2020-03-21T00:00:00Z,AM,Armenia,EURO,24,160,0,0
860,2020-03-22T00:00:00Z,AM,Armenia,EURO,0,160,0,0
861,2020-03-23T00:00:00Z,AM,Armenia,EURO,30,190,0,0
862,2020-03-24T00:00:00Z,AM,Armenia,EURO,45,235,0,0
863,2020-03-25T00:00:00Z,AM,Armenia,EURO,30,265,0,0
864,2020-03-26T00:00:00Z,AM,Armenia,EURO,25,290,0,0
865,2020-03-27T00:00:00Z,AM,Armenia,EURO,39,329,1,1
866,2020-03-28T00:00:00Z,AM,Armenia,EURO,43,372,0,1
867,2020-03-29T00:00:00Z,AM,Armenia,EURO,52,424,2,3
868,2020-03-30T00:00:00Z,AM,Armenia,EURO,58,482,0,3
869,2020-03-31T00:00:00Z,AM,Armenia,EURO,0,482,0,3
870,2020-04-01T00:00:00Z,AM,Armenia,EURO,50,532,0,3
871,2020-04-02T00:00:00Z,AM,Armenia,EURO,39,571,0,3
872,2020-04-03T00:00:00Z,AM,Armenia,EURO,69,640,1,4
873,2020-04-04T00:00:00Z,AM,Armenia,EURO,96,736,3,7
874,2020-04-05T00:00:00Z,AM,Armenia,EURO,10,746,0,7
875,2020-04-06T00:00:00Z,AM,Armenia,EURO,0,746,0,7
876,2020-04-07T00:00:00Z,AM,Armenia,EURO,87,833,1,8
877,2020-04-08T00:00:00Z,AM,Armenia,EURO,44,877,0,8
878,2020-04-09T00:00:00Z,AM,Armenia,EURO,44,921,2,10
879,2020-04-10T00:00:00Z,AM,Armenia,EURO,16,937,1,11
880,2020-04-11T00:00:00Z,AM,Armenia,EURO,0,937,0,11
881,2020-04-12T00:00:00Z,AM,Armenia,EURO,76,1013,2,13
882,2020-04-13T00:00:00Z,AM,Armenia,EURO,26,1039,1,14
883,2020-04-14T00:00:00Z,AM,Armenia,EURO,0,1039,0,14
884,2020-04-15T00:00:00Z,AM,Armenia,EURO,28,1067,2,16
885,2020-04-16T00:00:00Z,AM,Armenia,EURO,68,1135,2,18
886,2020-04-17T00:00:00Z,AM,Armenia,EURO,24,1159,0,18
887,2020-04-18T00:00:00Z,AM,Armenia,EURO,42,1201,1,19
888,2020-04-19T00:00:00Z,AM,Armenia,EURO,47,1248,1,20
889,2020-04-20T00:00:00Z,AM,Armenia,EURO,43,1291,0,20
890,2020-04-21T00:00:00Z,AM,Armenia,EURO,48,1339,2,22
891,2020-04-22T00:00:00Z,AM,Armenia,EURO,38,1377,2,24
892,2020-04-23T00:00:00Z,AM,Armenia,EURO,96,1473,0,24
893,2020-04-24T00:00:00Z,AM,Armenia,EURO,50,1523,0,24
894,2020-04-25T00:00:00Z,AM,Armenia,EURO,73,1596,3,27
895,2020-04-26T00:00:00Z,AM,Armenia,EURO,150,1746,1,28
896,2020-04-27T00:00:00Z,AM,Armenia,EURO,62,1808,1,29
897,2020-04-28T00:00:00Z,AM,Armenia,EURO,59,1867,1,30
898,2020-04-29T00:00:00Z,AM,Armenia,EURO,65,1932,0,30
899,2020-04-30T00:00:00Z,AM,Armenia,EURO,134,2066,2,32
900,2020-05-01T00:00:00Z,AM,Armenia,EURO,82,2148,1,33
901,2020-05-02T00:00:00Z,AM,Armenia,EURO,125,2273,0,33
902,2020-05-03T00:00:00Z,AM,Armenia,EURO,113,2386,2,35
903,2020-05-04T00:00:00Z,AM,Armenia,EURO,121,2507,4,39
904,2020-05-05T00:00:00Z,AM,Armenia,EURO,112,2619,1,40
905,2020-05-06T00:00:00Z,AM,Armenia,EURO,163,2782,0,40
906,2020-05-07T00:00:00Z,AM,Armenia,EURO,102,2884,2,42
907,2020-05-08T00:00:00Z,AM,Armenia,EURO,145,3029,1,43
908,2020-05-09T00:00:00Z,AM,Armenia,EURO,146,3175,1,44
909,2020-05-10T00:00:00Z,AM,Armenia,EURO,138,3313,1,45
910,2020-05-11T00:00:00Z,AM,Armenia,EURO,79,3392,0,45
911,2020-05-12T00:00:00Z,AM,Armenia,EURO,146,3538,2,47
912,2020-05-13T00:00:00Z,AM,Armenia,EURO,180,3718,1,48
913,2020-05-14T00:00:00Z,AM,Armenia,EURO,118,3836,1,49
914,2020-05-15T00:00:00Z,AM,Armenia,EURO,208,4044,3,52
915,2020-05-16T00:00:00Z,AM,Armenia,EURO,239,4283,3,55
916,2020-05-17T00:00:00Z,AM,Armenia,EURO,189,4472,5,60
917,2020-05-18T00:00:00Z,AM,Armenia,EURO,351,4823,1,61
918,2020-05-19T00:00:00Z,AM,Armenia,EURO,218,5041,3,64
919,2020-05-20T00:00:00Z,AM,Armenia,EURO,230,5271,3,67
920,2020-05-21T00:00:00Z,AM,Armenia,EURO,335,5606,3,70
921,2020-05-22T00:00:00Z,AM,Armenia,EURO,322,5928,4,74
922,2020-05-23T00:00:00Z,AM,Armenia,EURO,374,6302,3,77
923,2020-05-24T00:00:00Z,AM,Armenia,EURO,359,6661,4,81
924,2020-05-25T00:00:00Z,AM,Armenia,EURO,452,7113,6,87
925,2020-05-26T00:00:00Z,AM,Armenia,EURO,289,7402,4,91
926,2020-05-27T00:00:00Z,AM,Armenia,EURO,372,7774,7,98
927,2020-05-28T00:00:00Z,AM,Armenia,EURO,442,8216,15,113
928,2020-05-29T00:00:00Z,AM,Armenia,EURO,460,8676,7,120
929,2020-05-30T00:00:00Z,AM,Armenia,EURO,251,8927,7,127
930,2020-05-31T00:00:00Z,AM,Armenia,EURO,355,9282,4,131
931,2020-06-01T00:00:00Z,AM,Armenia,EURO,210,9492,8,139
932,2020-06-02T00:00:00Z,AM,Armenia,EURO,517,10009,19,158
933,2020-06-03T00:00:00Z,AM,Armenia,EURO,515,10524,12,170
934,2020-06-04T00:00:00Z,AM,Armenia,EURO,697,11221,6,176
935,2020-06-05T00:00:00Z,AM,Armenia,EURO,596,11817,7,183
936,2020-06-06T00:00:00Z,AM,Armenia,EURO,547,12364,7,190
937,2020-06-07T00:00:00Z,AM,Armenia,EURO,766,13130,10,200
938,2020-06-08T00:00:00Z,AM,Armenia,EURO,195,13325,11,211
939,2020-06-09T00:00:00Z,AM,Armenia,EURO,350,13675,6,217
940,2020-06-10T00:00:00Z,AM,Armenia,EURO,428,14103,10,227
941,2020-06-11T00:00:00Z,AM,Armenia,EURO,566,14669,18,245
942,2020-06-12T00:00:00Z,AM,Armenia,EURO,612,15281,13,258
943,2020-06-13T00:00:00Z,AM,Armenia,EURO,723,16004,6,264
944,2020-06-14T00:00:00Z,AM,Armenia,EURO,663,16667,5,269
945,2020-06-15T00:00:00Z,AM,Armenia,EURO,397,17064,16,285
946,2020-06-16T00:00:00Z,AM,Armenia,EURO,425,17489,8,293
947,2020-06-17T00:00:00Z,AM,Armenia,EURO,544,18033,9,302
948,2020-06-18T00:00:00Z,AM,Armenia,EURO,665,18698,7,309
949,2020-06-19T00:00:00Z,AM,Armenia,EURO,459,19157,10,319
950,2020-06-20T00:00:00Z,AM,Armenia,EURO,551,19708,13,332
1195,2020-02-25T00:00:00Z,AT,Austria,EURO,2,2,0,0
1196,2020-02-26T00:00:00Z,AT,Austria,EURO,0,2,0,0
1197,2020-02-27T00:00:00Z,AT,Austria,EURO,2,4,0,0
1198,2020-02-28T00:00:00Z,AT,Austria,EURO,1,5,0,0
1199,2020-02-29T00:00:00Z,AT,Austria,EURO,5,10,0,0
1200,2020-03-01T00:00:00Z,AT,Austria,EURO,0,10,0,0
1201,2020-03-02T00:00:00Z,AT,Austria,EURO,8,18,0,0
1202,2020-03-03T00:00:00Z,AT,Austria,EURO,6,24,0,0
1203,2020-03-04T00:00:00Z,AT,Austria,EURO,5,29,0,0
1204,2020-03-05T00:00:00Z,AT,Austria,EURO,8,37,0,0
1205,2020-03-06T00:00:00Z,AT,Austria,EURO,29,66,0,0
1206,2020-03-07T00:00:00Z,AT,Austria,EURO,13,79,0,0
1207,2020-03-08T00:00:00Z,AT,Austria,EURO,23,102,0,0
1208,2020-03-09T00:00:00Z,AT,Austria,EURO,10,112,0,0
1209,2020-03-10T00:00:00Z,AT,Austria,EURO,70,182,0,0
1210,2020-03-11T00:00:00Z,AT,Austria,EURO,0,182,0,0
1211,2020-03-12T00:00:00Z,AT,Austria,EURO,179,361,1,1
1212,2020-03-13T00:00:00Z,AT,Austria,EURO,143,504,0,1
1213,2020-03-14T00:00:00Z,AT,Austria,EURO,151,655,0,1
1214,2020-03-15T00:00:00Z,AT,Austria,EURO,205,860,0,1
1215,2020-03-16T00:00:00Z,AT,Austria,EURO,99,959,0,1
1216,2020-03-17T00:00:00Z,AT,Austria,EURO,373,1332,2,3
1217,2020-03-18T00:00:00Z,AT,Austria,EURO,314,1646,1,4
1218,2020-03-19T00:00:00Z,AT,Austria,EURO,197,1843,1,5
1219,2020-03-20T00:00:00Z,AT,Austria,EURO,806,2649,1,6
1220,2020-03-21T00:00:00Z,AT,Austria,EURO,375,3024,2,8
1221,2020-03-22T00:00:00Z,AT,Austria,EURO,0,3024,0,8
1222,2020-03-23T00:00:00Z,AT,Austria,EURO,607,3631,8,16
1223,2020-03-24T00:00:00Z,AT,Austria,EURO,855,4486,9,25
1224,2020-03-25T00:00:00Z,AT,Austria,EURO,796,5282,5,30
1225,2020-03-26T00:00:00Z,AT,Austria,EURO,606,5888,4,34
1226,2020-03-27T00:00:00Z,AT,Austria,EURO,1141,7029,18,52
1227,2020-03-28T00:00:00Z,AT,Austria,EURO,668,7697,16,68
1228,2020-03-29T00:00:00Z,AT,Austria,EURO,594,8291,0,68
1229,2020-03-30T00:00:00Z,AT,Austria,EURO,522,8813,18,86
1230,2020-03-31T00:00:00Z,AT,Austria,EURO,805,9618,22,108
1231,2020-04-01T00:00:00Z,AT,Austria,EURO,564,10182,20,128
1232,2020-04-02T00:00:00Z,AT,Austria,EURO,529,10711,18,146
1233,2020-04-03T00:00:00Z,AT,Austria,EURO,418,11129,12,158
1234,2020-04-04T00:00:00Z,AT,Austria,EURO,396,11525,10,168
1235,2020-04-05T00:00:00Z,AT,Austria,EURO,241,11766,18,186
1236,2020-04-06T00:00:00Z,AT,Austria,EURO,217,11983,18,204
1237,2020-04-07T00:00:00Z,AT,Austria,EURO,314,12297,16,220
1238,2020-04-08T00:00:00Z,AT,Austria,EURO,343,12640,23,243
1239,2020-04-09T00:00:00Z,AT,Austria,EURO,329,12969,30,273
1240,2020-04-10T00:00:00Z,AT,Austria,EURO,279,13248,22,295
1241,2020-04-11T00:00:00Z,AT,Austria,EURO,312,13560,24,319
1242,2020-04-12T00:00:00Z,AT,Austria,EURO,247,13807,18,337
1243,2020-04-13T00:00:00Z,AT,Austria,EURO,130,13937,13,350
1244,2020-04-14T00:00:00Z,AT,Austria,EURO,106,14043,18,368
1245,2020-04-15T00:00:00Z,AT,Austria,EURO,191,14234,16,384
1246,2020-04-16T00:00:00Z,AT,Austria,EURO,136,14370,9,393
1247,2020-04-17T00:00:00Z,AT,Austria,EURO,78,14448,17,410
1248,2020-04-18T00:00:00Z,AT,Austria,EURO,155,14603,21,431
1249,2020-04-19T00:00:00Z,AT,Austria,EURO,59,14662,12,443
1250,2020-04-20T00:00:00Z,AT,Austria,EURO,48,14710,9,452
1251,2020-04-21T00:00:00Z,AT,Austria,EURO,73,14783,10,462
1252,2020-04-22T00:00:00Z,AT,Austria,EURO,50,14833,1,463
1253,2020-04-23T00:00:00Z,AT,Austria,EURO,91,14924,31,494
1254,2020-04-24T00:00:00Z,AT,Austria,EURO,61,14985,14,508
1255,2020-04-25T00:00:00Z,AT,Austria,EURO,83,15068,5,513
1256,2020-04-26T00:00:00Z,AT,Austria,EURO,66,15134,23,536
1257,2020-04-27T00:00:00Z,AT,Austria,EURO,55,15189,6,542
1258,2020-04-28T00:00:00Z,AT,Austria,EURO,67,15256,7,549
1259,2020-04-29T00:00:00Z,AT,Austria,EURO,58,15314,20,569
1260,2020-04-30T00:00:00Z,AT,Austria,EURO,50,15364,11,580
1261,2020-05-01T00:00:00Z,AT,Austria,EURO,60,15424,4,584
1262,2020-05-02T00:00:00Z,AT,Austria,EURO,34,15458,5,589
1263,2020-05-03T00:00:00Z,AT,Austria,EURO,12,15470,7,596
1264,2020-05-04T00:00:00Z,AT,Austria,EURO,68,15538,2,598
1265,2020-05-05T00:00:00Z,AT,Austria,EURO,31,15569,2,600
1266,2020-05-06T00:00:00Z,AT,Austria,EURO,17,15586,6,606
1267,2020-05-07T00:00:00Z,AT,Austria,EURO,65,15651,2,608
1268,2020-05-08T00:00:00Z,AT,Austria,EURO,22,15673,1,609
1269,2020-05-09T00:00:00Z,AT,Austria,EURO,62,15735,5,614
1270,2020-05-10T00:00:00Z,AT,Austria,EURO,42,15777,1,615
1271,2020-05-11T00:00:00Z,AT,Austria,EURO,10,15787,3,618
1272,2020-05-12T00:00:00Z,AT,Austria,EURO,87,15874,2,620
1273,2020-05-13T00:00:00Z,AT,Austria,EURO,36,15910,3,623
1274,2020-05-14T00:00:00Z,AT,Austria,EURO,54,15964,1,624
1275,2020-05-15T00:00:00Z,AT,Austria,EURO,41,16005,2,626
1276,2020-05-16T00:00:00Z,AT,Austria,EURO,63,16068,2,628
1277,2020-05-17T00:00:00Z,AT,Austria,EURO,72,16140,0,628
1278,2020-05-18T00:00:00Z,AT,Austria,EURO,14,16154,1,629
1279,2020-05-19T00:00:00Z,AT,Austria,EURO,25,16179,0,629
1280,2020-05-20T00:00:00Z,AT,Austria,EURO,78,16257,3,632
1281,2020-05-21T00:00:00Z,AT,Austria,EURO,18,16275,1,633
1282,2020-05-22T00:00:00Z,AT,Austria,EURO,57,16332,0,633
1283,2020-05-23T00:00:00Z,AT,Austria,EURO,29,16361,2,635
1284,2020-05-24T00:00:00Z,AT,Austria,EURO,46,16407,4,639
1285,2020-05-25T00:00:00Z,AT,Austria,EURO,32,16439,1,640
1286,2020-05-26T00:00:00Z,AT,Austria,EURO,20,16459,1,641
1287,2020-05-27T00:00:00Z,AT,Austria,EURO,38,16497,2,643
1288,2020-05-28T00:00:00Z,AT,Austria,EURO,18,16515,2,645
1289,2020-05-29T00:00:00Z,AT,Austria,EURO,28,16543,23,668
1290,2020-05-30T00:00:00Z,AT,Austria,EURO,51,16594,0,668
1291,2020-05-31T00:00:00Z,AT,Austria,EURO,44,16638,0,668
1292,2020-06-01T00:00:00Z,AT,Austria,EURO,4,16642,0,668
1293,2020-06-02T00:00:00Z,AT,Austria,EURO,21,16663,0,668
1294,2020-06-03T00:00:00Z,AT,Austria,EURO,11,16674,1,669
1295,2020-06-04T00:00:00Z,AT,Austria,EURO,31,16705,1,670
1296,2020-06-05T00:00:00Z,AT,Austria,EURO,36,16741,0,670
1297,2020-06-06T00:00:00Z,AT,Austria,EURO,62,16803,2,672
1298,2020-06-07T00:00:00Z,AT,Austria,EURO,19,16822,0,672
1299,2020-06-08T00:00:00Z,AT,Austria,EURO,46,16868,0,672
1300,2020-06-09T00:00:00Z,AT,Austria,EURO,21,16889,0,672
1301,2020-06-10T00:00:00Z,AT,Austria,EURO,13,16902,0,672
1302,2020-06-11T00:00:00Z,AT,Austria,EURO,34,16936,1,673
1303,2020-06-12T00:00:00Z,AT,Austria,EURO,28,16964,1,674
1304,2020-06-13T00:00:00Z,AT,Austria,EURO,30,16994,1,675
1305,2020-06-14T00:00:00Z,AT,Austria,EURO,20,17014,2,677
1306,2020-06-15T00:00:00Z,AT,Austria,EURO,24,17038,0,677
1307,2020-06-16T00:00:00Z,AT,Austria,EURO,27,17065,1,678
1308,2020-06-17T00:00:00Z,AT,Austria,EURO,33,17098,3,681
1309,2020-06-18T00:00:00Z,AT,Austria,EURO,17,17115,6,687
1310,2020-06-19T00:00:00Z,AT,Austria,EURO,40,17155,1,688
1311,2020-06-20T00:00:00Z,AT,Austria,EURO,30,17185,0,688
1312,2020-02-29T00:00:00Z,AZ,Azerbaijan,EURO,3,3,0,0
1313,2020-03-01T00:00:00Z,AZ,Azerbaijan,EURO,0,3,0,0
1314,2020-03-02T00:00:00Z,AZ,Azerbaijan,EURO,0,3,0,0
1315,2020-03-03T00:00:00Z,AZ,Azerbaijan,EURO,0,3,0,0
1316,2020-03-04T00:00:00Z,AZ,Azerbaijan,EURO,0,3,0,0
1317,2020-03-05T00:00:00Z,AZ,Azerbaijan,EURO,0,3,0,0
1318,2020-03-06T00:00:00Z,AZ,Azerbaijan,EURO,6,9,0,0
1319,2020-03-07T00:00:00Z,AZ,Azerbaijan,EURO,0,9,0,0
1320,2020-03-08T00:00:00Z,AZ,Azerbaijan,EURO,0,9,0,0
1321,2020-03-09T00:00:00Z,AZ,Azerbaijan,EURO,0,9,0,0
1322,2020-03-10T00:00:00Z,AZ,Azerbaijan,EURO,0,9,0,0
1323,2020-03-11T00:00:00Z,AZ,Azerbaijan,EURO,0,9,0,0
1324,2020-03-12T00:00:00Z,AZ,Azerbaijan,EURO,2,11,0,0
1325,2020-03-13T00:00:00Z,AZ,Azerbaijan,EURO,0,11,0,0
1326,2020-03-14T00:00:00Z,AZ,Azerbaijan,EURO,8,19,0,0
1327,2020-03-15T00:00:00Z,AZ,Azerbaijan,EURO,2,21,0,0
1328,2020-03-16T00:00:00Z,AZ,Azerbaijan,EURO,0,21,0,0
1329,2020-03-17T00:00:00Z,AZ,Azerbaijan,EURO,0,21,0,0
1330,2020-03-18T00:00:00Z,AZ,Azerbaijan,EURO,13,34,1,1
1331,2020-03-19T00:00:00Z,AZ,Azerbaijan,EURO,0,34,0,1
1332,2020-03-20T00:00:00Z,AZ,Azerbaijan,EURO,10,44,0,1
1333,2020-03-21T00:00:00Z,AZ,Azerbaijan,EURO,9,53,0,1
1334,2020-03-22T00:00:00Z,AZ,Azerbaijan,EURO,0,53,0,1
1335,2020-03-23T00:00:00Z,AZ,Azerbaijan,EURO,12,65,0,1
1336,2020-03-24T00:00:00Z,AZ,Azerbaijan,EURO,7,72,0,1
1337,2020-03-25T00:00:00Z,AZ,Azerbaijan,EURO,15,87,0,1
1338,2020-03-26T00:00:00Z,AZ,Azerbaijan,EURO,6,93,1,2
1339,2020-03-27T00:00:00Z,AZ,Azerbaijan,EURO,29,122,1,3
1340,2020-03-28T00:00:00Z,AZ,Azerbaijan,EURO,25,147,0,3
1341,2020-03-29T00:00:00Z,AZ,Azerbaijan,EURO,17,164,1,4
1342,2020-03-30T00:00:00Z,AZ,Azerbaijan,EURO,26,190,0,4
1343,2020-03-31T00:00:00Z,AZ,Azerbaijan,EURO,83,273,0,4
1344,2020-04-01T00:00:00Z,AZ,Azerbaijan,EURO,25,298,1,5
1345,2020-04-02T00:00:00Z,AZ,Azerbaijan,EURO,61,359,0,5
1346,2020-04-03T00:00:00Z,AZ,Azerbaijan,EURO,41,400,0,5
1347,2020-04-04T00:00:00Z,AZ,Azerbaijan,EURO,43,443,0,5
1348,2020-04-05T00:00:00Z,AZ,Azerbaijan,EURO,69,512,0,5
1349,2020-04-06T00:00:00Z,AZ,Azerbaijan,EURO,72,584,0,5
1350,2020-04-07T00:00:00Z,AZ,Azerbaijan,EURO,57,641,2,7
1351,2020-04-08T00:00:00Z,AZ,Azerbaijan,EURO,76,717,1,8
1352,2020-04-09T00:00:00Z,AZ,Azerbaijan,EURO,105,822,0,8
1353,2020-04-10T00:00:00Z,AZ,Azerbaijan,EURO,104,926,1,9
1354,2020-04-11T00:00:00Z,AZ,Azerbaijan,EURO,65,991,1,10
1355,2020-04-12T00:00:00Z,AZ,Azerbaijan,EURO,67,1058,1,11
1356,2020-04-13T00:00:00Z,AZ,Azerbaijan,EURO,40,1098,0,11
1357,2020-04-14T00:00:00Z,AZ,Azerbaijan,EURO,50,1148,1,12
1358,2020-04-15T00:00:00Z,AZ,Azerbaijan,EURO,49,1197,1,13
1359,2020-04-16T00:00:00Z,AZ,Azerbaijan,EURO,56,1253,0,13
1360,2020-04-17T00:00:00Z,AZ,Azerbaijan,EURO,30,1283,2,15
1361,2020-04-18T00:00:00Z,AZ,Azerbaijan,EURO,57,1340,0,15
1362,2020-04-19T00:00:00Z,AZ,Azerbaijan,EURO,33,1373,3,18
1363,2020-04-20T00:00:00Z,AZ,Azerbaijan,EURO,25,1398,1,19
1364,2020-04-21T00:00:00Z,AZ,Azerbaijan,EURO,38,1436,0,19
1365,2020-04-22T00:00:00Z,AZ,Azerbaijan,EURO,44,1480,1,20
1366,2020-04-23T00:00:00Z,AZ,Azerbaijan,EURO,38,1518,0,20
1367,2020-04-24T00:00:00Z,AZ,Azerbaijan,EURO,30,1548,0,20
1368,2020-04-25T00:00:00Z,AZ,Azerbaijan,EURO,44,1592,1,21
1369,2020-04-26T00:00:00Z,AZ,Azerbaijan,EURO,25,1617,0,21
1370,2020-04-27T00:00:00Z,AZ,Azerbaijan,EURO,28,1645,0,21
1371,2020-04-28T00:00:00Z,AZ,Azerbaijan,EURO,33,1678,1,22
1372,2020-04-29T00:00:00Z,AZ,Azerbaijan,EURO,39,1717,0,22
1373,2020-04-30T00:00:00Z,AZ,Azerbaijan,EURO,49,1766,1,23
1374,2020-05-01T00:00:00Z,AZ,Azerbaijan,EURO,38,1804,1,24
1375,2020-05-02T00:00:00Z,AZ,Azerbaijan,EURO,50,1854,1,25
1376,2020-05-03T00:00:00Z,AZ,Azerbaijan,EURO,40,1894,0,25
1377,2020-05-04T00:00:00Z,AZ,Azerbaijan,EURO,38,1932,0,25
1378,2020-05-05T00:00:00Z,AZ,Azerbaijan,EURO,52,1984,1,26
1379,2020-05-06T00:00:00Z,AZ,Azerbaijan,EURO,76,2060,0,26
1380,2020-05-07T00:00:00Z,AZ,Azerbaijan,EURO,67,2127,2,28
1381,2020-05-08T00:00:00Z,AZ,Azerbaijan,EURO,77,2204,0,28
1382,2020-05-09T00:00:00Z,AZ,Azerbaijan,EURO,75,2279,0,28
1383,2020-05-10T00:00:00Z,AZ,Azerbaijan,EURO,143,2422,3,31
1384,2020-05-11T00:00:00Z,AZ,Azerbaijan,EURO,97,2519,1,32
1385,2020-05-12T00:00:00Z,AZ,Azerbaijan,EURO,70,2589,0,32
1386,2020-05-13T00:00:00Z,AZ,Azerbaijan,EURO,104,2693,1,33
1387,2020-05-14T00:00:00Z,AZ,Azerbaijan,EURO,65,2758,2,35
1388,2020-05-15T00:00:00Z,AZ,Azerbaijan,EURO,121,2879,0,35
1389,2020-05-16T00:00:00Z,AZ,Azerbaijan,EURO,101,2980,1,36
1390,2020-05-17T00:00:00Z,AZ,Azerbaijan,EURO,158,3138,0,36
1391,2020-05-18T00:00:00Z,AZ,Azerbaijan,EURO,136,3274,3,39
1392,2020-05-19T00:00:00Z,AZ,Azerbaijan,EURO,113,3387,1,40
1393,2020-05-20T00:00:00Z,AZ,Azerbaijan,EURO,131,3518,1,41
1394,2020-05-21T00:00:00Z,AZ,Azerbaijan,EURO,113,3631,2,43
1395,2020-05-22T00:00:00Z,AZ,Azerbaijan,EURO,118,3749,1,44
1396,2020-05-23T00:00:00Z,AZ,Azerbaijan,EURO,106,3855,2,46
1397,2020-05-24T00:00:00Z,AZ,Azerbaijan,EURO,127,3982,3,49
1398,2020-05-25T00:00:00Z,AZ,Azerbaijan,EURO,140,4122,0,49
1399,2020-05-26T00:00:00Z,AZ,Azerbaijan,EURO,149,4271,2,51
1400,2020-05-27T00:00:00Z,AZ,Azerbaijan,EURO,132,4403,1,52
1401,2020-05-28T00:00:00Z,AZ,Azerbaijan,EURO,165,4568,2,54
1402,2020-05-29T00:00:00Z,AZ,Azerbaijan,EURO,191,4759,2,56
1403,2020-05-30T00:00:00Z,AZ,Azerbaijan,EURO,230,4989,2,58
1404,2020-05-31T00:00:00Z,AZ,Azerbaijan,EURO,257,5246,3,61
1405,2020-06-01T00:00:00Z,AZ,Azerbaijan,EURO,248,5494,2,63
1406,2020-06-02T00:00:00Z,AZ,Azerbaijan,EURO,168,5662,5,68
1407,2020-06-03T00:00:00Z,AZ,Azerbaijan,EURO,273,5935,3,71
1408,2020-06-04T00:00:00Z,AZ,Azerbaijan,EURO,325,6260,5,76
1409,2020-06-05T00:00:00Z,AZ,Azerbaijan,EURO,262,6522,2,78
1410,2020-06-06T00:00:00Z,AZ,Azerbaijan,EURO,338,6860,4,82
1411,2020-06-07T00:00:00Z,AZ,Azerbaijan,EURO,379,7239,2,84
1412,2020-06-08T00:00:00Z,AZ,Azerbaijan,EURO,314,7553,4,88
1413,2020-06-09T00:00:00Z,AZ,Azerbaijan,EURO,323,7876,5,93
1414,2020-06-10T00:00:00Z,AZ,Azerbaijan,EURO,315,8191,5,98
1415,2020-06-11T00:00:00Z,AZ,Azerbaijan,EURO,339,8530,4,102
1416,2020-06-12T00:00:00Z,AZ,Azerbaijan,EURO,352,8882,6,108
1417,2020-06-13T00:00:00Z,AZ,Azerbaijan,EURO,336,9218,5,113
1418,2020-06-14T00:00:00Z,AZ,Azerbaijan,EURO,352,9570,2,115
1419,2020-06-15T00:00:00Z,AZ,Azerbaijan,EURO,387,9957,4,119
1420,2020-06-16T00:00:00Z,AZ,Azerbaijan,EURO,367,10324,3,122
1421,2020-06-17T00:00:00Z,AZ,Azerbaijan,EURO,338,10662,4,126
1422,2020-06-18T00:00:00Z,AZ,Azerbaijan,EURO,329,10991,7,133
1423,2020-06-19T00:00:00Z,AZ,Azerbaijan,EURO,338,11329,6,139
1424,2020-06-20T00:00:00Z,AZ,Azerbaijan,EURO,438,11767,4,143
1839,2020-02-28T00:00:00Z,BY,Belarus,EURO,1,1,0,0
1840,2020-02-29T00:00:00Z,BY,Belarus,EURO,0,1,0,0
1841,2020-03-01T00:00:00Z,BY,Belarus,EURO,0,1,0,0
1842,2020-03-02T00:00:00Z,BY,Belarus,EURO,0,1,0,0
1843,2020-03-03T00:00:00Z,BY,Belarus,EURO,0,1,0,0
1844,2020-03-04T00:00:00Z,BY,Belarus,EURO,5,6,0,0
1845,2020-03-05T00:00:00Z,BY,Belarus,EURO,0,6,0,0
1846,2020-03-06T00:00:00Z,BY,Belarus,EURO,0,6,0,0
1847,2020-03-07T00:00:00Z,BY,Belarus,EURO,0,6,0,0
1848,2020-03-08T00:00:00Z,BY,Belarus,EURO,0,6,0,0
1849,2020-03-09T00:00:00Z,BY,Belarus,EURO,0,6,0,0
1850,2020-03-10T00:00:00Z,BY,Belarus,EURO,3,9,0,0
1851,2020-03-11T00:00:00Z,BY,Belarus,EURO,3,12,0,0
1852,2020-03-12T00:00:00Z,BY,Belarus,EURO,0,12,0,0
1853,2020-03-13T00:00:00Z,BY,Belarus,EURO,9,21,0,0
1854,2020-03-14T00:00:00Z,BY,Belarus,EURO,0,21,0,0
1855,2020-03-15T00:00:00Z,BY,Belarus,EURO,0,21,0,0
1856,2020-03-16T00:00:00Z,BY,Belarus,EURO,15,36,0,0
1857,2020-03-17T00:00:00Z,BY,Belarus,EURO,0,36,0,0
1858,2020-03-18T00:00:00Z,BY,Belarus,EURO,10,46,0,0
1859,2020-03-19T00:00:00Z,BY,Belarus,EURO,0,46,0,0
1860,2020-03-20T00:00:00Z,BY,Belarus,EURO,11,57,0,0
1861,2020-03-21T00:00:00Z,BY,Belarus,EURO,19,76,0,0
1862,2020-03-22T00:00:00Z,BY,Belarus,EURO,0,76,0,0
1863,2020-03-23T00:00:00Z,BY,Belarus,EURO,0,76,0,0
1864,2020-03-24T00:00:00Z,BY,Belarus,EURO,5,81,0,0
1865,2020-03-25T00:00:00Z,BY,Belarus,EURO,0,81,0,0
1866,2020-03-26T00:00:00Z,BY,Belarus,EURO,5,86,0,0
1867,2020-03-27T00:00:00Z,BY,Belarus,EURO,0,86,0,0
1868,2020-03-28T00:00:00Z,BY,Belarus,EURO,8,94,0,0
1869,2020-03-29T00:00:00Z,BY,Belarus,EURO,0,94,0,0
1870,2020-03-30T00:00:00Z,BY,Belarus,EURO,58,152,0,0
1871,2020-03-31T00:00:00Z,BY,Belarus,EURO,0,152,0,0
1872,2020-04-01T00:00:00Z,BY,Belarus,EURO,0,152,0,0
1873,2020-04-02T00:00:00Z,BY,Belarus,EURO,40,192,2,2
1874,2020-04-03T00:00:00Z,BY,Belarus,EURO,62,254,2,4
1875,2020-04-04T00:00:00Z,BY,Belarus,EURO,0,254,0,4
1876,2020-04-05T00:00:00Z,BY,Belarus,EURO,186,440,0,4
1877,2020-04-06T00:00:00Z,BY,Belarus,EURO,122,562,4,8
1878,2020-04-07T00:00:00Z,BY,Belarus,EURO,138,700,5,13
1879,2020-04-08T00:00:00Z,BY,Belarus,EURO,161,861,0,13
1880,2020-04-09T00:00:00Z,BY,Belarus,EURO,205,1066,0,13
1881,2020-04-10T00:00:00Z,BY,Belarus,EURO,0,1066,0,13
1882,2020-04-11T00:00:00Z,BY,Belarus,EURO,915,1981,6,19
1883,2020-04-12T00:00:00Z,BY,Belarus,EURO,245,2226,4,23
1884,2020-04-13T00:00:00Z,BY,Belarus,EURO,352,2578,3,26
1885,2020-04-14T00:00:00Z,BY,Belarus,EURO,341,2919,3,29
1886,2020-04-15T00:00:00Z,BY,Belarus,EURO,362,3281,4,33
1887,2020-04-16T00:00:00Z,BY,Belarus,EURO,447,3728,3,36
1888,2020-04-17T00:00:00Z,BY,Belarus,EURO,476,4204,4,40
1889,2020-04-18T00:00:00Z,BY,Belarus,EURO,575,4779,3,43
1890,2020-04-19T00:00:00Z,BY,Belarus,EURO,0,4779,2,45
1891,2020-04-20T00:00:00Z,BY,Belarus,EURO,0,4779,2,47
1892,2020-04-21T00:00:00Z,BY,Belarus,EURO,1485,6264,4,51
1893,2020-04-22T00:00:00Z,BY,Belarus,EURO,459,6723,4,55
1894,2020-04-23T00:00:00Z,BY,Belarus,EURO,558,7281,5,60
1895,2020-04-24T00:00:00Z,BY,Belarus,EURO,741,8022,0,60
1896,2020-04-25T00:00:00Z,BY,Belarus,EURO,751,8773,3,63
1897,2020-04-26T00:00:00Z,BY,Belarus,EURO,817,9590,4,67
1898,2020-04-27T00:00:00Z,BY,Belarus,EURO,873,10463,5,72
1899,2020-04-28T00:00:00Z,BY,Belarus,EURO,1745,12208,7,79
1900,2020-04-29T00:00:00Z,BY,Belarus,EURO,0,12208,0,79
1901,2020-04-30T00:00:00Z,BY,Belarus,EURO,973,13181,5,84
1902,2020-05-01T00:00:00Z,BY,Belarus,EURO,846,14027,5,89
1903,2020-05-02T00:00:00Z,BY,Belarus,EURO,890,14917,4,93
1904,2020-05-03T00:00:00Z,BY,Belarus,EURO,911,15828,4,97
1905,2020-05-04T00:00:00Z,BY,Belarus,EURO,1661,17489,6,103
1906,2020-05-05T00:00:00Z,BY,Belarus,EURO,0,17489,0,103
1907,2020-05-06T00:00:00Z,BY,Belarus,EURO,1766,19255,9,112
1908,2020-05-07T00:00:00Z,BY,Belarus,EURO,0,19255,0,112
1909,2020-05-08T00:00:00Z,BY,Belarus,EURO,913,20168,4,116
1910,2020-05-09T00:00:00Z,BY,Belarus,EURO,933,21101,5,121
1911,2020-05-10T00:00:00Z,BY,Belarus,EURO,1872,22973,10,131
1912,2020-05-11T00:00:00Z,BY,Belarus,EURO,933,23906,4,135
1913,2020-05-12T00:00:00Z,BY,Belarus,EURO,0,23906,0,135
1914,2020-05-13T00:00:00Z,BY,Belarus,EURO,1934,25840,14,149
1915,2020-05-14T00:00:00Z,BY,Belarus,EURO,0,25840,0,149
1916,2020-05-15T00:00:00Z,BY,Belarus,EURO,932,26772,2,151
1917,2020-05-16T00:00:00Z,BY,Belarus,EURO,958,27730,5,156
1918,2020-05-17T00:00:00Z,BY,Belarus,EURO,951,28681,4,160
1919,2020-05-18T00:00:00Z,BY,Belarus,EURO,969,29650,5,165
1920,2020-05-19T00:00:00Z,BY,Belarus,EURO,922,30572,6,171
1921,2020-05-20T00:00:00Z,BY,Belarus,EURO,936,31508,4,175
1922,2020-05-21T00:00:00Z,BY,Belarus,EURO,1863,33371,10,185
1923,2020-05-22T00:00:00Z,BY,Belarus,EURO,932,34303,5,190
1924,2020-05-23T00:00:00Z,BY,Belarus,EURO,0,34303,0,190
1925,2020-05-24T00:00:00Z,BY,Belarus,EURO,941,35244,4,194
1926,2020-05-25T00:00:00Z,BY,Belarus,EURO,954,36198,5,199
1927,2020-05-26T00:00:00Z,BY,Belarus,EURO,946,37144,5,204
1928,2020-05-27T00:00:00Z,BY,Belarus,EURO,915,38059,4,208
1929,2020-05-28T00:00:00Z,BY,Belarus,EURO,897,38956,6,214
1930,2020-05-29T00:00:00Z,BY,Belarus,EURO,902,39858,5,219
1931,2020-05-30T00:00:00Z,BY,Belarus,EURO,906,40764,5,224
1932,2020-05-31T00:00:00Z,BY,Belarus,EURO,894,41658,5,229
1933,2020-06-01T00:00:00Z,BY,Belarus,EURO,898,42556,6,235
1934,2020-06-02T00:00:00Z,BY,Belarus,EURO,847,43403,5,240
1935,2020-06-03T00:00:00Z,BY,Belarus,EURO,852,44255,3,243
1936,2020-06-04T00:00:00Z,BY,Belarus,EURO,861,45116,5,248
1937,2020-06-05T00:00:00Z,BY,Belarus,EURO,865,45981,5,253
1938,2020-06-06T00:00:00Z,BY,Belarus,EURO,887,46868,6,259
1939,2020-06-07T00:00:00Z,BY,Belarus,EURO,0,46868,0,259
1940,2020-06-08T00:00:00Z,BY,Belarus,EURO,1762,48630,10,269
1941,2020-06-09T00:00:00Z,BY,Belarus,EURO,823,49453,7,276
1942,2020-06-10T00:00:00Z,BY,Belarus,EURO,812,50265,6,282
1943,2020-06-11T00:00:00Z,BY,Belarus,EURO,801,51066,6,288
1944,2020-06-12T00:00:00Z,BY,Belarus,EURO,750,51816,5,293
1945,2020-06-13T00:00:00Z,BY,Belarus,EURO,704,52520,5,298
1946,2020-06-14T00:00:00Z,BY,Belarus,EURO,721,53241,5,303
1947,2020-06-15T00:00:00Z,BY,Belarus,EURO,732,53973,5,308
1948,2020-06-16T00:00:00Z,BY,Belarus,EURO,707,54680,4,312
1949,2020-06-17T00:00:00Z,BY,Belarus,EURO,689,55369,6,318
1950,2020-06-18T00:00:00Z,BY,Belarus,EURO,663,56032,6,324
1951,2020-06-19T00:00:00Z,BY,Belarus,EURO,625,56657,7,331
1952,2020-06-20T00:00:00Z,BY,Belarus,EURO,676,57333,6,337
1953,2020-02-04T00:00:00Z,BE,Belgium,EURO,1,1,0,0
1954,2020-02-05T00:00:00Z,BE,Belgium,EURO,0,1,0,0
1955,2020-02-06T00:00:00Z,BE,Belgium,EURO,0,1,0,0
1956,2020-02-07T00:00:00Z,BE,Belgium,EURO,0,1,0,0
1957,2020-02-08T00:00:00Z,BE,Belgium,EURO,0,1,0,0
1958,2020-02-09T00:00:00Z,BE,Belgium,EURO,0,1,0,0
1959,2020-02-10T00:00:00Z,BE,Belgium,EURO,0,1,0,0
1960,2020-02-11T00:00:00Z,BE,Belgium,EURO,0,1,0,0
1961,2020-02-12T00:00:00Z,BE,Belgium,EURO,0,1,0,0
1962,2020-02-13T00:00:00Z,BE,Belgium,EURO,0,1,0,0
1963,2020-02-14T00:00:00Z,BE,Belgium,EURO,0,1,0,0
1964,2020-02-15T00:00:00Z,BE,Belgium,EURO,0,1,0,0
1965,2020-02-16T00:00:00Z,BE,Belgium,EURO,0,1,0,0
1966,2020-02-17T00:00:00Z,BE,Belgium,EURO,0,1,0,0
1967,2020-02-18T00:00:00Z,BE,Belgium,EURO,0,1,0,0
1968,2020-02-19T00:00:00Z,BE,Belgium,EURO,0,1,0,0
1969,2020-02-20T00:00:00Z,BE,Belgium,EURO,0,1,0,0
1970,2020-02-21T00:00:00Z,BE,Belgium,EURO,0,1,0,0
1971,2020-02-22T00:00:00Z,BE,Belgium,EURO,0,1,0,0
1972,2020-02-23T00:00:00Z,BE,Belgium,EURO,0,1,0,0
1973,2020-02-24T00:00:00Z,BE,Belgium,EURO,0,1,0,0
1974,2020-02-25T00:00:00Z,BE,Belgium,EURO,0,1,0,0
1975,2020-02-26T00:00:00Z,BE,Belgium,EURO,0,1,0,0
1976,2020-02-27T00:00:00Z,BE,Belgium,EURO,0,1,0,0
1977,2020-02-28T00:00:00Z,BE,Belgium,EURO,0,1,0,0
1978,2020-02-29T00:00:00Z,BE,Belgium,EURO,0,1,0,0
1979,2020-03-01T00:00:00Z,BE,Belgium,EURO,0,1,0,0
1980,2020-03-02T00:00:00Z,BE,Belgium,EURO,7,8,0,0
1981,2020-03-03T00:00:00Z,BE,Belgium,EURO,0,8,0,0
1982,2020-03-04T00:00:00Z,BE,Belgium,EURO,15,23,0,0
1983,2020-03-05T00:00:00Z,BE,Belgium,EURO,27,50,0,0
1984,2020-03-06T00:00:00Z,BE,Belgium,EURO,59,109,0,0
1985,2020-03-07T00:00:00Z,BE,Belgium,EURO,60,169,0,0
1986,2020-03-08T00:00:00Z,BE,Belgium,EURO,31,200,0,0
1987,2020-03-09T00:00:00Z,BE,Belgium,EURO,0,200,0,0
1988,2020-03-10T00:00:00Z,BE,Belgium,EURO,67,267,0,0
1989,2020-03-11T00:00:00Z,BE,Belgium,EURO,0,267,0,0
1990,2020-03-12T00:00:00Z,BE,Belgium,EURO,47,314,0,0
1991,2020-03-13T00:00:00Z,BE,Belgium,EURO,285,599,0,0
1992,2020-03-14T00:00:00Z,BE,Belgium,EURO,90,689,0,0
1993,2020-03-15T00:00:00Z,BE,Belgium,EURO,197,886,0,0
1994,2020-03-16T00:00:00Z,BE,Belgium,EURO,199,1085,5,5
1995,2020-03-17T00:00:00Z,BE,Belgium,EURO,401,1486,9,14
1996,2020-03-18T00:00:00Z,BE,Belgium,EURO,0,1486,0,14
1997,2020-03-19T00:00:00Z,BE,Belgium,EURO,309,1795,0,14
1998,2020-03-20T00:00:00Z,BE,Belgium,EURO,462,2257,23,37
1999,2020-03-21T00:00:00Z,BE,Belgium,EURO,558,2815,30,67
2000,2020-03-22T00:00:00Z,BE,Belgium,EURO,0,2815,0,67
2001,2020-03-23T00:00:00Z,BE,Belgium,EURO,586,3401,8,75
2002,2020-03-24T00:00:00Z,BE,Belgium,EURO,342,3743,13,88
2003,2020-03-25T00:00:00Z,BE,Belgium,EURO,526,4269,34,122
2004,2020-03-26T00:00:00Z,BE,Belgium,EURO,668,4937,56,178
2005,2020-03-27T00:00:00Z,BE,Belgium,EURO,1298,6235,42,220
2006,2020-03-28T00:00:00Z,BE,Belgium,EURO,1049,7284,69,289
2007,2020-03-29T00:00:00Z,BE,Belgium,EURO,1850,9134,64,353
2008,2020-03-30T00:00:00Z,BE,Belgium,EURO,1702,10836,78,431
2009,2020-03-31T00:00:00Z,BE,Belgium,EURO,1063,11899,82,513
2010,2020-04-01T00:00:00Z,BE,Belgium,EURO,876,12775,192,705
2011,2020-04-02T00:00:00Z,BE,Belgium,EURO,1189,13964,123,828
2012,2020-04-03T00:00:00Z,BE,Belgium,EURO,1384,15348,183,1011
2013,2020-04-04T00:00:00Z,BE,Belgium,EURO,1422,16770,132,1143
2014,2020-04-05T00:00:00Z,BE,Belgium,EURO,1661,18431,140,1283
2015,2020-04-06T00:00:00Z,BE,Belgium,EURO,1260,19691,164,1447
2016,2020-04-07T00:00:00Z,BE,Belgium,EURO,1123,20814,185,1632
2017,2020-04-08T00:00:00Z,BE,Belgium,EURO,1380,22194,403,2035
2018,2020-04-09T00:00:00Z,BE,Belgium,EURO,1209,23403,205,2240
2019,2020-04-10T00:00:00Z,BE,Belgium,EURO,1580,24983,283,2523
2020,2020-04-11T00:00:00Z,BE,Belgium,EURO,1684,26667,496,3019
2021,2020-04-12T00:00:00Z,BE,Belgium,EURO,1351,28018,327,3346
2022,2020-04-13T00:00:00Z,BE,Belgium,EURO,1629,29647,254,3600
2023,2020-04-14T00:00:00Z,BE,Belgium,EURO,942,30589,303,3903
2024,2020-04-15T00:00:00Z,BE,Belgium,EURO,530,31119,254,4157
2025,2020-04-16T00:00:00Z,BE,Belgium,EURO,2454,33573,283,4440
2026,2020-04-17T00:00:00Z,BE,Belgium,EURO,1236,34809,417,4857
2027,2020-04-18T00:00:00Z,BE,Belgium,EURO,1329,36138,306,5163
2028,2020-04-19T00:00:00Z,BE,Belgium,EURO,1045,37183,290,5453
2029,2020-04-20T00:00:00Z,BE,Belgium,EURO,1313,38496,230,5683
2030,2020-04-21T00:00:00Z,BE,Belgium,EURO,1487,39983,145,5828
2031,2020-04-22T00:00:00Z,BE,Belgium,EURO,973,40956,170,5998
2032,2020-04-23T00:00:00Z,BE,Belgium,EURO,933,41889,264,6262
2033,2020-04-24T00:00:00Z,BE,Belgium,EURO,908,42797,228,6490
2034,2020-04-25T00:00:00Z,BE,Belgium,EURO,1496,44293,189,6679
2035,2020-04-26T00:00:00Z,BE,Belgium,EURO,1032,45325,238,6917
2036,2020-04-27T00:00:00Z,BE,Belgium,EURO,809,46134,177,7094
2037,2020-04-28T00:00:00Z,BE,Belgium,EURO,553,46687,113,7207
2038,2020-04-29T00:00:00Z,BE,Belgium,EURO,647,47334,124,7331
2039,2020-04-30T00:00:00Z,BE,Belgium,EURO,525,47859,170,7501
2040,2020-05-01T00:00:00Z,BE,Belgium,EURO,660,48519,93,7594
2041,2020-05-02T00:00:00Z,BE,Belgium,EURO,513,49032,109,7703
2042,2020-05-03T00:00:00Z,BE,Belgium,EURO,485,49517,62,7765
2043,2020-05-04T00:00:00Z,BE,Belgium,EURO,389,49906,79,7844
2044,2020-05-05T00:00:00Z,BE,Belgium,EURO,361,50267,80,7924
2045,2020-05-06T00:00:00Z,BE,Belgium,EURO,242,50509,92,8016
2046,2020-05-07T00:00:00Z,BE,Belgium,EURO,272,50781,323,8339
2047,2020-05-08T00:00:00Z,BE,Belgium,EURO,639,51420,76,8415
2048,2020-05-09T00:00:00Z,BE,Belgium,EURO,591,52011,106,8521
2049,2020-05-10T00:00:00Z,BE,Belgium,EURO,585,52596,60,8581
2050,2020-05-11T00:00:00Z,BE,Belgium,EURO,485,53081,75,8656
2051,2020-05-12T00:00:00Z,BE,Belgium,EURO,368,53449,51,8707
2052,2020-05-13T00:00:00Z,BE,Belgium,EURO,330,53779,54,8761
2053,2020-05-14T00:00:00Z,BE,Belgium,EURO,202,53981,82,8843
2054,2020-05-15T00:00:00Z,BE,Belgium,EURO,307,54288,60,8903
2055,2020-05-16T00:00:00Z,BE,Belgium,EURO,356,54644,56,8959
2056,2020-05-17T00:00:00Z,BE,Belgium,EURO,345,54989,46,9005
2057,2020-05-18T00:00:00Z,BE,Belgium,EURO,291,55280,47,9052
2058,2020-05-19T00:00:00Z,BE,Belgium,EURO,279,55559,28,9080
2059,2020-05-20T00:00:00Z,BE,Belgium,EURO,232,55791,28,9108
2060,2020-05-21T00:00:00Z,BE,Belgium,EURO,192,55983,42,9150
2061,2020-05-22T00:00:00Z,BE,Belgium,EURO,252,56235,36,9186
2062,2020-05-23T00:00:00Z,BE,Belgium,EURO,276,56511,26,9212
2063,2020-05-24T00:00:00Z,BE,Belgium,EURO,299,56810,25,9237
2064,2020-05-25T00:00:00Z,BE,Belgium,EURO,282,57092,43,9280
2065,2020-05-26T00:00:00Z,BE,Belgium,EURO,250,57342,32,9312
2066,2020-05-27T00:00:00Z,BE,Belgium,EURO,113,57455,22,9334
2067,2020-05-28T00:00:00Z,BE,Belgium,EURO,137,57592,30,9364
2068,2020-05-29T00:00:00Z,BE,Belgium,EURO,257,57849,24,9388
2069,2020-05-30T00:00:00Z,BE,Belgium,EURO,212,58061,55,9443
2070,2020-05-31T00:00:00Z,BE,Belgium,EURO,125,58186,10,9453
2071,2020-06-01T00:00:00Z,BE,Belgium,EURO,195,58381,14,9467
2072,2020-06-02T00:00:00Z,BE,Belgium,EURO,136,58517,19,9486
2073,2020-06-03T00:00:00Z,BE,Belgium,EURO,98,58615,19,9505
2074,2020-06-04T00:00:00Z,BE,Belgium,EURO,70,58685,17,9522
2075,2020-06-05T00:00:00Z,BE,Belgium,EURO,82,58767,26,9548
2076,2020-06-06T00:00:00Z,BE,Belgium,EURO,140,58907,18,9566
2077,2020-06-07T00:00:00Z,BE,Belgium,EURO,165,59072,14,9580
2078,2020-06-08T00:00:00Z,BE,Belgium,EURO,154,59226,15,9595
2079,2020-06-09T00:00:00Z,BE,Belgium,EURO,122,59348,14,9609
2080,2020-06-10T00:00:00Z,BE,Belgium,EURO,89,59437,10,9619
2081,2020-06-11T00:00:00Z,BE,Belgium,EURO,132,59569,10,9629
2082,2020-06-12T00:00:00Z,BE,Belgium,EURO,142,59711,7,9636
2083,2020-06-13T00:00:00Z,BE,Belgium,EURO,108,59819,10,9646
2084,2020-06-14T00:00:00Z,BE,Belgium,EURO,99,59918,4,9650
2085,2020-06-15T00:00:00Z,BE,Belgium,EURO,111,60029,5,9655
2086,2020-06-16T00:00:00Z,BE,Belgium,EURO,71,60100,6,9661
2087,2020-06-17T00:00:00Z,BE,Belgium,EURO,55,60155,2,9663
2088,2020-06-18T00:00:00Z,BE,Belgium,EURO,89,60244,12,9675
2089,2020-06-19T00:00:00Z,BE,Belgium,EURO,104,60348,8,9683
2090,2020-06-20T00:00:00Z,BE,Belgium,EURO,128,60476,12,9695
2658,2020-03-05T00:00:00Z,BA,Bosnia and Herzegovina,EURO,2,2,0,0
2659,2020-03-06T00:00:00Z,BA,Bosnia and Herzegovina,EURO,0,2,0,0
2660,2020-03-07T00:00:00Z,BA,Bosnia and Herzegovina,EURO,0,2,0,0
2661,2020-03-08T00:00:00Z,BA,Bosnia and Herzegovina,EURO,0,2,0,0
2662,2020-03-09T00:00:00Z,BA,Bosnia and Herzegovina,EURO,0,2,0,0
2663,2020-03-10T00:00:00Z,BA,Bosnia and Herzegovina,EURO,0,2,0,0
2664,2020-03-11T00:00:00Z,BA,Bosnia and Herzegovina,EURO,2,4,0,0
2665,2020-03-12T00:00:00Z,BA,Bosnia and Herzegovina,EURO,0,4,0,0
2666,2020-03-13T00:00:00Z,BA,Bosnia and Herzegovina,EURO,7,11,0,0
2667,2020-03-14T00:00:00Z,BA,Bosnia and Herzegovina,EURO,0,11,0,0
2668,2020-03-15T00:00:00Z,BA,Bosnia and Herzegovina,EURO,8,19,0,0
2669,2020-03-16T00:00:00Z,BA,Bosnia and Herzegovina,EURO,0,19,0,0
2670,2020-03-17T00:00:00Z,BA,Bosnia and Herzegovina,EURO,0,19,0,0
2671,2020-03-18T00:00:00Z,BA,Bosnia and Herzegovina,EURO,17,36,0,0
2672,2020-03-19T00:00:00Z,BA,Bosnia and Herzegovina,EURO,8,44,0,0
2673,2020-03-20T00:00:00Z,BA,Bosnia and Herzegovina,EURO,0,44,0,0
2674,2020-03-21T00:00:00Z,BA,Bosnia and Herzegovina,EURO,48,92,1,1
2675,2020-03-22T00:00:00Z,BA,Bosnia and Herzegovina,EURO,0,92,0,1
2676,2020-03-23T00:00:00Z,BA,Bosnia and Herzegovina,EURO,33,125,0,1
2677,2020-03-24T00:00:00Z,BA,Bosnia and Herzegovina,EURO,6,131,0,1
2678,2020-03-25T00:00:00Z,BA,Bosnia and Herzegovina,EURO,33,164,1,2
2679,2020-03-26T00:00:00Z,BA,Bosnia and Herzegovina,EURO,9,173,1,3
2680,2020-03-27T00:00:00Z,BA,Bosnia and Herzegovina,EURO,40,213,0,3
2681,2020-03-28T00:00:00Z,BA,Bosnia and Herzegovina,EURO,20,233,1,4
2682,2020-03-29T00:00:00Z,BA,Bosnia and Herzegovina,EURO,36,269,2,6
2683,2020-03-30T00:00:00Z,BA,Bosnia and Herzegovina,EURO,56,325,0,6
2684,2020-03-31T00:00:00Z,BA,Bosnia and Herzegovina,EURO,34,359,3,9
2685,2020-04-01T00:00:00Z,BA,Bosnia and Herzegovina,EURO,54,413,3,12
2686,2020-04-02T00:00:00Z,BA,Bosnia and Herzegovina,EURO,51,464,1,13
2687,2020-04-03T00:00:00Z,BA,Bosnia and Herzegovina,EURO,57,521,3,16
2688,2020-04-04T00:00:00Z,BA,Bosnia and Herzegovina,EURO,65,586,2,18
2689,2020-04-05T00:00:00Z,BA,Bosnia and Herzegovina,EURO,46,632,3,21
2690,2020-04-06T00:00:00Z,BA,Bosnia and Herzegovina,EURO,30,662,0,21
2691,2020-04-07T00:00:00Z,BA,Bosnia and Herzegovina,EURO,33,695,7,28
2692,2020-04-08T00:00:00Z,BA,Bosnia and Herzegovina,EURO,86,781,4,32
2693,2020-04-09T00:00:00Z,BA,Bosnia and Herzegovina,EURO,35,816,3,35
2694,2020-04-10T00:00:00Z,BA,Bosnia and Herzegovina,EURO,59,875,1,36
2695,2020-04-11T00:00:00Z,BA,Bosnia and Herzegovina,EURO,26,901,1,37
2696,2020-04-12T00:00:00Z,BA,Bosnia and Herzegovina,EURO,47,948,0,37
2697,2020-04-13T00:00:00Z,BA,Bosnia and Herzegovina,EURO,59,1007,1,38
2698,2020-04-14T00:00:00Z,BA,Bosnia and Herzegovina,EURO,27,1034,0,38
2699,2020-04-15T00:00:00Z,BA,Bosnia and Herzegovina,EURO,52,1086,2,40
2700,2020-04-16T00:00:00Z,BA,Bosnia and Herzegovina,EURO,30,1116,1,41
2701,2020-04-17T00:00:00Z,BA,Bosnia and Herzegovina,EURO,53,1169,1,42
2702,2020-04-18T00:00:00Z,BA,Bosnia and Herzegovina,EURO,41,1210,2,44
2703,2020-04-19T00:00:00Z,BA,Bosnia and Herzegovina,EURO,58,1268,2,46
2704,2020-04-20T00:00:00Z,BA,Bosnia and Herzegovina,EURO,18,1286,0,46
2705,2020-04-21T00:00:00Z,BA,Bosnia and Herzegovina,EURO,14,1300,3,49
2706,2020-04-22T00:00:00Z,BA,Bosnia and Herzegovina,EURO,40,1340,1,50
2707,2020-04-23T00:00:00Z,BA,Bosnia and Herzegovina,EURO,27,1367,2,52
2708,2020-04-24T00:00:00Z,BA,Bosnia and Herzegovina,EURO,46,1413,1,53
2709,2020-04-25T00:00:00Z,BA,Bosnia and Herzegovina,EURO,15,1428,1,54
2710,2020-04-26T00:00:00Z,BA,Bosnia and Herzegovina,EURO,57,1485,2,56
2711,2020-04-27T00:00:00Z,BA,Bosnia and Herzegovina,EURO,31,1516,2,58
2712,2020-04-28T00:00:00Z,BA,Bosnia and Herzegovina,EURO,48,1564,2,60
2713,2020-04-29T00:00:00Z,BA,Bosnia and Herzegovina,EURO,24,1588,2,62
2714,2020-04-30T00:00:00Z,BA,Bosnia and Herzegovina,EURO,101,1689,2,64
2715,2020-05-01T00:00:00Z,BA,Bosnia and Herzegovina,EURO,93,1782,5,69
2716,2020-05-02T00:00:00Z,BA,Bosnia and Herzegovina,EURO,58,1840,2,71
2717,2020-05-03T00:00:00Z,BA,Bosnia and Herzegovina,EURO,0,1840,0,71
2718,2020-05-04T00:00:00Z,BA,Bosnia and Herzegovina,EURO,17,1857,5,76
2719,2020-05-05T00:00:00Z,BA,Bosnia and Herzegovina,EURO,69,1926,1,77
2720,2020-05-06T00:00:00Z,BA,Bosnia and Herzegovina,EURO,42,1968,5,82
2721,2020-05-07T00:00:00Z,BA,Bosnia and Herzegovina,EURO,49,2017,5,87
2722,2020-05-08T00:00:00Z,BA,Bosnia and Herzegovina,EURO,10,2027,2,89
2723,2020-05-09T00:00:00Z,BA,Bosnia and Herzegovina,EURO,43,2070,8,97
2724,2020-05-10T00:00:00Z,BA,Bosnia and Herzegovina,EURO,0,2070,0,97
2725,2020-05-11T00:00:00Z,BA,Bosnia and Herzegovina,EURO,28,2098,6,103
2726,2020-05-12T00:00:00Z,BA,Bosnia and Herzegovina,EURO,44,2142,9,112
2727,2020-05-13T00:00:00Z,BA,Bosnia and Herzegovina,EURO,20,2162,4,116
2728,2020-05-14T00:00:00Z,BA,Bosnia and Herzegovina,EURO,19,2181,3,119
2729,2020-05-15T00:00:00Z,BA,Bosnia and Herzegovina,EURO,35,2216,4,123
2730,2020-05-16T00:00:00Z,BA,Bosnia and Herzegovina,EURO,21,2237,4,127
2731,2020-05-17T00:00:00Z,BA,Bosnia and Herzegovina,EURO,28,2265,4,131
2732,2020-05-18T00:00:00Z,BA,Bosnia and Herzegovina,EURO,24,2289,1,132
2733,2020-05-19T00:00:00Z,BA,Bosnia and Herzegovina,EURO,14,2303,0,132
2734,2020-05-20T00:00:00Z,BA,Bosnia and Herzegovina,EURO,16,2319,1,133
2735,2020-05-21T00:00:00Z,BA,Bosnia and Herzegovina,EURO,15,2334,2,135
2736,2020-05-22T00:00:00Z,BA,Bosnia and Herzegovina,EURO,18,2352,4,139
2737,2020-05-23T00:00:00Z,BA,Bosnia and Herzegovina,EURO,19,2371,1,140
2738,2020-05-24T00:00:00Z,BA,Bosnia and Herzegovina,EURO,0,2371,0,140
2739,2020-05-25T00:00:00Z,BA,Bosnia and Herzegovina,EURO,20,2391,1,141
2740,2020-05-26T00:00:00Z,BA,Bosnia and Herzegovina,EURO,14,2405,4,145
2741,2020-05-27T00:00:00Z,BA,Bosnia and Herzegovina,EURO,10,2415,4,149
2742,2020-05-28T00:00:00Z,BA,Bosnia and Herzegovina,EURO,0,2415,0,149
2743,2020-05-29T00:00:00Z,BA,Bosnia and Herzegovina,EURO,47,2462,3,152
2744,2020-05-30T00:00:00Z,BA,Bosnia and Herzegovina,EURO,22,2484,0,152
2745,2020-05-31T00:00:00Z,BA,Bosnia and Herzegovina,EURO,9,2493,0,152
2746,2020-06-01T00:00:00Z,BA,Bosnia and Herzegovina,EURO,16,2509,0,152
2747,2020-06-02T00:00:00Z,BA,Bosnia and Herzegovina,EURO,14,2523,1,153
2748,2020-06-03T00:00:00Z,BA,Bosnia and Herzegovina,EURO,11,2534,3,156
2749,2020-06-04T00:00:00Z,BA,Bosnia and Herzegovina,EURO,16,2550,0,156
2750,2020-06-05T00:00:00Z,BA,Bosnia and Herzegovina,EURO,43,2593,2,158
2751,2020-06-06T00:00:00Z,BA,Bosnia and Herzegovina,EURO,12,2605,0,158
2752,2020-06-07T00:00:00Z,BA,Bosnia and Herzegovina,EURO,40,2645,0,158
2753,2020-06-08T00:00:00Z,BA,Bosnia and Herzegovina,EURO,28,2673,1,159
2754,2020-06-09T00:00:00Z,BA,Bosnia and Herzegovina,EURO,30,2703,0,159
2755,2020-06-10T00:00:00Z,BA,Bosnia and Herzegovina,EURO,24,2727,0,159
2756,2020-06-11T00:00:00Z,BA,Bosnia and Herzegovina,EURO,49,2776,1,160
2757,2020-06-12T00:00:00Z,BA,Bosnia and Herzegovina,EURO,55,2831,0,160
2758,2020-06-13T00:00:00Z,BA,Bosnia and Herzegovina,EURO,61,2892,2,162
2759,2020-06-14T00:00:00Z,BA,Bosnia and Herzegovina,EURO,0,2892,0,162
2760,2020-06-15T00:00:00Z,BA,Bosnia and Herzegovina,EURO,109,3001,1,163
2761,2020-06-16T00:00:00Z,BA,Bosnia and Herzegovina,EURO,38,3039,1,164
2762,2020-06-17T00:00:00Z,BA,Bosnia and Herzegovina,EURO,45,3084,3,167
2763,2020-06-18T00:00:00Z,BA,Bosnia and Herzegovina,EURO,60,3144,0,167
2764,2020-06-19T00:00:00Z,BA,Bosnia and Herzegovina,EURO,58,3202,0,167
2765,2020-06-20T00:00:00Z,BA,Bosnia and Herzegovina,EURO,86,3288,1,168
3153,2020-03-08T00:00:00Z,BG,Bulgaria,EURO,4,4,0,0
3154,2020-03-09T00:00:00Z,BG,Bulgaria,EURO,0,4,0,0
3155,2020-03-10T00:00:00Z,BG,Bulgaria,EURO,0,4,0,0
3156,2020-03-11T00:00:00Z,BG,Bulgaria,EURO,3,7,0,0
3157,2020-03-12T00:00:00Z,BG,Bulgaria,EURO,0,7,1,1
3158,2020-03-13T00:00:00Z,BG,Bulgaria,EURO,0,7,0,1
3159,2020-03-14T00:00:00Z,BG,Bulgaria,EURO,0,7,0,1
3160,2020-03-15T00:00:00Z,BG,Bulgaria,EURO,44,51,1,2
3161,2020-03-16T00:00:00Z,BG,Bulgaria,EURO,16,67,0,2
3162,2020-03-17T00:00:00Z,BG,Bulgaria,EURO,14,81,0,2
3163,2020-03-18T00:00:00Z,BG,Bulgaria,EURO,11,92,0,2
3164,2020-03-19T00:00:00Z,BG,Bulgaria,EURO,2,94,1,3
3165,2020-03-20T00:00:00Z,BG,Bulgaria,EURO,33,127,0,3
3166,2020-03-21T00:00:00Z,BG,Bulgaria,EURO,36,163,0,3
3167,2020-03-22T00:00:00Z,BG,Bulgaria,EURO,0,163,0,3
3168,2020-03-23T00:00:00Z,BG,Bulgaria,EURO,22,185,0,3
3169,2020-03-24T00:00:00Z,BG,Bulgaria,EURO,16,201,0,3
3170,2020-03-25T00:00:00Z,BG,Bulgaria,EURO,19,220,0,3
3171,2020-03-26T00:00:00Z,BG,Bulgaria,EURO,22,242,0,3
3172,2020-03-27T00:00:00Z,BG,Bulgaria,EURO,22,264,0,3
3173,2020-03-28T00:00:00Z,BG,Bulgaria,EURO,29,293,0,3
3174,2020-03-29T00:00:00Z,BG,Bulgaria,EURO,38,331,4,7
3175,2020-03-30T00:00:00Z,BG,Bulgaria,EURO,15,346,1,8
3176,2020-03-31T00:00:00Z,BG,Bulgaria,EURO,13,359,0,8
3177,2020-04-01T00:00:00Z,BG,Bulgaria,EURO,40,399,0,8
3178,2020-04-02T00:00:00Z,BG,Bulgaria,EURO,23,422,2,10
3179,2020-04-03T00:00:00Z,BG,Bulgaria,EURO,35,457,0,10
3180,2020-04-04T00:00:00Z,BG,Bulgaria,EURO,28,485,4,14
3181,2020-04-05T00:00:00Z,BG,Bulgaria,EURO,18,503,3,17
3182,2020-04-06T00:00:00Z,BG,Bulgaria,EURO,28,531,3,20
3183,2020-04-07T00:00:00Z,BG,Bulgaria,EURO,18,549,2,22
3184,2020-04-08T00:00:00Z,BG,Bulgaria,EURO,28,577,1,23
3185,2020-04-09T00:00:00Z,BG,Bulgaria,EURO,16,593,1,24
3186,2020-04-10T00:00:00Z,BG,Bulgaria,EURO,31,624,0,24
3187,2020-04-11T00:00:00Z,BG,Bulgaria,EURO,11,635,1,25
3188,2020-04-12T00:00:00Z,BG,Bulgaria,EURO,26,661,3,28
3189,2020-04-13T00:00:00Z,BG,Bulgaria,EURO,14,675,1,29
3190,2020-04-14T00:00:00Z,BG,Bulgaria,EURO,10,685,3,32
3191,2020-04-15T00:00:00Z,BG,Bulgaria,EURO,28,713,3,35
3192,2020-04-16T00:00:00Z,BG,Bulgaria,EURO,34,747,1,36
3193,2020-04-17T00:00:00Z,BG,Bulgaria,EURO,53,800,2,38
3194,2020-04-18T00:00:00Z,BG,Bulgaria,EURO,46,846,3,41
3195,2020-04-19T00:00:00Z,BG,Bulgaria,EURO,32,878,0,41
3196,2020-04-20T00:00:00Z,BG,Bulgaria,EURO,37,915,2,43
3197,2020-04-21T00:00:00Z,BG,Bulgaria,EURO,14,929,0,43
3198,2020-04-22T00:00:00Z,BG,Bulgaria,EURO,46,975,2,45
3199,2020-04-23T00:00:00Z,BG,Bulgaria,EURO,49,1024,4,49
3200,2020-04-24T00:00:00Z,BG,Bulgaria,EURO,73,1097,3,52
3201,2020-04-25T00:00:00Z,BG,Bulgaria,EURO,91,1188,2,54
3202,2020-04-26T00:00:00Z,BG,Bulgaria,EURO,59,1247,1,55
3203,2020-04-27T00:00:00Z,BG,Bulgaria,EURO,53,1300,1,56
3204,2020-04-28T00:00:00Z,BG,Bulgaria,EURO,63,1363,2,58
3205,2020-04-29T00:00:00Z,BG,Bulgaria,EURO,36,1399,0,58
3206,2020-04-30T00:00:00Z,BG,Bulgaria,EURO,48,1447,6,64
3207,2020-05-01T00:00:00Z,BG,Bulgaria,EURO,59,1506,2,66
3208,2020-05-02T00:00:00Z,BG,Bulgaria,EURO,82,1588,3,69
3209,2020-05-03T00:00:00Z,BG,Bulgaria,EURO,6,1594,3,72
3210,2020-05-04T00:00:00Z,BG,Bulgaria,EURO,24,1618,1,73
3211,2020-05-05T00:00:00Z,BG,Bulgaria,EURO,34,1652,5,78
3212,2020-05-06T00:00:00Z,BG,Bulgaria,EURO,37,1689,0,78
3213,2020-05-07T00:00:00Z,BG,Bulgaria,EURO,89,1778,6,84
3214,2020-05-08T00:00:00Z,BG,Bulgaria,EURO,51,1829,0,84
3215,2020-05-09T00:00:00Z,BG,Bulgaria,EURO,82,1911,4,88
3216,2020-05-10T00:00:00Z,BG,Bulgaria,EURO,44,1955,2,90
3217,2020-05-11T00:00:00Z,BG,Bulgaria,EURO,10,1965,1,91
3218,2020-05-12T00:00:00Z,BG,Bulgaria,EURO,25,1990,2,93
3219,2020-05-13T00:00:00Z,BG,Bulgaria,EURO,33,2023,2,95
3220,2020-05-14T00:00:00Z,BG,Bulgaria,EURO,46,2069,1,96
3221,2020-05-15T00:00:00Z,BG,Bulgaria,EURO,31,2100,3,99
3222,2020-05-16T00:00:00Z,BG,Bulgaria,EURO,38,2138,3,102
3223,2020-05-17T00:00:00Z,BG,Bulgaria,EURO,73,2211,6,108
3224,2020-05-18T00:00:00Z,BG,Bulgaria,EURO,24,2235,2,110
3225,2020-05-19T00:00:00Z,BG,Bulgaria,EURO,24,2259,2,112
3226,2020-05-20T00:00:00Z,BG,Bulgaria,EURO,33,2292,4,116
3227,2020-05-21T00:00:00Z,BG,Bulgaria,EURO,39,2331,4,120
3228,2020-05-22T00:00:00Z,BG,Bulgaria,EURO,41,2372,5,125
3229,2020-05-23T00:00:00Z,BG,Bulgaria,EURO,36,2408,1,126
3230,2020-05-24T00:00:00Z,BG,Bulgaria,EURO,0,2408,0,126
3231,2020-05-25T00:00:00Z,BG,Bulgaria,EURO,25,2433,4,130
3232,2020-05-26T00:00:00Z,BG,Bulgaria,EURO,0,2433,0,130
3233,2020-05-27T00:00:00Z,BG,Bulgaria,EURO,27,2460,3,133
3234,2020-05-28T00:00:00Z,BG,Bulgaria,EURO,0,2460,0,133
3235,2020-05-29T00:00:00Z,BG,Bulgaria,EURO,25,2485,3,136
3236,2020-05-30T00:00:00Z,BG,Bulgaria,EURO,14,2499,3,139
3237,2020-05-31T00:00:00Z,BG,Bulgaria,EURO,14,2513,1,140
3238,2020-06-01T00:00:00Z,BG,Bulgaria,EURO,0,2513,0,140
3239,2020-06-02T00:00:00Z,BG,Bulgaria,EURO,0,2513,4,144
3240,2020-06-03T00:00:00Z,BG,Bulgaria,EURO,25,2538,0,144
3241,2020-06-04T00:00:00Z,BG,Bulgaria,EURO,47,2585,3,147
3242,2020-06-05T00:00:00Z,BG,Bulgaria,EURO,0,2585,0,147
3243,2020-06-06T00:00:00Z,BG,Bulgaria,EURO,83,2668,13,160
3244,2020-06-07T00:00:00Z,BG,Bulgaria,EURO,43,2711,0,160
3245,2020-06-08T00:00:00Z,BG,Bulgaria,EURO,16,2727,0,160
3246,2020-06-09T00:00:00Z,BG,Bulgaria,EURO,83,2810,4,164
3247,2020-06-10T00:00:00Z,BG,Bulgaria,EURO,79,2889,3,167
3248,2020-06-11T00:00:00Z,BG,Bulgaria,EURO,0,2889,0,167
3249,2020-06-12T00:00:00Z,BG,Bulgaria,EURO,197,3086,1,168
3250,2020-06-13T00:00:00Z,BG,Bulgaria,EURO,105,3191,4,172
3251,2020-06-14T00:00:00Z,BG,Bulgaria,EURO,75,3266,0,172
3252,2020-06-15T00:00:00Z,BG,Bulgaria,EURO,24,3290,2,174
3253,2020-06-16T00:00:00Z,BG,Bulgaria,EURO,51,3341,2,176
3254,2020-06-17T00:00:00Z,BG,Bulgaria,EURO,112,3453,5,181
3255,2020-06-18T00:00:00Z,BG,Bulgaria,EURO,89,3542,3,184
3256,2020-06-19T00:00:00Z,BG,Bulgaria,EURO,132,3674,6,190
3257,2020-06-20T00:00:00Z,BG,Bulgaria,EURO,81,3755,3,193
4961,2020-02-25T00:00:00Z,HR,Croatia,EURO,1,1,0,0
4962,2020-02-26T00:00:00Z,HR,Croatia,EURO,2,3,0,0
4963,2020-02-27T00:00:00Z,HR,Croatia,EURO,0,3,0,0
4964,2020-02-28T00:00:00Z,HR,Croatia,EURO,2,5,0,0
4965,2020-02-29T00:00:00Z,HR,Croatia,EURO,2,7,0,0
4966,2020-03-01T00:00:00Z,HR,Croatia,EURO,0,7,0,0
4967,2020-03-02T00:00:00Z,HR,Croatia,EURO,1,8,0,0
4968,2020-03-03T00:00:00Z,HR,Croatia,EURO,1,9,0,0
4969,2020-03-04T00:00:00Z,HR,Croatia,EURO,0,9,0,0
4970,2020-03-05T00:00:00Z,HR,Croatia,EURO,1,10,0,0
4971,2020-03-06T00:00:00Z,HR,Croatia,EURO,1,11,0,0
4972,2020-03-07T00:00:00Z,HR,Croatia,EURO,0,11,0,0
4973,2020-03-08T00:00:00Z,HR,Croatia,EURO,0,11,0,0
4974,2020-03-09T00:00:00Z,HR,Croatia,EURO,1,12,0,0
4975,2020-03-10T00:00:00Z,HR,Croatia,EURO,0,12,0,0
4976,2020-03-11T00:00:00Z,HR,Croatia,EURO,8,20,0,0
4977,2020-03-12T00:00:00Z,HR,Croatia,EURO,0,20,0,0
4978,2020-03-13T00:00:00Z,HR,Croatia,EURO,11,31,0,0
4979,2020-03-14T00:00:00Z,HR,Croatia,EURO,0,31,0,0
4980,2020-03-15T00:00:00Z,HR,Croatia,EURO,6,37,0,0
4981,2020-03-16T00:00:00Z,HR,Croatia,EURO,19,56,0,0
4982,2020-03-17T00:00:00Z,HR,Croatia,EURO,9,65,0,0
4983,2020-03-18T00:00:00Z,HR,Croatia,EURO,16,81,0,0
4984,2020-03-19T00:00:00Z,HR,Croatia,EURO,0,81,0,0
4985,2020-03-20T00:00:00Z,HR,Croatia,EURO,45,126,0,0
4986,2020-03-21T00:00:00Z,HR,Croatia,EURO,80,206,0,0
4987,2020-03-22T00:00:00Z,HR,Croatia,EURO,0,206,0,0
4988,2020-03-23T00:00:00Z,HR,Croatia,EURO,29,235,0,0
4989,2020-03-24T00:00:00Z,HR,Croatia,EURO,71,306,0,0
4990,2020-03-25T00:00:00Z,HR,Croatia,EURO,76,382,1,1
4991,2020-03-26T00:00:00Z,HR,Croatia,EURO,36,418,0,1
4992,2020-03-27T00:00:00Z,HR,Croatia,EURO,77,495,1,2
4993,2020-03-28T00:00:00Z,HR,Croatia,EURO,91,586,1,3
4994,2020-03-29T00:00:00Z,HR,Croatia,EURO,71,657,2,5
4995,2020-03-30T00:00:00Z,HR,Croatia,EURO,56,713,1,6
4996,2020-03-31T00:00:00Z,HR,Croatia,EURO,77,790,0,6
4997,2020-04-01T00:00:00Z,HR,Croatia,EURO,77,867,0,6
4998,2020-04-02T00:00:00Z,HR,Croatia,EURO,96,963,0,6
4999,2020-04-03T00:00:00Z,HR,Croatia,EURO,48,1011,1,7
5000,2020-04-04T00:00:00Z,HR,Croatia,EURO,68,1079,1,8
5001,2020-04-05T00:00:00Z,HR,Croatia,EURO,47,1126,4,12
5002,2020-04-06T00:00:00Z,HR,Croatia,EURO,56,1182,3,15
5003,2020-04-07T00:00:00Z,HR,Croatia,EURO,40,1222,1,16
5004,2020-04-08T00:00:00Z,HR,Croatia,EURO,60,1282,2,18
5005,2020-04-09T00:00:00Z,HR,Croatia,EURO,61,1343,1,19
5006,2020-04-10T00:00:00Z,HR,Croatia,EURO,64,1407,1,20
5007,2020-04-11T00:00:00Z,HR,Croatia,EURO,88,1495,1,21
5008,2020-04-12T00:00:00Z,HR,Croatia,EURO,39,1534,0,21
5009,2020-04-13T00:00:00Z,HR,Croatia,EURO,66,1600,2,23
5010,2020-04-14T00:00:00Z,HR,Croatia,EURO,50,1650,2,25
5011,2020-04-15T00:00:00Z,HR,Croatia,EURO,54,1704,6,31
5012,2020-04-16T00:00:00Z,HR,Croatia,EURO,37,1741,3,34
5013,2020-04-17T00:00:00Z,HR,Croatia,EURO,50,1791,1,35
5014,2020-04-18T00:00:00Z,HR,Croatia,EURO,23,1814,1,36
5015,2020-04-19T00:00:00Z,HR,Croatia,EURO,18,1832,3,39
5016,2020-04-20T00:00:00Z,HR,Croatia,EURO,39,1871,8,47
5017,2020-04-21T00:00:00Z,HR,Croatia,EURO,10,1881,0,47
5018,2020-04-22T00:00:00Z,HR,Croatia,EURO,27,1908,1,48
5019,2020-04-23T00:00:00Z,HR,Croatia,EURO,42,1950,0,48
5020,2020-04-24T00:00:00Z,HR,Croatia,EURO,31,1981,2,50
5021,2020-04-25T00:00:00Z,HR,Croatia,EURO,28,2009,1,51
5022,2020-04-26T00:00:00Z,HR,Croatia,EURO,7,2016,3,54
5023,2020-04-27T00:00:00Z,HR,Croatia,EURO,14,2030,1,55
5024,2020-04-28T00:00:00Z,HR,Croatia,EURO,9,2039,4,59
5025,2020-04-29T00:00:00Z,HR,Croatia,EURO,8,2047,4,63
5026,2020-04-30T00:00:00Z,HR,Croatia,EURO,15,2062,4,67
5027,2020-05-01T00:00:00Z,HR,Croatia,EURO,14,2076,2,69
5028,2020-05-02T00:00:00Z,HR,Croatia,EURO,9,2085,6,75
5029,2020-05-03T00:00:00Z,HR,Croatia,EURO,3,2088,2,77
5030,2020-05-04T00:00:00Z,HR,Croatia,EURO,8,2096,2,79
5031,2020-05-05T00:00:00Z,HR,Croatia,EURO,5,2101,1,80
5032,2020-05-06T00:00:00Z,HR,Croatia,EURO,11,2112,3,83
5033,2020-05-07T00:00:00Z,HR,Croatia,EURO,7,2119,2,85
5034,2020-05-08T00:00:00Z,HR,Croatia,EURO,6,2125,1,86
5035,2020-05-09T00:00:00Z,HR,Croatia,EURO,36,2161,0,86
5036,2020-05-10T00:00:00Z,HR,Croatia,EURO,15,2176,1,87
5037,2020-05-11T00:00:00Z,HR,Croatia,EURO,11,2187,3,90
5038,2020-05-12T00:00:00Z,HR,Croatia,EURO,9,2196,1,91
5039,2020-05-13T00:00:00Z,HR,Croatia,EURO,11,2207,0,91
5040,2020-05-14T00:00:00Z,HR,Croatia,EURO,6,2213,3,94
5041,2020-05-15T00:00:00Z,HR,Croatia,EURO,8,2221,0,94
5042,2020-05-16T00:00:00Z,HR,Croatia,EURO,1,2222,1,95
5043,2020-05-17T00:00:00Z,HR,Croatia,EURO,2,2224,0,95
5044,2020-05-18T00:00:00Z,HR,Croatia,EURO,2,2226,0,95
5045,2020-05-19T00:00:00Z,HR,Croatia,EURO,2,2228,0,95
5046,2020-05-20T00:00:00Z,HR,Croatia,EURO,4,2232,1,96
5047,2020-05-21T00:00:00Z,HR,Croatia,EURO,2,2234,0,96
5048,2020-05-22T00:00:00Z,HR,Croatia,EURO,3,2237,1,97
5049,2020-05-23T00:00:00Z,HR,Croatia,EURO,6,2243,2,99
5050,2020-05-24T00:00:00Z,HR,Croatia,EURO,0,2243,0,99
5051,2020-05-25T00:00:00Z,HR,Croatia,EURO,1,2244,0,99
5052,2020-05-26T00:00:00Z,HR,Croatia,EURO,0,2244,1,100
5053,2020-05-27T00:00:00Z,HR,Croatia,EURO,0,2244,1,101
5054,2020-05-28T00:00:00Z,HR,Croatia,EURO,0,2244,0,101
5055,2020-05-29T00:00:00Z,HR,Croatia,EURO,1,2245,1,102
5056,2020-05-30T00:00:00Z,HR,Croatia,EURO,0,2245,1,103
5057,2020-05-31T00:00:00Z,HR,Croatia,EURO,1,2246,0,103
5058,2020-06-01T00:00:00Z,HR,Croatia,EURO,0,2246,0,103
5059,2020-06-02T00:00:00Z,HR,Croatia,EURO,0,2246,0,103
5060,2020-06-03T00:00:00Z,HR,Croatia,EURO,0,2246,0,103
5061,2020-06-04T00:00:00Z,HR,Croatia,EURO,0,2246,0,103
5062,2020-06-05T00:00:00Z,HR,Croatia,EURO,1,2247,0,103
5063,2020-06-06T00:00:00Z,HR,Croatia,EURO,0,2247,0,103
5064,2020-06-07T00:00:00Z,HR,Croatia,EURO,0,2247,1,104
5065,2020-06-08T00:00:00Z,HR,Croatia,EURO,0,2247,0,104
5066,2020-06-09T00:00:00Z,HR,Croatia,EURO,0,2247,0,104
5067,2020-06-10T00:00:00Z,HR,Croatia,EURO,0,2247,2,106
5068,2020-06-11T00:00:00Z,HR,Croatia,EURO,2,2249,0,106
5069,2020-06-12T00:00:00Z,HR,Croatia,EURO,0,2249,0,106
5070,2020-06-13T00:00:00Z,HR,Croatia,EURO,0,2249,1,107
5071,2020-06-14T00:00:00Z,HR,Croatia,EURO,2,2251,0,107
5072,2020-06-15T00:00:00Z,HR,Croatia,EURO,1,2252,0,107
5073,2020-06-16T00:00:00Z,HR,Croatia,EURO,2,2254,0,107
5074,2020-06-17T00:00:00Z,HR,Croatia,EURO,1,2255,0,107
5075,2020-06-18T00:00:00Z,HR,Croatia,EURO,3,2258,0,107
5076,2020-06-19T00:00:00Z,HR,Croatia,EURO,11,2269,0,107
5077,2020-06-20T00:00:00Z,HR,Croatia,EURO,11,2280,0,107
5278,2020-03-09T00:00:00Z,CY,Cyprus,EURO,2,2,0,0
5279,2020-03-10T00:00:00Z,CY,Cyprus,EURO,0,2,0,0
5280,2020-03-11T00:00:00Z,CY,Cyprus,EURO,0,2,0,0
5281,2020-03-12T00:00:00Z,CY,Cyprus,EURO,4,6,0,0
5282,2020-03-13T00:00:00Z,CY,Cyprus,EURO,8,14,0,0
5283,2020-03-14T00:00:00Z,CY,Cyprus,EURO,7,21,0,0
5284,2020-03-15T00:00:00Z,CY,Cyprus,EURO,9,30,0,0
5285,2020-03-16T00:00:00Z,CY,Cyprus,EURO,3,33,0,0
5286,2020-03-17T00:00:00Z,CY,Cyprus,EURO,0,33,0,0
5287,2020-03-18T00:00:00Z,CY,Cyprus,EURO,25,58,0,0
5288,2020-03-19T00:00:00Z,CY,Cyprus,EURO,0,58,0,0
5289,2020-03-20T00:00:00Z,CY,Cyprus,EURO,9,67,0,0
5290,2020-03-21T00:00:00Z,CY,Cyprus,EURO,17,84,0,0
5291,2020-03-22T00:00:00Z,CY,Cyprus,EURO,0,84,0,0
5292,2020-03-23T00:00:00Z,CY,Cyprus,EURO,11,95,0,0
5293,2020-03-24T00:00:00Z,CY,Cyprus,EURO,21,116,0,0
5294,2020-03-25T00:00:00Z,CY,Cyprus,EURO,8,124,3,3
5295,2020-03-26T00:00:00Z,CY,Cyprus,EURO,8,132,0,3
5296,2020-03-27T00:00:00Z,CY,Cyprus,EURO,14,146,0,3
5297,2020-03-28T00:00:00Z,CY,Cyprus,EURO,16,162,2,5
5298,2020-03-29T00:00:00Z,CY,Cyprus,EURO,17,179,0,5
5299,2020-03-30T00:00:00Z,CY,Cyprus,EURO,35,214,1,6
5300,2020-03-31T00:00:00Z,CY,Cyprus,EURO,16,230,1,7
5301,2020-04-01T00:00:00Z,CY,Cyprus,EURO,32,262,1,8
5302,2020-04-02T00:00:00Z,CY,Cyprus,EURO,58,320,1,9
5303,2020-04-03T00:00:00Z,CY,Cyprus,EURO,36,356,0,9
5304,2020-04-04T00:00:00Z,CY,Cyprus,EURO,40,396,2,11
5305,2020-04-05T00:00:00Z,CY,Cyprus,EURO,30,426,0,11
5306,2020-04-06T00:00:00Z,CY,Cyprus,EURO,20,446,3,14
5307,2020-04-07T00:00:00Z,CY,Cyprus,EURO,19,465,0,14
5308,2020-04-08T00:00:00Z,CY,Cyprus,EURO,29,494,0,14
5309,2020-04-09T00:00:00Z,CY,Cyprus,EURO,32,526,0,14
5310,2020-04-10T00:00:00Z,CY,Cyprus,EURO,38,564,1,15
5311,2020-04-11T00:00:00Z,CY,Cyprus,EURO,31,595,0,15
5312,2020-04-12T00:00:00Z,CY,Cyprus,EURO,21,616,0,15
5313,2020-04-13T00:00:00Z,CY,Cyprus,EURO,17,633,1,16
5314,2020-04-14T00:00:00Z,CY,Cyprus,EURO,29,662,1,17
5315,2020-04-15T00:00:00Z,CY,Cyprus,EURO,33,695,0,17
5316,2020-04-16T00:00:00Z,CY,Cyprus,EURO,20,715,0,17
5317,2020-04-17T00:00:00Z,CY,Cyprus,EURO,20,735,0,17
5318,2020-04-18T00:00:00Z,CY,Cyprus,EURO,0,735,0,17
5319,2020-04-19T00:00:00Z,CY,Cyprus,EURO,26,761,0,17
5320,2020-04-20T00:00:00Z,CY,Cyprus,EURO,6,767,0,17
5321,2020-04-21T00:00:00Z,CY,Cyprus,EURO,5,772,0,17
5322,2020-04-22T00:00:00Z,CY,Cyprus,EURO,12,784,0,17
5323,2020-04-23T00:00:00Z,CY,Cyprus,EURO,6,790,0,17
5324,2020-04-24T00:00:00Z,CY,Cyprus,EURO,5,795,0,17
5325,2020-04-25T00:00:00Z,CY,Cyprus,EURO,9,804,0,17
5326,2020-04-26T00:00:00Z,CY,Cyprus,EURO,6,810,0,17
5327,2020-04-27T00:00:00Z,CY,Cyprus,EURO,7,817,0,17
5328,2020-04-28T00:00:00Z,CY,Cyprus,EURO,5,822,3,20
5329,2020-04-29T00:00:00Z,CY,Cyprus,EURO,15,837,0,20
5330,2020-04-30T00:00:00Z,CY,Cyprus,EURO,6,843,0,20
5331,2020-05-01T00:00:00Z,CY,Cyprus,EURO,7,850,0,20
5332,2020-05-02T00:00:00Z,CY,Cyprus,EURO,7,857,0,20
5333,2020-05-03T00:00:00Z,CY,Cyprus,EURO,7,864,0,20
5334,2020-05-04T00:00:00Z,CY,Cyprus,EURO,8,872,0,20
5335,2020-05-05T00:00:00Z,CY,Cyprus,EURO,2,874,0,20
5336,2020-05-06T00:00:00Z,CY,Cyprus,EURO,4,878,0,20
5337,2020-05-07T00:00:00Z,CY,Cyprus,EURO,5,883,1,21
5338,2020-05-08T00:00:00Z,CY,Cyprus,EURO,6,889,0,21
5339,2020-05-09T00:00:00Z,CY,Cyprus,EURO,2,891,0,21
5340,2020-05-10T00:00:00Z,CY,Cyprus,EURO,1,892,0,21
5341,2020-05-11T00:00:00Z,CY,Cyprus,EURO,6,898,1,22
5342,2020-05-12T00:00:00Z,CY,Cyprus,EURO,3,901,0,22
5343,2020-05-13T00:00:00Z,CY,Cyprus,EURO,2,903,1,23
5344,2020-05-14T00:00:00Z,CY,Cyprus,EURO,2,905,-6,17
5345,2020-05-15T00:00:00Z,CY,Cyprus,EURO,2,907,0,17
5346,2020-05-16T00:00:00Z,CY,Cyprus,EURO,3,910,0,17
5347,2020-05-17T00:00:00Z,CY,Cyprus,EURO,4,914,0,17
5348,2020-05-18T00:00:00Z,CY,Cyprus,EURO,2,916,0,17
5349,2020-05-19T00:00:00Z,CY,Cyprus,EURO,1,917,0,17
5350,2020-05-20T00:00:00Z,CY,Cyprus,EURO,1,918,0,17
5351,2020-05-21T00:00:00Z,CY,Cyprus,EURO,4,922,0,17
5352,2020-05-22T00:00:00Z,CY,Cyprus,EURO,1,923,0,17
5353,2020-05-23T00:00:00Z,CY,Cyprus,EURO,4,927,0,17
5354,2020-05-24T00:00:00Z,CY,Cyprus,EURO,0,927,0,17
5355,2020-05-25T00:00:00Z,CY,Cyprus,EURO,8,935,0,17
5356,2020-05-26T00:00:00Z,CY,Cyprus,EURO,2,937,0,17
5357,2020-05-27T00:00:00Z,CY,Cyprus,EURO,2,939,0,17
5358,2020-05-28T00:00:00Z,CY,Cyprus,EURO,0,939,0,17
5359,2020-05-29T00:00:00Z,CY,Cyprus,EURO,2,941,0,17
5360,2020-05-30T00:00:00Z,CY,Cyprus,EURO,0,941,0,17
5361,2020-05-31T00:00:00Z,CY,Cyprus,EURO,2,943,0,17
5362,2020-06-01T00:00:00Z,CY,Cyprus,EURO,1,944,0,17
5363,2020-06-02T00:00:00Z,CY,Cyprus,EURO,5,949,0,17
5364,2020-06-03T00:00:00Z,CY,Cyprus,EURO,3,952,0,17
5365,2020-06-04T00:00:00Z,CY,Cyprus,EURO,6,958,0,17
5366,2020-06-05T00:00:00Z,CY,Cyprus,EURO,0,958,0,17
5367,2020-06-06T00:00:00Z,CY,Cyprus,EURO,2,960,0,17
5368,2020-06-07T00:00:00Z,CY,Cyprus,EURO,0,960,1,18
5369,2020-06-08T00:00:00Z,CY,Cyprus,EURO,4,964,0,18
5370,2020-06-09T00:00:00Z,CY,Cyprus,EURO,6,970,0,18
5371,2020-06-10T00:00:00Z,CY,Cyprus,EURO,2,972,0,18
5372,2020-06-11T00:00:00Z,CY,Cyprus,EURO,2,974,0,18
5373,2020-06-12T00:00:00Z,CY,Cyprus,EURO,1,975,0,18
5374,2020-06-13T00:00:00Z,CY,Cyprus,EURO,5,980,0,18
5375,2020-06-14T00:00:00Z,CY,Cyprus,EURO,0,980,0,18
5376,2020-06-15T00:00:00Z,CY,Cyprus,EURO,3,983,0,18
5377,2020-06-16T00:00:00Z,CY,Cyprus,EURO,2,985,0,18
5378,2020-06-17T00:00:00Z,CY,Cyprus,EURO,0,985,0,18
5379,2020-06-18T00:00:00Z,CY,Cyprus,EURO,0,985,0,18
5380,2020-06-19T00:00:00Z,CY,Cyprus,EURO,0,985,1,19
5381,2020-06-20T00:00:00Z,CY,Cyprus,EURO,0,985,0,19
5382,2020-03-01T00:00:00Z,CZ,Czechia,EURO,3,3,0,0
5383,2020-03-02T00:00:00Z,CZ,Czechia,EURO,0,3,0,0
5384,2020-03-03T00:00:00Z,CZ,Czechia,EURO,2,5,0,0
5385,2020-03-04T00:00:00Z,CZ,Czechia,EURO,0,5,0,0
5386,2020-03-05T00:00:00Z,CZ,Czechia,EURO,7,12,0,0
5387,2020-03-06T00:00:00Z,CZ,Czechia,EURO,0,12,0,0
5388,2020-03-07T00:00:00Z,CZ,Czechia,EURO,14,26,0,0
5389,2020-03-08T00:00:00Z,CZ,Czechia,EURO,6,32,0,0
5390,2020-03-09T00:00:00Z,CZ,Czechia,EURO,0,32,0,0
5391,2020-03-10T00:00:00Z,CZ,Czechia,EURO,29,61,0,0
5392,2020-03-11T00:00:00Z,CZ,Czechia,EURO,0,61,0,0
5393,2020-03-12T00:00:00Z,CZ,Czechia,EURO,55,116,0,0
5394,2020-03-13T00:00:00Z,CZ,Czechia,EURO,0,116,0,0
5395,2020-03-14T00:00:00Z,CZ,Czechia,EURO,34,150,0,0
5396,2020-03-15T00:00:00Z,CZ,Czechia,EURO,103,253,0,0
5397,2020-03-16T00:00:00Z,CZ,Czechia,EURO,45,298,0,0
5398,2020-03-17T00:00:00Z,CZ,Czechia,EURO,136,434,0,0
5399,2020-03-18T00:00:00Z,CZ,Czechia,EURO,88,522,0,0
5400,2020-03-19T00:00:00Z,CZ,Czechia,EURO,172,694,0,0
5401,2020-03-20T00:00:00Z,CZ,Czechia,EURO,210,904,0,0
5402,2020-03-21T00:00:00Z,CZ,Czechia,EURO,91,995,0,0
5403,2020-03-22T00:00:00Z,CZ,Czechia,EURO,0,995,0,0
5404,2020-03-23T00:00:00Z,CZ,Czechia,EURO,170,1165,1,1
5405,2020-03-24T00:00:00Z,CZ,Czechia,EURO,71,1236,0,1
5406,2020-03-25T00:00:00Z,CZ,Czechia,EURO,158,1394,2,3
5407,2020-03-26T00:00:00Z,CZ,Czechia,EURO,260,1654,3,6
5408,2020-03-27T00:00:00Z,CZ,Czechia,EURO,408,2062,3,9
5409,2020-03-28T00:00:00Z,CZ,Czechia,EURO,217,2279,0,9
5410,2020-03-29T00:00:00Z,CZ,Czechia,EURO,384,2663,2,11
5411,2020-03-30T00:00:00Z,CZ,Czechia,EURO,166,2829,5,16
5412,2020-03-31T00:00:00Z,CZ,Czechia,EURO,173,3002,8,24
5413,2020-04-01T00:00:00Z,CZ,Czechia,EURO,306,3308,7,31
5414,2020-04-02T00:00:00Z,CZ,Czechia,EURO,281,3589,8,39
5415,2020-04-03T00:00:00Z,CZ,Czechia,EURO,269,3858,5,44
5416,2020-04-04T00:00:00Z,CZ,Czechia,EURO,332,4190,9,53
5417,2020-04-05T00:00:00Z,CZ,Czechia,EURO,282,4472,6,59
5418,2020-04-06T00:00:00Z,CZ,Czechia,EURO,115,4587,8,67
5419,2020-04-07T00:00:00Z,CZ,Czechia,EURO,235,4822,11,78
5420,2020-04-08T00:00:00Z,CZ,Czechia,EURO,195,5017,10,88
5421,2020-04-09T00:00:00Z,CZ,Czechia,EURO,295,5312,11,99
5422,2020-04-10T00:00:00Z,CZ,Czechia,EURO,257,5569,13,112
5423,2020-04-11T00:00:00Z,CZ,Czechia,EURO,163,5732,7,119
5424,2020-04-12T00:00:00Z,CZ,Czechia,EURO,170,5902,10,129
5425,2020-04-13T00:00:00Z,CZ,Czechia,EURO,89,5991,9,138
5426,2020-04-14T00:00:00Z,CZ,Czechia,EURO,68,6059,5,143
5427,2020-04-15T00:00:00Z,CZ,Czechia,EURO,82,6141,18,161
5428,2020-04-16T00:00:00Z,CZ,Czechia,EURO,162,6303,5,166
5429,2020-04-17T00:00:00Z,CZ,Czechia,EURO,130,6433,3,169
5430,2020-04-18T00:00:00Z,CZ,Czechia,EURO,116,6549,4,173
5431,2020-04-19T00:00:00Z,CZ,Czechia,EURO,105,6654,8,181
5432,2020-04-20T00:00:00Z,CZ,Czechia,EURO,133,6787,7,188
5433,2020-04-21T00:00:00Z,CZ,Czechia,EURO,127,6914,8,196
5434,2020-04-22T00:00:00Z,CZ,Czechia,EURO,127,7041,5,201
5435,2020-04-23T00:00:00Z,CZ,Czechia,EURO,95,7136,9,210
5436,2020-04-24T00:00:00Z,CZ,Czechia,EURO,52,7188,3,213
5437,2020-04-25T00:00:00Z,CZ,Czechia,EURO,85,7273,2,215
5438,2020-04-26T00:00:00Z,CZ,Czechia,EURO,79,7352,3,218
5439,2020-04-27T00:00:00Z,CZ,Czechia,EURO,52,7404,3,221
5440,2020-04-28T00:00:00Z,CZ,Czechia,EURO,45,7449,2,223
5441,2020-04-29T00:00:00Z,CZ,Czechia,EURO,55,7504,4,227
5442,2020-04-30T00:00:00Z,CZ,Czechia,EURO,75,7579,0,227
5443,2020-05-01T00:00:00Z,CZ,Czechia,EURO,103,7682,9,236
5444,2020-05-02T00:00:00Z,CZ,Czechia,EURO,55,7737,4,240
5445,2020-05-03T00:00:00Z,CZ,Czechia,EURO,18,7755,5,245
5446,2020-05-04T00:00:00Z,CZ,Czechia,EURO,26,7781,3,248
5447,2020-05-05T00:00:00Z,CZ,Czechia,EURO,38,7819,4,252
5448,2020-05-06T00:00:00Z,CZ,Czechia,EURO,77,7896,5,257
5449,2020-05-07T00:00:00Z,CZ,Czechia,EURO,78,7974,5,262
5450,2020-05-08T00:00:00Z,CZ,Czechia,EURO,57,8031,8,270
5451,2020-05-09T00:00:00Z,CZ,Czechia,EURO,46,8077,3,273
5452,2020-05-10T00:00:00Z,CZ,Czechia,EURO,18,8095,3,276
5453,2020-05-11T00:00:00Z,CZ,Czechia,EURO,28,8123,4,280
5454,2020-05-12T00:00:00Z,CZ,Czechia,EURO,53,8176,2,282
5455,2020-05-13T00:00:00Z,CZ,Czechia,EURO,45,8221,1,283
5456,2020-05-14T00:00:00Z,CZ,Czechia,EURO,48,8269,7,290
5457,2020-05-15T00:00:00Z,CZ,Czechia,EURO,82,8351,3,293
5458,2020-05-16T00:00:00Z,CZ,Czechia,EURO,55,8406,2,295
5459,2020-05-17T00:00:00Z,CZ,Czechia,EURO,49,8455,1,296
5460,2020-05-18T00:00:00Z,CZ,Czechia,EURO,20,8475,2,298
5461,2020-05-19T00:00:00Z,CZ,Czechia,EURO,111,8586,-1,297
5462,2020-05-20T00:00:00Z,CZ,Czechia,EURO,61,8647,5,302
5463,2020-05-21T00:00:00Z,CZ,Czechia,EURO,74,8721,2,304
5464,2020-05-22T00:00:00Z,CZ,Czechia,EURO,33,8754,2,306
5465,2020-05-23T00:00:00Z,CZ,Czechia,EURO,59,8813,6,312
5466,2020-05-24T00:00:00Z,CZ,Czechia,EURO,77,8890,2,314
5467,2020-05-25T00:00:00Z,CZ,Czechia,EURO,67,8957,1,315
5468,2020-05-26T00:00:00Z,CZ,Czechia,EURO,47,9004,2,317
5469,2020-05-27T00:00:00Z,CZ,Czechia,EURO,46,9050,0,317
5470,2020-05-28T00:00:00Z,CZ,Czechia,EURO,36,9086,0,317
5471,2020-05-29T00:00:00Z,CZ,Czechia,EURO,54,9140,2,319
5472,2020-05-30T00:00:00Z,CZ,Czechia,EURO,56,9196,0,319
5473,2020-05-31T00:00:00Z,CZ,Czechia,EURO,34,9230,0,319
5474,2020-06-01T00:00:00Z,CZ,Czechia,EURO,43,9273,1,320
5475,2020-06-02T00:00:00Z,CZ,Czechia,EURO,29,9302,1,321
5476,2020-06-03T00:00:00Z,CZ,Czechia,EURO,62,9364,2,323
5477,2020-06-04T00:00:00Z,CZ,Czechia,EURO,74,9438,1,324
5478,2020-06-05T00:00:00Z,CZ,Czechia,EURO,56,9494,2,326
5479,2020-06-06T00:00:00Z,CZ,Czechia,EURO,35,9529,1,327
5480,2020-06-07T00:00:00Z,CZ,Czechia,EURO,38,9567,0,327
5481,2020-06-08T00:00:00Z,CZ,Czechia,EURO,61,9628,0,327
5482,2020-06-09T00:00:00Z,CZ,Czechia,EURO,69,9697,1,328
5483,2020-06-10T00:00:00Z,CZ,Czechia,EURO,54,9751,0,328
5484,2020-06-11T00:00:00Z,CZ,Czechia,EURO,73,9824,0,328
5485,2020-06-12T00:00:00Z,CZ,Czechia,EURO,62,9886,1,329
5486,2020-06-13T00:00:00Z,CZ,Czechia,EURO,52,9938,0,329
5487,2020-06-14T00:00:00Z,CZ,Czechia,EURO,53,9991,0,329
5488,2020-06-15T00:00:00Z,CZ,Czechia,EURO,33,10024,0,329
5489,2020-06-16T00:00:00Z,CZ,Czechia,EURO,40,10064,1,330
5490,2020-06-17T00:00:00Z,CZ,Czechia,EURO,47,10111,1,331
5491,2020-06-18T00:00:00Z,CZ,Czechia,EURO,51,10162,2,333
5492,2020-06-19T00:00:00Z,CZ,Czechia,EURO,68,10230,1,334
5493,2020-06-20T00:00:00Z,CZ,Czechia,EURO,230,10460,1,335
5596,2020-02-27T00:00:00Z,DK,Denmark,EURO,1,1,0,0
5597,2020-02-28T00:00:00Z,DK,Denmark,EURO,1,2,0,0
5598,2020-02-29T00:00:00Z,DK,Denmark,EURO,1,3,0,0
5599,2020-03-01T00:00:00Z,DK,Denmark,EURO,1,4,0,0
5600,2020-03-02T00:00:00Z,DK,Denmark,EURO,1,5,0,0
5601,2020-03-03T00:00:00Z,DK,Denmark,EURO,3,8,0,0
5602,2020-03-04T00:00:00Z,DK,Denmark,EURO,2,10,0,0
5603,2020-03-05T00:00:00Z,DK,Denmark,EURO,8,18,0,0
5604,2020-03-06T00:00:00Z,DK,Denmark,EURO,5,23,0,0
5605,2020-03-07T00:00:00Z,DK,Denmark,EURO,8,31,0,0
5606,2020-03-08T00:00:00Z,DK,Denmark,EURO,5,36,0,0
5607,2020-03-09T00:00:00Z,DK,Denmark,EURO,54,90,0,0
5608,2020-03-10T00:00:00Z,DK,Denmark,EURO,172,262,0,0
5609,2020-03-11T00:00:00Z,DK,Denmark,EURO,276,538,0,0
5610,2020-03-12T00:00:00Z,DK,Denmark,EURO,136,674,0,0
5611,2020-03-13T00:00:00Z,DK,Denmark,EURO,127,801,0,0
5612,2020-03-14T00:00:00Z,DK,Denmark,EURO,26,827,0,0
5613,2020-03-15T00:00:00Z,DK,Denmark,EURO,37,864,1,1
5614,2020-03-16T00:00:00Z,DK,Denmark,EURO,34,898,0,1
5615,2020-03-17T00:00:00Z,DK,Denmark,EURO,79,977,3,4
5616,2020-03-18T00:00:00Z,DK,Denmark,EURO,67,1044,0,4
5617,2020-03-19T00:00:00Z,DK,Denmark,EURO,88,1132,2,6
5618,2020-03-20T00:00:00Z,DK,Denmark,EURO,123,1255,3,9
5619,2020-03-21T00:00:00Z,DK,Denmark,EURO,71,1326,4,13
5620,2020-03-22T00:00:00Z,DK,Denmark,EURO,0,1326,0,13
5621,2020-03-23T00:00:00Z,DK,Denmark,EURO,69,1395,0,13
5622,2020-03-24T00:00:00Z,DK,Denmark,EURO,65,1460,11,24
5623,2020-03-25T00:00:00Z,DK,Denmark,EURO,131,1591,8,32
5624,2020-03-26T00:00:00Z,DK,Denmark,EURO,133,1724,2,34
5625,2020-03-27T00:00:00Z,DK,Denmark,EURO,153,1877,7,41
5626,2020-03-28T00:00:00Z,DK,Denmark,EURO,169,2046,11,52
5627,2020-03-29T00:00:00Z,DK,Denmark,EURO,155,2201,13,65
5628,2020-03-30T00:00:00Z,DK,Denmark,EURO,194,2395,7,72
5629,2020-03-31T00:00:00Z,DK,Denmark,EURO,182,2577,5,77
5630,2020-04-01T00:00:00Z,DK,Denmark,EURO,283,2860,13,90
5631,2020-04-02T00:00:00Z,DK,Denmark,EURO,247,3107,14,104
5632,2020-04-03T00:00:00Z,DK,Denmark,EURO,279,3386,19,123
5633,2020-04-04T00:00:00Z,DK,Denmark,EURO,371,3757,16,139
5634,2020-04-05T00:00:00Z,DK,Denmark,EURO,320,4077,22,161
5635,2020-04-06T00:00:00Z,DK,Denmark,EURO,292,4369,18,179
5636,2020-04-07T00:00:00Z,DK,Denmark,EURO,312,4681,8,187
5637,2020-04-08T00:00:00Z,DK,Denmark,EURO,390,5071,16,203
5638,2020-04-09T00:00:00Z,DK,Denmark,EURO,331,5402,15,218
5639,2020-04-10T00:00:00Z,DK,Denmark,EURO,233,5635,19,237
5640,2020-04-11T00:00:00Z,DK,Denmark,EURO,184,5819,10,247
5641,2020-04-12T00:00:00Z,DK,Denmark,EURO,177,5996,13,260
5642,2020-04-13T00:00:00Z,DK,Denmark,EURO,178,6174,13,273
5643,2020-04-14T00:00:00Z,DK,Denmark,EURO,144,6318,12,285
5644,2020-04-15T00:00:00Z,DK,Denmark,EURO,193,6511,14,299
5645,2020-04-16T00:00:00Z,DK,Denmark,EURO,170,6681,10,309
5646,2020-04-17T00:00:00Z,DK,Denmark,EURO,198,6879,12,321
5647,2020-04-18T00:00:00Z,DK,Denmark,EURO,194,7073,15,336
5648,2020-04-19T00:00:00Z,DK,Denmark,EURO,169,7242,10,346
5649,2020-04-20T00:00:00Z,DK,Denmark,EURO,142,7384,9,355
5650,2020-04-21T00:00:00Z,DK,Denmark,EURO,131,7515,9,364
5651,2020-04-22T00:00:00Z,DK,Denmark,EURO,180,7695,6,370
5652,2020-04-23T00:00:00Z,DK,Denmark,EURO,217,7912,14,384
5653,2020-04-24T00:00:00Z,DK,Denmark,EURO,161,8073,10,394
5654,2020-04-25T00:00:00Z,DK,Denmark,EURO,137,8210,9,403
5655,2020-04-26T00:00:00Z,DK,Denmark,EURO,235,8445,15,418
5656,2020-04-27T00:00:00Z,DK,Denmark,EURO,130,8575,4,422
5657,2020-04-28T00:00:00Z,DK,Denmark,EURO,123,8698,5,427
5658,2020-04-29T00:00:00Z,DK,Denmark,EURO,153,8851,7,434
5659,2020-04-30T00:00:00Z,DK,Denmark,EURO,157,9008,9,443
5660,2020-05-01T00:00:00Z,DK,Denmark,EURO,150,9158,9,452
5661,2020-05-02T00:00:00Z,DK,Denmark,EURO,153,9311,8,460
5662,2020-05-03T00:00:00Z,DK,Denmark,EURO,96,9407,15,475
5663,2020-05-04T00:00:00Z,DK,Denmark,EURO,116,9523,9,484
5664,2020-05-05T00:00:00Z,DK,Denmark,EURO,147,9670,9,493
5665,2020-05-06T00:00:00Z,DK,Denmark,EURO,151,9821,10,503
5666,2020-05-07T00:00:00Z,DK,Denmark,EURO,162,9983,3,506
5667,2020-05-08T00:00:00Z,DK,Denmark,EURO,100,10083,8,514
5668,2020-05-09T00:00:00Z,DK,Denmark,EURO,135,10218,8,522
5669,2020-05-10T00:00:00Z,DK,Denmark,EURO,101,10319,4,526
5670,2020-05-11T00:00:00Z,DK,Denmark,EURO,110,10429,3,529
5671,2020-05-12T00:00:00Z,DK,Denmark,EURO,84,10513,4,533
5672,2020-05-13T00:00:00Z,DK,Denmark,EURO,78,10591,-6,527
5673,2020-05-14T00:00:00Z,DK,Denmark,EURO,76,10667,6,533
5674,2020-05-15T00:00:00Z,DK,Denmark,EURO,46,10713,4,537
5675,2020-05-16T00:00:00Z,DK,Denmark,EURO,78,10791,0,537
5676,2020-05-17T00:00:00Z,DK,Denmark,EURO,67,10858,6,543
5677,2020-05-18T00:00:00Z,DK,Denmark,EURO,69,10927,4,547
5678,2020-05-19T00:00:00Z,DK,Denmark,EURO,41,10968,1,548
5679,2020-05-20T00:00:00Z,DK,Denmark,EURO,76,11044,3,551
5680,2020-05-21T00:00:00Z,DK,Denmark,EURO,73,11117,3,554
5681,2020-05-22T00:00:00Z,DK,Denmark,EURO,65,11182,7,561
5682,2020-05-23T00:00:00Z,DK,Denmark,EURO,48,11230,0,561
5683,2020-05-24T00:00:00Z,DK,Denmark,EURO,59,11289,0,561
5684,2020-05-25T00:00:00Z,DK,Denmark,EURO,71,11360,1,562
5685,2020-05-26T00:00:00Z,DK,Denmark,EURO,27,11387,1,563
5686,2020-05-27T00:00:00Z,DK,Denmark,EURO,41,11428,0,563
5687,2020-05-28T00:00:00Z,DK,Denmark,EURO,52,11480,2,565
5688,2020-05-29T00:00:00Z,DK,Denmark,EURO,32,11512,3,568
5689,2020-05-30T00:00:00Z,DK,Denmark,EURO,81,11593,0,568
5690,2020-05-31T00:00:00Z,DK,Denmark,EURO,40,11633,3,571
5691,2020-06-01T00:00:00Z,DK,Denmark,EURO,36,11669,3,574
5692,2020-06-02T00:00:00Z,DK,Denmark,EURO,30,11699,2,576
5693,2020-06-03T00:00:00Z,DK,Denmark,EURO,35,11734,4,580
5694,2020-06-04T00:00:00Z,DK,Denmark,EURO,37,11771,0,580
5695,2020-06-05T00:00:00Z,DK,Denmark,EURO,40,11811,2,582
5696,2020-06-06T00:00:00Z,DK,Denmark,EURO,64,11875,4,586
5697,2020-06-07T00:00:00Z,DK,Denmark,EURO,49,11924,1,587
5698,2020-06-08T00:00:00Z,DK,Denmark,EURO,24,11948,2,589
5699,2020-06-09T00:00:00Z,DK,Denmark,EURO,14,11962,4,593
5700,2020-06-10T00:00:00Z,DK,Denmark,EURO,39,12001,0,593
5701,2020-06-11T00:00:00Z,DK,Denmark,EURO,15,12016,0,593
5702,2020-06-12T00:00:00Z,DK,Denmark,EURO,19,12035,0,593
5703,2020-06-13T00:00:00Z,DK,Denmark,EURO,64,12099,1,594
5704,2020-06-14T00:00:00Z,DK,Denmark,EURO,40,12139,3,597
5705,2020-06-15T00:00:00Z,DK,Denmark,EURO,54,12193,0,597
5706,2020-06-16T00:00:00Z,DK,Denmark,EURO,24,12217,1,598
5707,2020-06-17T00:00:00Z,DK,Denmark,EURO,33,12250,0,598
5708,2020-06-18T00:00:00Z,DK,Denmark,EURO,44,12294,0,598
5709,2020-06-19T00:00:00Z,DK,Denmark,EURO,50,12344,2,600
5710,2020-06-20T00:00:00Z,DK,Denmark,EURO,47,12391,0,600
6532,2020-02-27T00:00:00Z,EE,Estonia,EURO,1,1,0,0
6533,2020-02-28T00:00:00Z,EE,Estonia,EURO,0,1,0,0
6534,2020-02-29T00:00:00Z,EE,Estonia,EURO,0,1,0,0
6535,2020-03-01T00:00:00Z,EE,Estonia,EURO,0,1,0,0
6536,2020-03-02T00:00:00Z,EE,Estonia,EURO,0,1,0,0
6537,2020-03-03T00:00:00Z,EE,Estonia,EURO,1,2,0,0
6538,2020-03-04T00:00:00Z,EE,Estonia,EURO,0,2,0,0
6539,2020-03-05T00:00:00Z,EE,Estonia,EURO,1,3,0,0
6540,2020-03-06T00:00:00Z,EE,Estonia,EURO,7,10,0,0
6541,2020-03-07T00:00:00Z,EE,Estonia,EURO,0,10,0,0
6542,2020-03-08T00:00:00Z,EE,Estonia,EURO,0,10,0,0
6543,2020-03-09T00:00:00Z,EE,Estonia,EURO,0,10,0,0
6544,2020-03-10T00:00:00Z,EE,Estonia,EURO,0,10,0,0
6545,2020-03-11T00:00:00Z,EE,Estonia,EURO,3,13,0,0
6546,2020-03-12T00:00:00Z,EE,Estonia,EURO,0,13,0,0
6547,2020-03-13T00:00:00Z,EE,Estonia,EURO,66,79,0,0
6548,2020-03-14T00:00:00Z,EE,Estonia,EURO,0,79,0,0
6549,2020-03-15T00:00:00Z,EE,Estonia,EURO,92,171,0,0
6550,2020-03-16T00:00:00Z,EE,Estonia,EURO,34,205,0,0
6551,2020-03-17T00:00:00Z,EE,Estonia,EURO,20,225,0,0
6552,2020-03-18T00:00:00Z,EE,Estonia,EURO,33,258,0,0
6553,2020-03-19T00:00:00Z,EE,Estonia,EURO,9,267,0,0
6554,2020-03-20T00:00:00Z,EE,Estonia,EURO,16,283,0,0
6555,2020-03-21T00:00:00Z,EE,Estonia,EURO,23,306,0,0
6556,2020-03-22T00:00:00Z,EE,Estonia,EURO,0,306,0,0
6557,2020-03-23T00:00:00Z,EE,Estonia,EURO,20,326,0,0
6558,2020-03-24T00:00:00Z,EE,Estonia,EURO,26,352,0,0
6559,2020-03-25T00:00:00Z,EE,Estonia,EURO,17,369,0,0
6560,2020-03-26T00:00:00Z,EE,Estonia,EURO,35,404,1,1
6561,2020-03-27T00:00:00Z,EE,Estonia,EURO,134,538,0,1
6562,2020-03-28T00:00:00Z,EE,Estonia,EURO,37,575,0,1
6563,2020-03-29T00:00:00Z,EE,Estonia,EURO,65,640,0,1
6564,2020-03-30T00:00:00Z,EE,Estonia,EURO,39,679,2,3
6565,2020-03-31T00:00:00Z,EE,Estonia,EURO,36,715,0,3
6566,2020-04-01T00:00:00Z,EE,Estonia,EURO,30,745,1,4
6567,2020-04-02T00:00:00Z,EE,Estonia,EURO,34,779,1,5
6568,2020-04-03T00:00:00Z,EE,Estonia,EURO,79,858,6,11
6569,2020-04-04T00:00:00Z,EE,Estonia,EURO,103,961,1,12
6570,2020-04-05T00:00:00Z,EE,Estonia,EURO,57,1018,1,13
6571,2020-04-06T00:00:00Z,EE,Estonia,EURO,79,1097,2,15
6572,2020-04-07T00:00:00Z,EE,Estonia,EURO,11,1108,4,19
6573,2020-04-08T00:00:00Z,EE,Estonia,EURO,41,1149,2,21
6574,2020-04-09T00:00:00Z,EE,Estonia,EURO,36,1185,3,24
6575,2020-04-10T00:00:00Z,EE,Estonia,EURO,22,1207,0,24
6576,2020-04-11T00:00:00Z,EE,Estonia,EURO,51,1258,0,24
6577,2020-04-12T00:00:00Z,EE,Estonia,EURO,46,1304,0,24
6578,2020-04-13T00:00:00Z,EE,Estonia,EURO,5,1309,1,25
6579,2020-04-14T00:00:00Z,EE,Estonia,EURO,23,1332,3,28
6580,2020-04-15T00:00:00Z,EE,Estonia,EURO,41,1373,3,31
6581,2020-04-16T00:00:00Z,EE,Estonia,EURO,29,1402,4,35
6582,2020-04-17T00:00:00Z,EE,Estonia,EURO,32,1434,1,36
6583,2020-04-18T00:00:00Z,EE,Estonia,EURO,25,1459,2,38
6584,2020-04-19T00:00:00Z,EE,Estonia,EURO,53,1512,0,38
6585,2020-04-20T00:00:00Z,EE,Estonia,EURO,16,1528,2,40
6586,2020-04-21T00:00:00Z,EE,Estonia,EURO,7,1535,0,40
6587,2020-04-22T00:00:00Z,EE,Estonia,EURO,17,1552,3,43
6588,2020-04-23T00:00:00Z,EE,Estonia,EURO,7,1559,1,44
6589,2020-04-24T00:00:00Z,EE,Estonia,EURO,33,1592,1,45
6590,2020-04-25T00:00:00Z,EE,Estonia,EURO,13,1605,1,46
6591,2020-04-26T00:00:00Z,EE,Estonia,EURO,30,1635,0,46
6592,2020-04-27T00:00:00Z,EE,Estonia,EURO,8,1643,3,49
6593,2020-04-28T00:00:00Z,EE,Estonia,EURO,4,1647,1,50
6594,2020-04-29T00:00:00Z,EE,Estonia,EURO,13,1660,0,50
6595,2020-04-30T00:00:00Z,EE,Estonia,EURO,6,1666,0,50
6596,2020-05-01T00:00:00Z,EE,Estonia,EURO,23,1689,2,52
6597,2020-05-02T00:00:00Z,EE,Estonia,EURO,5,1694,0,52
6598,2020-05-03T00:00:00Z,EE,Estonia,EURO,5,1699,1,53
6599,2020-05-04T00:00:00Z,EE,Estonia,EURO,1,1700,2,55
6600,2020-05-05T00:00:00Z,EE,Estonia,EURO,3,1703,0,55
6601,2020-05-06T00:00:00Z,EE,Estonia,EURO,8,1711,0,55
6602,2020-05-07T00:00:00Z,EE,Estonia,EURO,2,1713,0,55
6603,2020-05-08T00:00:00Z,EE,Estonia,EURO,7,1720,1,56
6604,2020-05-09T00:00:00Z,EE,Estonia,EURO,5,1725,0,56
6605,2020-05-10T00:00:00Z,EE,Estonia,EURO,8,1733,4,60
6606,2020-05-11T00:00:00Z,EE,Estonia,EURO,6,1739,0,60
6607,2020-05-12T00:00:00Z,EE,Estonia,EURO,2,1741,1,61
6608,2020-05-13T00:00:00Z,EE,Estonia,EURO,5,1746,0,61
6609,2020-05-14T00:00:00Z,EE,Estonia,EURO,5,1751,0,61
6610,2020-05-15T00:00:00Z,EE,Estonia,EURO,7,1758,1,62
6611,2020-05-16T00:00:00Z,EE,Estonia,EURO,8,1766,1,63
6612,2020-05-17T00:00:00Z,EE,Estonia,EURO,4,1770,0,63
6613,2020-05-18T00:00:00Z,EE,Estonia,EURO,4,1774,0,63
6614,2020-05-19T00:00:00Z,EE,Estonia,EURO,10,1784,1,64
6615,2020-05-20T00:00:00Z,EE,Estonia,EURO,7,1791,0,64
6616,2020-05-21T00:00:00Z,EE,Estonia,EURO,3,1794,0,64
6617,2020-05-22T00:00:00Z,EE,Estonia,EURO,6,1800,0,64
6618,2020-05-23T00:00:00Z,EE,Estonia,EURO,7,1807,0,64
6619,2020-05-24T00:00:00Z,EE,Estonia,EURO,14,1821,0,64
6620,2020-05-25T00:00:00Z,EE,Estonia,EURO,2,1823,0,64
6621,2020-05-26T00:00:00Z,EE,Estonia,EURO,1,1824,1,65
6622,2020-05-27T00:00:00Z,EE,Estonia,EURO,10,1834,0,65
6623,2020-05-28T00:00:00Z,EE,Estonia,EURO,6,1840,1,66
6624,2020-05-29T00:00:00Z,EE,Estonia,EURO,11,1851,0,66
6625,2020-05-30T00:00:00Z,EE,Estonia,EURO,8,1859,1,67
6626,2020-05-31T00:00:00Z,EE,Estonia,EURO,6,1865,0,67
6627,2020-06-01T00:00:00Z,EE,Estonia,EURO,4,1869,1,68
6628,2020-06-02T00:00:00Z,EE,Estonia,EURO,1,1870,0,68
6629,2020-06-03T00:00:00Z,EE,Estonia,EURO,0,1870,0,68
6630,2020-06-04T00:00:00Z,EE,Estonia,EURO,10,1880,1,69
6631,2020-06-05T00:00:00Z,EE,Estonia,EURO,10,1890,0,69
6632,2020-06-06T00:00:00Z,EE,Estonia,EURO,20,1910,0,69
6633,2020-06-07T00:00:00Z,EE,Estonia,EURO,21,1931,0,69
6634,2020-06-08T00:00:00Z,EE,Estonia,EURO,8,1939,0,69
6635,2020-06-09T00:00:00Z,EE,Estonia,EURO,1,1940,0,69
6636,2020-06-10T00:00:00Z,EE,Estonia,EURO,7,1947,0,69
6637,2020-06-11T00:00:00Z,EE,Estonia,EURO,11,1958,0,69
6638,2020-06-12T00:00:00Z,EE,Estonia,EURO,7,1965,0,69
6639,2020-06-13T00:00:00Z,EE,Estonia,EURO,5,1970,0,69
6640,2020-06-14T00:00:00Z,EE,Estonia,EURO,3,1973,0,69
6641,2020-06-15T00:00:00Z,EE,Estonia,EURO,0,1973,0,69
6642,2020-06-16T00:00:00Z,EE,Estonia,EURO,1,1974,0,69
6643,2020-06-17T00:00:00Z,EE,Estonia,EURO,1,1975,0,69
6644,2020-06-18T00:00:00Z,EE,Estonia,EURO,2,1977,0,69
6645,2020-06-19T00:00:00Z,EE,Estonia,EURO,0,1977,0,69
6646,2020-06-20T00:00:00Z,EE,Estonia,EURO,2,1979,0,69
6922,2020-03-05T00:00:00Z,FO,Faroe Islands,EURO,1,1,0,0
6923,2020-03-06T00:00:00Z,FO,Faroe Islands,EURO,0,1,0,0
6924,2020-03-07T00:00:00Z,FO,Faroe Islands,EURO,0,1,0,0
6925,2020-03-08T00:00:00Z,FO,Faroe Islands,EURO,1,2,0,0
6926,2020-03-09T00:00:00Z,FO,Faroe Islands,EURO,0,2,0,0
6927,2020-03-10T00:00:00Z,FO,Faroe Islands,EURO,0,2,0,0
6928,2020-03-11T00:00:00Z,FO,Faroe Islands,EURO,0,2,0,0
6929,2020-03-12T00:00:00Z,FO,Faroe Islands,EURO,0,2,0,0
6930,2020-03-13T00:00:00Z,FO,Faroe Islands,EURO,1,3,0,0
6931,2020-03-14T00:00:00Z,FO,Faroe Islands,EURO,6,9,0,0
6932,2020-03-15T00:00:00Z,FO,Faroe Islands,EURO,0,9,0,0
6933,2020-03-16T00:00:00Z,FO,Faroe Islands,EURO,2,11,0,0
6934,2020-03-17T00:00:00Z,FO,Faroe Islands,EURO,36,47,0,0
6935,2020-03-18T00:00:00Z,FO,Faroe Islands,EURO,11,58,0,0
6936,2020-03-19T00:00:00Z,FO,Faroe Islands,EURO,14,72,0,0
6937,2020-03-20T00:00:00Z,FO,Faroe Islands,EURO,8,80,0,0
6938,2020-03-21T00:00:00Z,FO,Faroe Islands,EURO,12,92,0,0
6939,2020-03-22T00:00:00Z,FO,Faroe Islands,EURO,0,92,0,0
6940,2020-03-23T00:00:00Z,FO,Faroe Islands,EURO,23,115,0,0
6941,2020-03-24T00:00:00Z,FO,Faroe Islands,EURO,3,118,0,0
6942,2020-03-25T00:00:00Z,FO,Faroe Islands,EURO,4,122,0,0
6943,2020-03-26T00:00:00Z,FO,Faroe Islands,EURO,10,132,0,0
6944,2020-03-27T00:00:00Z,FO,Faroe Islands,EURO,8,140,0,0
6945,2020-03-28T00:00:00Z,FO,Faroe Islands,EURO,4,144,0,0
6946,2020-03-29T00:00:00Z,FO,Faroe Islands,EURO,11,155,0,0
6947,2020-03-30T00:00:00Z,FO,Faroe Islands,EURO,4,159,0,0
6948,2020-03-31T00:00:00Z,FO,Faroe Islands,EURO,9,168,0,0
6949,2020-04-01T00:00:00Z,FO,Faroe Islands,EURO,1,169,0,0
6950,2020-04-02T00:00:00Z,FO,Faroe Islands,EURO,4,173,0,0
6951,2020-04-03T00:00:00Z,FO,Faroe Islands,EURO,4,177,0,0
6952,2020-04-04T00:00:00Z,FO,Faroe Islands,EURO,2,179,0,0
6953,2020-04-05T00:00:00Z,FO,Faroe Islands,EURO,2,181,0,0
6954,2020-04-06T00:00:00Z,FO,Faroe Islands,EURO,0,181,0,0
6955,2020-04-07T00:00:00Z,FO,Faroe Islands,EURO,0,181,0,0
6956,2020-04-08T00:00:00Z,FO,Faroe Islands,EURO,3,184,0,0
6957,2020-04-09T00:00:00Z,FO,Faroe Islands,EURO,0,184,0,0
6958,2020-04-10T00:00:00Z,FO,Faroe Islands,EURO,0,184,0,0
6959,2020-04-11T00:00:00Z,FO,Faroe Islands,EURO,0,184,0,0
6960,2020-04-12T00:00:00Z,FO,Faroe Islands,EURO,0,184,0,0
6961,2020-04-13T00:00:00Z,FO,Faroe Islands,EURO,0,184,0,0
6962,2020-04-14T00:00:00Z,FO,Faroe Islands,EURO,0,184,0,0
6963,2020-04-15T00:00:00Z,FO,Faroe Islands,EURO,0,184,0,0
6964,2020-04-16T00:00:00Z,FO,Faroe Islands,EURO,0,184,0,0
6965,2020-04-17T00:00:00Z,FO,Faroe Islands,EURO,0,184,0,0
6966,2020-04-18T00:00:00Z,FO,Faroe Islands,EURO,0,184,0,0
6967,2020-04-19T00:00:00Z,FO,Faroe Islands,EURO,0,184,0,0
6968,2020-04-20T00:00:00Z,FO,Faroe Islands,EURO,1,185,0,0
6969,2020-04-21T00:00:00Z,FO,Faroe Islands,EURO,0,185,0,0
6970,2020-04-22T00:00:00Z,FO,Faroe Islands,EURO,0,185,0,0
6971,2020-04-23T00:00:00Z,FO,Faroe Islands,EURO,0,185,0,0
6972,2020-04-24T00:00:00Z,FO,Faroe Islands,EURO,2,187,0,0
6973,2020-04-25T00:00:00Z,FO,Faroe Islands,EURO,0,187,0,0
6974,2020-04-26T00:00:00Z,FO,Faroe Islands,EURO,0,187,0,0
6975,2020-04-27T00:00:00Z,FO,Faroe Islands,EURO,0,187,0,0
6976,2020-04-28T00:00:00Z,FO,Faroe Islands,EURO,0,187,0,0
6977,2020-04-29T00:00:00Z,FO,Faroe Islands,EURO,0,187,0,0
6978,2020-04-30T00:00:00Z,FO,Faroe Islands,EURO,0,187,0,0
6979,2020-05-01T00:00:00Z,FO,Faroe Islands,EURO,0,187,0,0
6980,2020-05-02T00:00:00Z,FO,Faroe Islands,EURO,0,187,0,0
6981,2020-05-03T00:00:00Z,FO,Faroe Islands,EURO,0,187,0,0
6982,2020-05-04T00:00:00Z,FO,Faroe Islands,EURO,0,187,0,0
6983,2020-05-05T00:00:00Z,FO,Faroe Islands,EURO,0,187,0,0
6984,2020-05-06T00:00:00Z,FO,Faroe Islands,EURO,0,187,0,0
6985,2020-05-07T00:00:00Z,FO,Faroe Islands,EURO,0,187,0,0
6986,2020-05-08T00:00:00Z,FO,Faroe Islands,EURO,0,187,0,0
6987,2020-05-09T00:00:00Z,FO,Faroe Islands,EURO,0,187,0,0
6988,2020-05-10T00:00:00Z,FO,Faroe Islands,EURO,0,187,0,0
6989,2020-05-11T00:00:00Z,FO,Faroe Islands,EURO,0,187,0,0
6990,2020-05-12T00:00:00Z,FO,Faroe Islands,EURO,0,187,0,0
6991,2020-05-13T00:00:00Z,FO,Faroe Islands,EURO,0,187,0,0
6992,2020-05-14T00:00:00Z,FO,Faroe Islands,EURO,0,187,0,0
6993,2020-05-15T00:00:00Z,FO,Faroe Islands,EURO,0,187,0,0
6994,2020-05-16T00:00:00Z,FO,Faroe Islands,EURO,0,187,0,0
6995,2020-05-17T00:00:00Z,FO,Faroe Islands,EURO,0,187,0,0
6996,2020-05-18T00:00:00Z,FO,Faroe Islands,EURO,0,187,0,0
6997,2020-05-19T00:00:00Z,FO,Faroe Islands,EURO,0,187,0,0
6998,2020-05-20T00:00:00Z,FO,Faroe Islands,EURO,0,187,0,0
6999,2020-05-21T00:00:00Z,FO,Faroe Islands,EURO,0,187,0,0
7000,2020-05-22T00:00:00Z,FO,Faroe Islands,EURO,0,187,0,0
7001,2020-05-23T00:00:00Z,FO,Faroe Islands,EURO,0,187,0,0
7002,2020-05-24T00:00:00Z,FO,Faroe Islands,EURO,0,187,0,0
7003,2020-05-25T00:00:00Z,FO,Faroe Islands,EURO,0,187,0,0
7004,2020-05-26T00:00:00Z,FO,Faroe Islands,EURO,0,187,0,0
7005,2020-05-27T00:00:00Z,FO,Faroe Islands,EURO,0,187,0,0
7006,2020-05-28T00:00:00Z,FO,Faroe Islands,EURO,0,187,0,0
7007,2020-05-29T00:00:00Z,FO,Faroe Islands,EURO,0,187,0,0
7008,2020-05-30T00:00:00Z,FO,Faroe Islands,EURO,0,187,0,0
7009,2020-05-31T00:00:00Z,FO,Faroe Islands,EURO,0,187,0,0
7010,2020-06-01T00:00:00Z,FO,Faroe Islands,EURO,0,187,0,0
7011,2020-06-02T00:00:00Z,FO,Faroe Islands,EURO,0,187,0,0
7012,2020-06-03T00:00:00Z,FO,Faroe Islands,EURO,0,187,0,0
7013,2020-06-04T00:00:00Z,FO,Faroe Islands,EURO,0,187,0,0
7014,2020-06-05T00:00:00Z,FO,Faroe Islands,EURO,0,187,0,0
7015,2020-06-06T00:00:00Z,FO,Faroe Islands,EURO,0,187,0,0
7016,2020-06-07T00:00:00Z,FO,Faroe Islands,EURO,0,187,0,0
7017,2020-06-08T00:00:00Z,FO,Faroe Islands,EURO,0,187,0,0
7018,2020-06-09T00:00:00Z,FO,Faroe Islands,EURO,0,187,0,0
7019,2020-06-10T00:00:00Z,FO,Faroe Islands,EURO,0,187,0,0
7020,2020-06-11T00:00:00Z,FO,Faroe Islands,EURO,0,187,0,0
7021,2020-06-12T00:00:00Z,FO,Faroe Islands,EURO,0,187,0,0
7022,2020-06-13T00:00:00Z,FO,Faroe Islands,EURO,0,187,0,0
7023,2020-06-14T00:00:00Z,FO,Faroe Islands,EURO,0,187,0,0
7024,2020-06-15T00:00:00Z,FO,Faroe Islands,EURO,0,187,0,0
7025,2020-06-16T00:00:00Z,FO,Faroe Islands,EURO,0,187,0,0
7026,2020-06-17T00:00:00Z,FO,Faroe Islands,EURO,0,187,0,0
7027,2020-06-18T00:00:00Z,FO,Faroe Islands,EURO,0,187,0,0
7028,2020-06-19T00:00:00Z,FO,Faroe Islands,EURO,0,187,0,0
7029,2020-06-20T00:00:00Z,FO,Faroe Islands,EURO,0,187,0,0
7124,2020-01-29T00:00:00Z,FI,Finland,EURO,1,1,0,0
7125,2020-01-30T00:00:00Z,FI,Finland,EURO,0,1,0,0
7126,2020-01-31T00:00:00Z,FI,Finland,EURO,0,1,0,0
7127,2020-02-01T00:00:00Z,FI,Finland,EURO,0,1,0,0
7128,2020-02-02T00:00:00Z,FI,Finland,EURO,0,1,0,0
7129,2020-02-03T00:00:00Z,FI,Finland,EURO,0,1,0,0
7130,2020-02-04T00:00:00Z,FI,Finland,EURO,0,1,0,0
7131,2020-02-05T00:00:00Z,FI,Finland,EURO,0,1,0,0
7132,2020-02-06T00:00:00Z,FI,Finland,EURO,0,1,0,0
7133,2020-02-07T00:00:00Z,FI,Finland,EURO,0,1,0,0
7134,2020-02-08T00:00:00Z,FI,Finland,EURO,0,1,0,0
7135,2020-02-09T00:00:00Z,FI,Finland,EURO,0,1,0,0
7136,2020-02-10T00:00:00Z,FI,Finland,EURO,0,1,0,0
7137,2020-02-11T00:00:00Z,FI,Finland,EURO,0,1,0,0
7138,2020-02-12T00:00:00Z,FI,Finland,EURO,0,1,0,0
7139,2020-02-13T00:00:00Z,FI,Finland,EURO,0,1,0,0
7140,2020-02-14T00:00:00Z,FI,Finland,EURO,0,1,0,0
7141,2020-02-15T00:00:00Z,FI,Finland,EURO,0,1,0,0
7142,2020-02-16T00:00:00Z,FI,Finland,EURO,0,1,0,0
7143,2020-02-17T00:00:00Z,FI,Finland,EURO,0,1,0,0
7144,2020-02-18T00:00:00Z,FI,Finland,EURO,0,1,0,0
7145,2020-02-19T00:00:00Z,FI,Finland,EURO,0,1,0,0
7146,2020-02-20T00:00:00Z,FI,Finland,EURO,0,1,0,0
7147,2020-02-21T00:00:00Z,FI,Finland,EURO,0,1,0,0
7148,2020-02-22T00:00:00Z,FI,Finland,EURO,0,1,0,0
7149,2020-02-23T00:00:00Z,FI,Finland,EURO,0,1,0,0
7150,2020-02-24T00:00:00Z,FI,Finland,EURO,0,1,0,0
7151,2020-02-25T00:00:00Z,FI,Finland,EURO,0,1,0,0
7152,2020-02-26T00:00:00Z,FI,Finland,EURO,1,2,0,0
7153,2020-02-27T00:00:00Z,FI,Finland,EURO,0,2,0,0
7154,2020-02-28T00:00:00Z,FI,Finland,EURO,0,2,0,0
7155,2020-02-29T00:00:00Z,FI,Finland,EURO,0,2,0,0
7156,2020-03-01T00:00:00Z,FI,Finland,EURO,4,6,0,0
7157,2020-03-02T00:00:00Z,FI,Finland,EURO,1,7,0,0
7158,2020-03-03T00:00:00Z,FI,Finland,EURO,0,7,0,0
7159,2020-03-04T00:00:00Z,FI,Finland,EURO,0,7,0,0
7160,2020-03-05T00:00:00Z,FI,Finland,EURO,5,12,0,0
7161,2020-03-06T00:00:00Z,FI,Finland,EURO,7,19,0,0
7162,2020-03-07T00:00:00Z,FI,Finland,EURO,0,19,0,0
7163,2020-03-08T00:00:00Z,FI,Finland,EURO,11,30,0,0
7164,2020-03-09T00:00:00Z,FI,Finland,EURO,10,40,0,0
7165,2020-03-10T00:00:00Z,FI,Finland,EURO,0,40,0,0
7166,2020-03-11T00:00:00Z,FI,Finland,EURO,0,40,0,0
7167,2020-03-12T00:00:00Z,FI,Finland,EURO,115,155,0,0
7168,2020-03-13T00:00:00Z,FI,Finland,EURO,0,155,0,0
7169,2020-03-14T00:00:00Z,FI,Finland,EURO,55,210,0,0
7170,2020-03-15T00:00:00Z,FI,Finland,EURO,57,267,0,0
7171,2020-03-16T00:00:00Z,FI,Finland,EURO,5,272,0,0
7172,2020-03-17T00:00:00Z,FI,Finland,EURO,47,319,0,0
7173,2020-03-18T00:00:00Z,FI,Finland,EURO,40,359,0,0
7174,2020-03-19T00:00:00Z,FI,Finland,EURO,10,369,0,0
7175,2020-03-20T00:00:00Z,FI,Finland,EURO,81,450,0,0
7176,2020-03-21T00:00:00Z,FI,Finland,EURO,71,521,1,1
7177,2020-03-22T00:00:00Z,FI,Finland,EURO,0,521,0,1
7178,2020-03-23T00:00:00Z,FI,Finland,EURO,105,626,0,1
7179,2020-03-24T00:00:00Z,FI,Finland,EURO,74,700,0,1
7180,2020-03-25T00:00:00Z,FI,Finland,EURO,92,792,0,1
7181,2020-03-26T00:00:00Z,FI,Finland,EURO,88,880,2,3
7182,2020-03-27T00:00:00Z,FI,Finland,EURO,78,958,1,4
7183,2020-03-28T00:00:00Z,FI,Finland,EURO,67,1025,3,7
7184,2020-03-29T00:00:00Z,FI,Finland,EURO,193,1218,2,9
7185,2020-03-30T00:00:00Z,FI,Finland,EURO,0,1218,2,11
7186,2020-03-31T00:00:00Z,FI,Finland,EURO,95,1313,2,13
7187,2020-04-01T00:00:00Z,FI,Finland,EURO,71,1384,4,17
7188,2020-04-02T00:00:00Z,FI,Finland,EURO,62,1446,0,17
7189,2020-04-03T00:00:00Z,FI,Finland,EURO,72,1518,2,19
7190,2020-04-04T00:00:00Z,FI,Finland,EURO,97,1615,1,20
7191,2020-04-05T00:00:00Z,FI,Finland,EURO,267,1882,5,25
7192,2020-04-06T00:00:00Z,FI,Finland,EURO,45,1927,3,28
7193,2020-04-07T00:00:00Z,FI,Finland,EURO,249,2176,0,28
7194,2020-04-08T00:00:00Z,FI,Finland,EURO,132,2308,6,34
7195,2020-04-09T00:00:00Z,FI,Finland,EURO,179,2487,6,40
7196,2020-04-10T00:00:00Z,FI,Finland,EURO,118,2605,2,42
7197,2020-04-11T00:00:00Z,FI,Finland,EURO,164,2769,6,48
7198,2020-04-12T00:00:00Z,FI,Finland,EURO,136,2905,1,49
7199,2020-04-13T00:00:00Z,FI,Finland,EURO,69,2974,7,56
7200,2020-04-14T00:00:00Z,FI,Finland,EURO,90,3064,3,59
7201,2020-04-15T00:00:00Z,FI,Finland,EURO,97,3161,5,64
7202,2020-04-16T00:00:00Z,FI,Finland,EURO,76,3237,8,72
7203,2020-04-17T00:00:00Z,FI,Finland,EURO,132,3369,3,75
7204,2020-04-18T00:00:00Z,FI,Finland,EURO,120,3489,7,82
7205,2020-04-19T00:00:00Z,FI,Finland,EURO,192,3681,8,90
7206,2020-04-20T00:00:00Z,FI,Finland,EURO,102,3783,4,94
7207,2020-04-21T00:00:00Z,FI,Finland,EURO,85,3868,4,98
7208,2020-04-22T00:00:00Z,FI,Finland,EURO,146,4014,43,141
7209,2020-04-23T00:00:00Z,FI,Finland,EURO,115,4129,8,149
7210,2020-04-24T00:00:00Z,FI,Finland,EURO,155,4284,23,172
7211,2020-04-25T00:00:00Z,FI,Finland,EURO,111,4395,5,177
7212,2020-04-26T00:00:00Z,FI,Finland,EURO,80,4475,9,186
7213,2020-04-27T00:00:00Z,FI,Finland,EURO,101,4576,4,190
7214,2020-04-28T00:00:00Z,FI,Finland,EURO,119,4695,3,193
7215,2020-04-29T00:00:00Z,FI,Finland,EURO,45,4740,6,199
7216,2020-04-30T00:00:00Z,FI,Finland,EURO,166,4906,7,206
7217,2020-05-01T00:00:00Z,FI,Finland,EURO,89,4995,5,211
7218,2020-05-02T00:00:00Z,FI,Finland,EURO,56,5051,7,218
7219,2020-05-03T00:00:00Z,FI,Finland,EURO,128,5179,2,220
7220,2020-05-04T00:00:00Z,FI,Finland,EURO,75,5254,10,230
7221,2020-05-05T00:00:00Z,FI,Finland,EURO,73,5327,10,240
7222,2020-05-06T00:00:00Z,FI,Finland,EURO,85,5412,6,246
7223,2020-05-07T00:00:00Z,FI,Finland,EURO,161,5573,6,252
7224,2020-05-08T00:00:00Z,FI,Finland,EURO,100,5673,3,255
7225,2020-05-09T00:00:00Z,FI,Finland,EURO,65,5738,5,260
7226,2020-05-10T00:00:00Z,FI,Finland,EURO,142,5880,5,265
7227,2020-05-11T00:00:00Z,FI,Finland,EURO,82,5962,2,267
7228,2020-05-12T00:00:00Z,FI,Finland,EURO,22,5984,4,271
7229,2020-05-13T00:00:00Z,FI,Finland,EURO,19,6003,4,275
7230,2020-05-14T00:00:00Z,FI,Finland,EURO,51,6054,9,284
7231,2020-05-15T00:00:00Z,FI,Finland,EURO,91,6145,3,287
7232,2020-05-16T00:00:00Z,FI,Finland,EURO,83,6228,6,293
7233,2020-05-17T00:00:00Z,FI,Finland,EURO,58,6286,4,297
7234,2020-05-18T00:00:00Z,FI,Finland,EURO,61,6347,1,298
7235,2020-05-19T00:00:00Z,FI,Finland,EURO,33,6380,2,300
7236,2020-05-20T00:00:00Z,FI,Finland,EURO,19,6399,1,301
7237,2020-05-21T00:00:00Z,FI,Finland,EURO,44,6443,3,304
7238,2020-05-22T00:00:00Z,FI,Finland,EURO,50,6493,2,306
7239,2020-05-23T00:00:00Z,FI,Finland,EURO,44,6537,0,306
7240,2020-05-24T00:00:00Z,FI,Finland,EURO,31,6568,0,306
7241,2020-05-25T00:00:00Z,FI,Finland,EURO,11,6579,1,307
7242,2020-05-26T00:00:00Z,FI,Finland,EURO,20,6599,1,308
7243,2020-05-27T00:00:00Z,FI,Finland,EURO,29,6628,4,312
7244,2020-05-28T00:00:00Z,FI,Finland,EURO,64,6692,1,313
7245,2020-05-29T00:00:00Z,FI,Finland,EURO,51,6743,0,313
7246,2020-05-30T00:00:00Z,FI,Finland,EURO,33,6776,1,314
7247,2020-05-31T00:00:00Z,FI,Finland,EURO,50,6826,2,316
7248,2020-06-01T00:00:00Z,FI,Finland,EURO,33,6859,4,320
7249,2020-06-02T00:00:00Z,FI,Finland,EURO,26,6885,0,320
7250,2020-06-03T00:00:00Z,FI,Finland,EURO,2,6887,0,320
7251,2020-06-04T00:00:00Z,FI,Finland,EURO,24,6911,1,321
7252,2020-06-05T00:00:00Z,FI,Finland,EURO,0,6911,1,322
7253,2020-06-06T00:00:00Z,FI,Finland,EURO,30,6941,0,322
7254,2020-06-07T00:00:00Z,FI,Finland,EURO,23,6964,0,322
7255,2020-06-08T00:00:00Z,FI,Finland,EURO,17,6981,1,323
7256,2020-06-09T00:00:00Z,FI,Finland,EURO,20,7001,0,323
7257,2020-06-10T00:00:00Z,FI,Finland,EURO,24,7025,1,324
7258,2020-06-11T00:00:00Z,FI,Finland,EURO,15,7040,0,324
7259,2020-06-12T00:00:00Z,FI,Finland,EURO,24,7064,1,325
7260,2020-06-13T00:00:00Z,FI,Finland,EURO,9,7073,0,325
7261,2020-06-14T00:00:00Z,FI,Finland,EURO,14,7087,0,325
7262,2020-06-15T00:00:00Z,FI,Finland,EURO,17,7104,1,326
7263,2020-06-16T00:00:00Z,FI,Finland,EURO,4,7108,0,326
7264,2020-06-17T00:00:00Z,FI,Finland,EURO,4,7112,0,326
7265,2020-06-18T00:00:00Z,FI,Finland,EURO,5,7117,0,326
7266,2020-06-19T00:00:00Z,FI,Finland,EURO,0,7117,0,326
7267,2020-06-20T00:00:00Z,FI,Finland,EURO,16,7133,0,326
7268,2020-01-24T00:00:00Z,FR,France,EURO,3,3,0,0
7269,2020-01-25T00:00:00Z,FR,France,EURO,0,3,0,0
7270,2020-01-26T00:00:00Z,FR,France,EURO,0,3,0,0
7271,2020-01-27T00:00:00Z,FR,France,EURO,0,3,0,0
7272,2020-01-28T00:00:00Z,FR,France,EURO,1,4,0,0
7273,2020-01-29T00:00:00Z,FR,France,EURO,0,4,0,0
7274,2020-01-30T00:00:00Z,FR,France,EURO,2,6,0,0
7275,2020-01-31T00:00:00Z,FR,France,EURO,0,6,0,0
7276,2020-02-01T00:00:00Z,FR,France,EURO,0,6,0,0
7277,2020-02-02T00:00:00Z,FR,France,EURO,0,6,0,0
7278,2020-02-03T00:00:00Z,FR,France,EURO,0,6,0,0
7279,2020-02-04T00:00:00Z,FR,France,EURO,0,6,0,0
7280,2020-02-05T00:00:00Z,FR,France,EURO,0,6,0,0
7281,2020-02-06T00:00:00Z,FR,France,EURO,0,6,0,0
7282,2020-02-07T00:00:00Z,FR,France,EURO,0,6,0,0
7283,2020-02-08T00:00:00Z,FR,France,EURO,5,11,0,0
7284,2020-02-09T00:00:00Z,FR,France,EURO,0,11,0,0
7285,2020-02-10T00:00:00Z,FR,France,EURO,0,11,0,0
7286,2020-02-11T00:00:00Z,FR,France,EURO,0,11,0,0
7287,2020-02-12T00:00:00Z,FR,France,EURO,0,11,0,0
7288,2020-02-13T00:00:00Z,FR,France,EURO,0,11,0,0
7289,2020-02-14T00:00:00Z,FR,France,EURO,0,11,0,0
7290,2020-02-15T00:00:00Z,FR,France,EURO,0,11,1,1
7291,2020-02-16T00:00:00Z,FR,France,EURO,1,12,0,1
7292,2020-02-17T00:00:00Z,FR,France,EURO,0,12,0,1
7293,2020-02-18T00:00:00Z,FR,France,EURO,0,12,0,1
7294,2020-02-19T00:00:00Z,FR,France,EURO,0,12,0,1
7295,2020-02-20T00:00:00Z,FR,France,EURO,0,12,0,1
7296,2020-02-21T00:00:00Z,FR,France,EURO,0,12,0,1
7297,2020-02-22T00:00:00Z,FR,France,EURO,0,12,0,1
7298,2020-02-23T00:00:00Z,FR,France,EURO,0,12,0,1
7299,2020-02-24T00:00:00Z,FR,France,EURO,0,12,0,1
7300,2020-02-25T00:00:00Z,FR,France,EURO,0,12,0,1
7301,2020-02-26T00:00:00Z,FR,France,EURO,6,18,1,2
7302,2020-02-27T00:00:00Z,FR,France,EURO,0,18,0,2
7303,2020-02-28T00:00:00Z,FR,France,EURO,39,57,0,2
7304,2020-02-29T00:00:00Z,FR,France,EURO,43,100,0,2
7305,2020-03-01T00:00:00Z,FR,France,EURO,0,100,0,2
7306,2020-03-02T00:00:00Z,FR,France,EURO,88,188,1,3
7307,2020-03-03T00:00:00Z,FR,France,EURO,21,209,1,4
7308,2020-03-04T00:00:00Z,FR,France,EURO,73,282,0,4
7309,2020-03-05T00:00:00Z,FR,France,EURO,138,420,2,6
7310,2020-03-06T00:00:00Z,FR,France,EURO,193,613,3,9
7311,2020-03-07T00:00:00Z,FR,France,EURO,93,706,1,10
7312,2020-03-08T00:00:00Z,FR,France,EURO,410,1116,9,19
7313,2020-03-09T00:00:00Z,FR,France,EURO,286,1402,11,30
7314,2020-03-10T00:00:00Z,FR,France,EURO,372,1774,3,33
7315,2020-03-11T00:00:00Z,FR,France,EURO,495,2269,15,48
7316,2020-03-12T00:00:00Z,FR,France,EURO,12,2281,0,48
7317,2020-03-13T00:00:00Z,FR,France,EURO,1359,3640,31,79
7318,2020-03-14T00:00:00Z,FR,France,EURO,829,4469,12,91
7319,2020-03-15T00:00:00Z,FR,France,EURO,911,5380,36,127
7320,2020-03-16T00:00:00Z,FR,France,EURO,1193,6573,21,148
7321,2020-03-17T00:00:00Z,FR,France,EURO,1079,7652,27,175
7322,2020-03-18T00:00:00Z,FR,France,EURO,1391,9043,69,244
7323,2020-03-19T00:00:00Z,FR,France,EURO,1834,10877,128,372
7324,2020-03-20T00:00:00Z,FR,France,EURO,1598,12475,78,450
7325,2020-03-21T00:00:00Z,FR,France,EURO,1821,14296,112,562
7326,2020-03-22T00:00:00Z,FR,France,EURO,0,14296,0,562
7327,2020-03-23T00:00:00Z,FR,France,EURO,1525,15821,112,674
7328,2020-03-24T00:00:00Z,FR,France,EURO,3794,19615,186,860
7329,2020-03-25T00:00:00Z,FR,France,EURO,2410,22025,240,1100
7330,2020-03-26T00:00:00Z,FR,France,EURO,2895,24920,231,1331
7331,2020-03-27T00:00:00Z,FR,France,EURO,3866,28786,364,1695
7332,2020-03-28T00:00:00Z,FR,France,EURO,3756,32542,297,1992
7333,2020-03-29T00:00:00Z,FR,France,EURO,4603,37145,319,2311
7334,2020-03-30T00:00:00Z,FR,France,EURO,2497,39642,291,2602
7335,2020-03-31T00:00:00Z,FR,France,EURO,4335,43977,415,3017
7336,2020-04-01T00:00:00Z,FR,France,EURO,7500,51477,497,3514
7337,2020-04-02T00:00:00Z,FR,France,EURO,4784,56261,505,4019
7338,2020-04-03T00:00:00Z,FR,France,EURO,2066,58327,471,4490
7339,2020-04-04T00:00:00Z,FR,France,EURO,5209,63536,2003,6493
7340,2020-04-05T00:00:00Z,FR,France,EURO,4221,67757,1053,7546
7341,2020-04-06T00:00:00Z,FR,France,EURO,1850,69607,518,8064
7342,2020-04-07T00:00:00Z,FR,France,EURO,3881,73488,832,8896
7343,2020-04-08T00:00:00Z,FR,France,EURO,3738,77226,1417,10313
7344,2020-04-09T00:00:00Z,FR,France,EURO,3869,81095,540,10853
7345,2020-04-10T00:00:00Z,FR,France,EURO,4256,85351,1339,12192
7346,2020-04-11T00:00:00Z,FR,France,EURO,4332,89683,987,13179
7347,2020-04-12T00:00:00Z,FR,France,EURO,3104,92787,635,13814
7348,2020-04-13T00:00:00Z,FR,France,EURO,1595,94382,560,14374
7349,2020-04-14T00:00:00Z,FR,France,EURO,2668,97050,572,14946
7350,2020-04-15T00:00:00Z,FR,France,EURO,5483,102533,762,15708
7351,2020-04-16T00:00:00Z,FR,France,EURO,2622,105155,1438,17146
7352,2020-04-17T00:00:00Z,FR,France,EURO,2623,107778,753,17899
7353,2020-04-18T00:00:00Z,FR,France,EURO,385,108163,760,18659
7354,2020-04-19T00:00:00Z,FR,France,EURO,2558,110721,635,19294
7355,2020-04-20T00:00:00Z,FR,France,EURO,742,111463,395,19689
7356,2020-04-21T00:00:00Z,FR,France,EURO,2050,113513,544,20233
7357,2020-04-22T00:00:00Z,FR,France,EURO,2638,116151,530,20763
7358,2020-04-23T00:00:00Z,FR,France,EURO,1810,117961,544,21307
7359,2020-04-24T00:00:00Z,FR,France,EURO,1622,119583,516,21823
7360,2020-04-25T00:00:00Z,FR,France,EURO,1755,121338,389,22212
7361,2020-04-26T00:00:00Z,FR,France,EURO,1537,122875,368,22580
7362,2020-04-27T00:00:00Z,FR,France,EURO,404,123279,241,22821
7363,2020-04-28T00:00:00Z,FR,France,EURO,1160,124439,440,23261
7364,2020-04-29T00:00:00Z,FR,France,EURO,1025,125464,366,23627
7365,2020-04-30T00:00:00Z,FR,France,EURO,1602,127066,427,24054
7366,2020-05-01T00:00:00Z,FR,France,EURO,1055,128121,288,24342
7367,2020-05-02T00:00:00Z,FR,France,EURO,601,128722,218,24560
7368,2020-05-03T00:00:00Z,FR,France,EURO,736,129458,164,24724
7369,2020-05-04T00:00:00Z,FR,France,EURO,250,129708,135,24859
7370,2020-05-05T00:00:00Z,FR,France,EURO,534,130242,306,25165
7371,2020-05-06T00:00:00Z,FR,France,EURO,1050,131292,326,25491
7372,2020-05-07T00:00:00Z,FR,France,EURO,4176,135468,278,25769
7373,2020-05-08T00:00:00Z,FR,France,EURO,512,135980,177,25946
7374,2020-05-09T00:00:00Z,FR,France,EURO,598,136578,242,26188
7375,2020-05-10T00:00:00Z,FR,France,EURO,430,137008,80,26268
7376,2020-05-11T00:00:00Z,FR,France,EURO,65,137073,70,26338
7377,2020-05-12T00:00:00Z,FR,France,EURO,418,137491,262,26600
7378,2020-05-13T00:00:00Z,FR,France,EURO,670,138161,348,26948
7379,2020-05-14T00:00:00Z,FR,France,EURO,448,138609,81,27029
7380,2020-05-15T00:00:00Z,FR,France,EURO,543,139152,349,27378
7381,2020-05-16T00:00:00Z,FR,France,EURO,494,139646,104,27482
7382,2020-05-17T00:00:00Z,FR,France,EURO,362,140008,96,27578
7383,2020-05-18T00:00:00Z,FR,France,EURO,28,140036,481,28059
7384,2020-05-19T00:00:00Z,FR,France,EURO,461,140497,131,28190
7385,2020-05-20T00:00:00Z,FR,France,EURO,462,140959,-218,27972
7386,2020-05-21T00:00:00Z,FR,France,EURO,353,141312,109,28081
7387,2020-05-22T00:00:00Z,FR,France,EURO,278,141590,83,28164
7388,2020-05-23T00:00:00Z,FR,France,EURO,359,141949,74,28238
7389,2020-05-24T00:00:00Z,FR,France,EURO,224,142173,43,28281
7390,2020-05-25T00:00:00Z,FR,France,EURO,31,142204,34,28315
7391,2020-05-26T00:00:00Z,FR,France,EURO,278,142482,64,28379
7392,2020-05-27T00:00:00Z,FR,France,EURO,222,142704,98,28477
7393,2020-05-28T00:00:00Z,FR,France,EURO,148,142852,66,28543
7394,2020-05-29T00:00:00Z,FR,France,EURO,3270,146122,65,28608
7395,2020-05-30T00:00:00Z,FR,France,EURO,535,146657,52,28660
7396,2020-05-31T00:00:00Z,FR,France,EURO,1779,148436,57,28717
7397,2020-06-01T00:00:00Z,FR,France,EURO,88,148524,29,28746
7398,2020-06-02T00:00:00Z,FR,France,EURO,251,148775,30,28776
7399,2020-06-03T00:00:00Z,FR,France,EURO,-840,147935,107,28883
7400,2020-06-04T00:00:00Z,FR,France,EURO,328,148263,81,28964
7401,2020-06-05T00:00:00Z,FR,France,EURO,678,148941,43,29007
7402,2020-06-06T00:00:00Z,FR,France,EURO,554,149495,46,29053
7403,2020-06-07T00:00:00Z,FR,France,EURO,527,150022,31,29084
7404,2020-06-08T00:00:00Z,FR,France,EURO,293,150315,13,29097
7405,2020-06-09T00:00:00Z,FR,France,EURO,98,150413,52,29149
7406,2020-06-10T00:00:00Z,FR,France,EURO,335,150748,85,29234
7407,2020-06-11T00:00:00Z,FR,France,EURO,397,151145,23,29257
7408,2020-06-12T00:00:00Z,FR,France,EURO,358,151503,27,29284
7409,2020-06-13T00:00:00Z,FR,France,EURO,564,152067,28,29312
7410,2020-06-14T00:00:00Z,FR,France,EURO,393,152460,23,29335
7411,2020-06-15T00:00:00Z,FR,France,EURO,307,152767,8,29343
7412,2020-06-16T00:00:00Z,FR,France,EURO,52,152819,30,29373
7413,2020-06-17T00:00:00Z,FR,France,EURO,226,153045,108,29481
7414,2020-06-18T00:00:00Z,FR,France,EURO,311,153356,28,29509
7415,2020-06-19T00:00:00Z,FR,France,EURO,201,153557,28,29537
7416,2020-06-20T00:00:00Z,FR,France,EURO,584,154141,14,29551
7818,2020-02-26T00:00:00Z,GE,Georgia,EURO,1,1,0,0
7819,2020-02-27T00:00:00Z,GE,Georgia,EURO,0,1,0,0
7820,2020-02-28T00:00:00Z,GE,Georgia,EURO,1,2,0,0
7821,2020-02-29T00:00:00Z,GE,Georgia,EURO,1,3,0,0
7822,2020-03-01T00:00:00Z,GE,Georgia,EURO,0,3,0,0
7823,2020-03-02T00:00:00Z,GE,Georgia,EURO,0,3,0,0
7824,2020-03-03T00:00:00Z,GE,Georgia,EURO,0,3,0,0
7825,2020-03-04T00:00:00Z,GE,Georgia,EURO,0,3,0,0
7826,2020-03-05T00:00:00Z,GE,Georgia,EURO,6,9,0,0
7827,2020-03-06T00:00:00Z,GE,Georgia,EURO,0,9,0,0
7828,2020-03-07T00:00:00Z,GE,Georgia,EURO,3,12,0,0
7829,2020-03-08T00:00:00Z,GE,Georgia,EURO,1,13,0,0
7830,2020-03-09T00:00:00Z,GE,Georgia,EURO,2,15,0,0
7831,2020-03-10T00:00:00Z,GE,Georgia,EURO,8,23,0,0
7832,2020-03-11T00:00:00Z,GE,Georgia,EURO,0,23,0,0
7833,2020-03-12T00:00:00Z,GE,Georgia,EURO,2,25,0,0
7834,2020-03-13T00:00:00Z,GE,Georgia,EURO,0,25,0,0
7835,2020-03-14T00:00:00Z,GE,Georgia,EURO,5,30,0,0
7836,2020-03-15T00:00:00Z,GE,Georgia,EURO,3,33,0,0
7837,2020-03-16T00:00:00Z,GE,Georgia,EURO,0,33,0,0
7838,2020-03-17T00:00:00Z,GE,Georgia,EURO,1,34,0,0
7839,2020-03-18T00:00:00Z,GE,Georgia,EURO,0,34,0,0
7840,2020-03-19T00:00:00Z,GE,Georgia,EURO,4,38,0,0
7841,2020-03-20T00:00:00Z,GE,Georgia,EURO,5,43,0,0
7842,2020-03-21T00:00:00Z,GE,Georgia,EURO,6,49,0,0
7843,2020-03-22T00:00:00Z,GE,Georgia,EURO,0,49,0,0
7844,2020-03-23T00:00:00Z,GE,Georgia,EURO,5,54,0,0
7845,2020-03-24T00:00:00Z,GE,Georgia,EURO,13,67,0,0
7846,2020-03-25T00:00:00Z,GE,Georgia,EURO,6,73,0,0
7847,2020-03-26T00:00:00Z,GE,Georgia,EURO,4,77,0,0
7848,2020-03-27T00:00:00Z,GE,Georgia,EURO,4,81,0,0
7849,2020-03-28T00:00:00Z,GE,Georgia,EURO,4,85,0,0
7850,2020-03-29T00:00:00Z,GE,Georgia,EURO,5,90,0,0
7851,2020-03-30T00:00:00Z,GE,Georgia,EURO,8,98,0,0
7852,2020-03-31T00:00:00Z,GE,Georgia,EURO,5,103,0,0
7853,2020-04-01T00:00:00Z,GE,Georgia,EURO,12,115,0,0
7854,2020-04-02T00:00:00Z,GE,Georgia,EURO,6,121,0,0
7855,2020-04-03T00:00:00Z,GE,Georgia,EURO,27,148,0,0
7856,2020-04-04T00:00:00Z,GE,Georgia,EURO,9,157,0,0
7857,2020-04-05T00:00:00Z,GE,Georgia,EURO,13,170,1,1
7858,2020-04-06T00:00:00Z,GE,Georgia,EURO,18,188,1,2
7859,2020-04-07T00:00:00Z,GE,Georgia,EURO,7,195,0,2
7860,2020-04-08T00:00:00Z,GE,Georgia,EURO,13,208,1,3
7861,2020-04-09T00:00:00Z,GE,Georgia,EURO,6,214,0,3
7862,2020-04-10T00:00:00Z,GE,Georgia,EURO,16,230,0,3
7863,2020-04-11T00:00:00Z,GE,Georgia,EURO,3,233,0,3
7864,2020-04-12T00:00:00Z,GE,Georgia,EURO,19,252,0,3
7865,2020-04-13T00:00:00Z,GE,Georgia,EURO,14,266,0,3
7866,2020-04-14T00:00:00Z,GE,Georgia,EURO,30,296,0,3
7867,2020-04-15T00:00:00Z,GE,Georgia,EURO,10,306,0,3
7868,2020-04-16T00:00:00Z,GE,Georgia,EURO,30,336,0,3
7869,2020-04-17T00:00:00Z,GE,Georgia,EURO,34,370,0,3
7870,2020-04-18T00:00:00Z,GE,Georgia,EURO,15,385,0,3
7871,2020-04-19T00:00:00Z,GE,Georgia,EURO,9,394,1,4
7872,2020-04-20T00:00:00Z,GE,Georgia,EURO,5,399,0,4
7873,2020-04-21T00:00:00Z,GE,Georgia,EURO,9,408,0,4
7874,2020-04-22T00:00:00Z,GE,Georgia,EURO,3,411,1,5
7875,2020-04-23T00:00:00Z,GE,Georgia,EURO,9,420,0,5
7876,2020-04-24T00:00:00Z,GE,Georgia,EURO,11,431,0,5
7877,2020-04-25T00:00:00Z,GE,Georgia,EURO,25,456,0,5
7878,2020-04-26T00:00:00Z,GE,Georgia,EURO,29,485,0,5
7879,2020-04-27T00:00:00Z,GE,Georgia,EURO,11,496,1,6
7880,2020-04-28T00:00:00Z,GE,Georgia,EURO,15,511,0,6
7881,2020-04-29T00:00:00Z,GE,Georgia,EURO,6,517,0,6
7882,2020-04-30T00:00:00Z,GE,Georgia,EURO,22,539,0,6
7883,2020-05-01T00:00:00Z,GE,Georgia,EURO,27,566,0,6
7884,2020-05-02T00:00:00Z,GE,Georgia,EURO,16,582,2,8
7885,2020-05-03T00:00:00Z,GE,Georgia,EURO,7,589,0,8
7886,2020-05-04T00:00:00Z,GE,Georgia,EURO,4,593,1,9
7887,2020-05-05T00:00:00Z,GE,Georgia,EURO,11,604,0,9
7888,2020-05-06T00:00:00Z,GE,Georgia,EURO,6,610,0,9
7889,2020-05-07T00:00:00Z,GE,Georgia,EURO,4,614,0,9
7890,2020-05-08T00:00:00Z,GE,Georgia,EURO,9,623,0,9
7891,2020-05-09T00:00:00Z,GE,Georgia,EURO,3,626,1,10
7892,2020-05-10T00:00:00Z,GE,Georgia,EURO,9,635,0,10
7893,2020-05-11T00:00:00Z,GE,Georgia,EURO,3,638,0,10
7894,2020-05-12T00:00:00Z,GE,Georgia,EURO,1,639,1,11
7895,2020-05-13T00:00:00Z,GE,Georgia,EURO,3,642,0,11
7896,2020-05-14T00:00:00Z,GE,Georgia,EURO,10,652,0,11
7897,2020-05-15T00:00:00Z,GE,Georgia,EURO,19,671,1,12
7898,2020-05-16T00:00:00Z,GE,Georgia,EURO,6,677,0,12
7899,2020-05-17T00:00:00Z,GE,Georgia,EURO,18,695,0,12
7900,2020-05-18T00:00:00Z,GE,Georgia,EURO,6,701,0,12
7901,2020-05-19T00:00:00Z,GE,Georgia,EURO,1,702,0,12
7902,2020-05-20T00:00:00Z,GE,Georgia,EURO,11,713,0,12
7903,2020-05-21T00:00:00Z,GE,Georgia,EURO,8,721,0,12
7904,2020-05-22T00:00:00Z,GE,Georgia,EURO,2,723,0,12
7905,2020-05-23T00:00:00Z,GE,Georgia,EURO,0,723,0,12
7906,2020-05-24T00:00:00Z,GE,Georgia,EURO,7,730,0,12
7907,2020-05-25T00:00:00Z,GE,Georgia,EURO,1,731,0,12
7908,2020-05-26T00:00:00Z,GE,Georgia,EURO,1,732,0,12
7909,2020-05-27T00:00:00Z,GE,Georgia,EURO,3,735,0,12
7910,2020-05-28T00:00:00Z,GE,Georgia,EURO,3,738,0,12
7911,2020-05-29T00:00:00Z,GE,Georgia,EURO,8,746,0,12
7912,2020-05-30T00:00:00Z,GE,Georgia,EURO,11,757,0,12
7913,2020-05-31T00:00:00Z,GE,Georgia,EURO,26,783,0,12
7914,2020-06-01T00:00:00Z,GE,Georgia,EURO,11,794,0,12
7915,2020-06-02T00:00:00Z,GE,Georgia,EURO,2,796,0,12
7916,2020-06-03T00:00:00Z,GE,Georgia,EURO,4,800,1,13
7917,2020-06-04T00:00:00Z,GE,Georgia,EURO,1,801,0,13
7918,2020-06-05T00:00:00Z,GE,Georgia,EURO,5,806,0,13
7919,2020-06-06T00:00:00Z,GE,Georgia,EURO,2,808,0,13
7920,2020-06-07T00:00:00Z,GE,Georgia,EURO,1,809,0,13
7921,2020-06-08T00:00:00Z,GE,Georgia,EURO,1,810,0,13
7922,2020-06-09T00:00:00Z,GE,Georgia,EURO,8,818,0,13
7923,2020-06-10T00:00:00Z,GE,Georgia,EURO,4,822,0,13
7924,2020-06-11T00:00:00Z,GE,Georgia,EURO,6,828,0,13
7925,2020-06-12T00:00:00Z,GE,Georgia,EURO,9,837,0,13
7926,2020-06-13T00:00:00Z,GE,Georgia,EURO,14,851,0,13
7927,2020-06-14T00:00:00Z,GE,Georgia,EURO,13,864,1,14
7928,2020-06-15T00:00:00Z,GE,Georgia,EURO,15,879,0,14
7929,2020-06-16T00:00:00Z,GE,Georgia,EURO,0,879,0,14
7930,2020-06-17T00:00:00Z,GE,Georgia,EURO,9,888,0,14
7931,2020-06-18T00:00:00Z,GE,Georgia,EURO,5,893,0,14
7932,2020-06-19T00:00:00Z,GE,Georgia,EURO,2,895,0,14
7933,2020-06-20T00:00:00Z,GE,Georgia,EURO,3,898,0,14
7934,2020-01-28T00:00:00Z,DE,Germany,EURO,4,4,0,0
7935,2020-01-29T00:00:00Z,DE,Germany,EURO,0,4,0,0
7936,2020-01-30T00:00:00Z,DE,Germany,EURO,0,4,0,0
7937,2020-01-31T00:00:00Z,DE,Germany,EURO,3,7,0,0
7938,2020-02-01T00:00:00Z,DE,Germany,EURO,1,8,0,0
7939,2020-02-02T00:00:00Z,DE,Germany,EURO,2,10,0,0
7940,2020-02-03T00:00:00Z,DE,Germany,EURO,0,10,0,0
7941,2020-02-04T00:00:00Z,DE,Germany,EURO,2,12,0,0
7942,2020-02-05T00:00:00Z,DE,Germany,EURO,0,12,0,0
7943,2020-02-06T00:00:00Z,DE,Germany,EURO,1,13,0,0
7944,2020-02-07T00:00:00Z,DE,Germany,EURO,1,14,0,0
7945,2020-02-08T00:00:00Z,DE,Germany,EURO,0,14,0,0
7946,2020-02-09T00:00:00Z,DE,Germany,EURO,0,14,0,0
7947,2020-02-10T00:00:00Z,DE,Germany,EURO,0,14,0,0
7948,2020-02-11T00:00:00Z,DE,Germany,EURO,2,16,0,0
7949,2020-02-12T00:00:00Z,DE,Germany,EURO,0,16,0,0
7950,2020-02-13T00:00:00Z,DE,Germany,EURO,0,16,0,0
7951,2020-02-14T00:00:00Z,DE,Germany,EURO,0,16,0,0
7952,2020-02-15T00:00:00Z,DE,Germany,EURO,0,16,0,0
7953,2020-02-16T00:00:00Z,DE,Germany,EURO,0,16,0,0
7954,2020-02-17T00:00:00Z,DE,Germany,EURO,0,16,0,0
7955,2020-02-18T00:00:00Z,DE,Germany,EURO,0,16,0,0
7956,2020-02-19T00:00:00Z,DE,Germany,EURO,0,16,0,0
7957,2020-02-20T00:00:00Z,DE,Germany,EURO,0,16,0,0
7958,2020-02-21T00:00:00Z,DE,Germany,EURO,0,16,0,0
7959,2020-02-22T00:00:00Z,DE,Germany,EURO,0,16,0,0
7960,2020-02-23T00:00:00Z,DE,Germany,EURO,0,16,0,0
7961,2020-02-24T00:00:00Z,DE,Germany,EURO,0,16,0,0
7962,2020-02-25T00:00:00Z,DE,Germany,EURO,2,18,0,0
7963,2020-02-26T00:00:00Z,DE,Germany,EURO,3,21,0,0
7964,2020-02-27T00:00:00Z,DE,Germany,EURO,5,26,0,0
7965,2020-02-28T00:00:00Z,DE,Germany,EURO,31,57,0,0
7966,2020-02-29T00:00:00Z,DE,Germany,EURO,0,57,0,0
7967,2020-03-01T00:00:00Z,DE,Germany,EURO,72,129,0,0
7968,2020-03-02T00:00:00Z,DE,Germany,EURO,29,158,0,0
7969,2020-03-03T00:00:00Z,DE,Germany,EURO,38,196,0,0
7970,2020-03-04T00:00:00Z,DE,Germany,EURO,66,262,0,0
7971,2020-03-05T00:00:00Z,DE,Germany,EURO,138,400,0,0
7972,2020-03-06T00:00:00Z,DE,Germany,EURO,239,639,0,0
7973,2020-03-07T00:00:00Z,DE,Germany,EURO,156,795,0,0
7974,2020-03-08T00:00:00Z,DE,Germany,EURO,107,902,0,0
7975,2020-03-09T00:00:00Z,DE,Germany,EURO,237,1139,2,2
7976,2020-03-10T00:00:00Z,DE,Germany,EURO,157,1296,0,2
7977,2020-03-11T00:00:00Z,DE,Germany,EURO,271,1567,1,3
7978,2020-03-12T00:00:00Z,DE,Germany,EURO,0,1567,0,3
7979,2020-03-13T00:00:00Z,DE,Germany,EURO,693,2260,0,3
7980,2020-03-14T00:00:00Z,DE,Germany,EURO,1535,3795,5,8
7981,2020-03-15T00:00:00Z,DE,Germany,EURO,1043,4838,4,12
7982,2020-03-16T00:00:00Z,DE,Germany,EURO,1174,6012,0,12
7983,2020-03-17T00:00:00Z,DE,Germany,EURO,1144,7156,0,12
7984,2020-03-18T00:00:00Z,DE,Germany,EURO,1042,8198,0,12
7985,2020-03-19T00:00:00Z,DE,Germany,EURO,2801,10999,8,20
7986,2020-03-20T00:00:00Z,DE,Germany,EURO,7324,18323,25,45
7987,2020-03-21T00:00:00Z,DE,Germany,EURO,3140,21463,22,67
7988,2020-03-22T00:00:00Z,DE,Germany,EURO,0,21463,0,67
7989,2020-03-23T00:00:00Z,DE,Germany,EURO,3311,24774,27,94
7990,2020-03-24T00:00:00Z,DE,Germany,EURO,4438,29212,32,126
7991,2020-03-25T00:00:00Z,DE,Germany,EURO,2342,31554,23,149
7992,2020-03-26T00:00:00Z,DE,Germany,EURO,4954,36508,49,198
7993,2020-03-27T00:00:00Z,DE,Germany,EURO,5780,42288,55,253
7994,2020-03-28T00:00:00Z,DE,Germany,EURO,6294,48582,72,325
7995,2020-03-29T00:00:00Z,DE,Germany,EURO,3965,52547,64,389
7996,2020-03-30T00:00:00Z,DE,Germany,EURO,4751,57298,66,455
7997,2020-03-31T00:00:00Z,DE,Germany,EURO,4615,61913,128,583
7998,2020-04-01T00:00:00Z,DE,Germany,EURO,5453,67366,149,732
7999,2020-04-02T00:00:00Z,DE,Germany,EURO,6156,73522,140,872
8000,2020-04-03T00:00:00Z,DE,Germany,EURO,6174,79696,145,1017
8001,2020-04-04T00:00:00Z,DE,Germany,EURO,6082,85778,141,1158
8002,2020-04-05T00:00:00Z,DE,Germany,EURO,5936,91714,184,1342
8003,2020-04-06T00:00:00Z,DE,Germany,EURO,3677,95391,92,1434
8004,2020-04-07T00:00:00Z,DE,Germany,EURO,3834,99225,173,1607
8005,2020-04-08T00:00:00Z,DE,Germany,EURO,4003,103228,254,1861
8006,2020-04-09T00:00:00Z,DE,Germany,EURO,4974,108202,246,2107
8007,2020-04-10T00:00:00Z,DE,Germany,EURO,5323,113525,266,2373
8008,2020-04-11T00:00:00Z,DE,Germany,EURO,4133,117658,171,2544
8009,2020-04-12T00:00:00Z,DE,Germany,EURO,2821,120479,129,2673
8010,2020-04-13T00:00:00Z,DE,Germany,EURO,2537,123016,126,2799
8011,2020-04-14T00:00:00Z,DE,Germany,EURO,2082,125098,170,2969
8012,2020-04-15T00:00:00Z,DE,Germany,EURO,2486,127584,285,3254
8013,2020-04-16T00:00:00Z,DE,Germany,EURO,2866,130450,315,3569
8014,2020-04-17T00:00:00Z,DE,Germany,EURO,3380,133830,299,3868
8015,2020-04-18T00:00:00Z,DE,Germany,EURO,3609,137439,242,4110
8016,2020-04-19T00:00:00Z,DE,Germany,EURO,2458,139897,184,4294
8017,2020-04-20T00:00:00Z,DE,Germany,EURO,1775,141672,110,4404
8018,2020-04-21T00:00:00Z,DE,Germany,EURO,1785,143457,194,4598
8019,2020-04-22T00:00:00Z,DE,Germany,EURO,2237,145694,281,4879
8020,2020-04-23T00:00:00Z,DE,Germany,EURO,2352,148046,215,5094
8021,2020-04-24T00:00:00Z,DE,Germany,EURO,2337,150383,227,5321
8022,2020-04-25T00:00:00Z,DE,Germany,EURO,2055,152438,179,5500
8023,2020-04-26T00:00:00Z,DE,Germany,EURO,1737,154175,140,5640
8024,2020-04-27T00:00:00Z,DE,Germany,EURO,1018,155193,110,5750
8025,2020-04-28T00:00:00Z,DE,Germany,EURO,1144,156337,163,5913
8026,2020-04-29T00:00:00Z,DE,Germany,EURO,1304,157641,202,6115
8027,2020-04-30T00:00:00Z,DE,Germany,EURO,1478,159119,173,6288
8028,2020-05-01T00:00:00Z,DE,Germany,EURO,0,159119,0,6288
8029,2020-05-02T00:00:00Z,DE,Germany,EURO,2584,161703,287,6575
8030,2020-05-03T00:00:00Z,DE,Germany,EURO,793,162496,74,6649
8031,2020-05-04T00:00:00Z,DE,Germany,EURO,679,163175,43,6692
8032,2020-05-05T00:00:00Z,DE,Germany,EURO,685,163860,139,6831
8033,2020-05-06T00:00:00Z,DE,Germany,EURO,1037,164897,165,6996
8034,2020-05-07T00:00:00Z,DE,Germany,EURO,1194,166091,123,7119
8035,2020-05-08T00:00:00Z,DE,Germany,EURO,1209,167300,147,7266
8036,2020-05-09T00:00:00Z,DE,Germany,EURO,1251,168551,103,7369
8037,2020-05-10T00:00:00Z,DE,Germany,EURO,667,169218,26,7395
8038,2020-05-11T00:00:00Z,DE,Germany,EURO,357,169575,22,7417
8039,2020-05-12T00:00:00Z,DE,Germany,EURO,933,170508,116,7533
8040,2020-05-13T00:00:00Z,DE,Germany,EURO,798,171306,101,7634
8041,2020-05-14T00:00:00Z,DE,Germany,EURO,933,172239,89,7723
8042,2020-05-15T00:00:00Z,DE,Germany,EURO,913,173152,101,7824
8043,2020-05-16T00:00:00Z,DE,Germany,EURO,620,173772,57,7881
8044,2020-05-17T00:00:00Z,DE,Germany,EURO,583,174355,33,7914
8045,2020-05-18T00:00:00Z,DE,Germany,EURO,342,174697,21,7935
8046,2020-05-19T00:00:00Z,DE,Germany,EURO,513,175210,72,8007
8047,2020-05-20T00:00:00Z,DE,Germany,EURO,797,176007,83,8090
8048,2020-05-21T00:00:00Z,DE,Germany,EURO,745,176752,57,8147
8049,2020-05-22T00:00:00Z,DE,Germany,EURO,460,177212,27,8174
8050,2020-05-23T00:00:00Z,DE,Germany,EURO,638,177850,42,8216
8051,2020-05-24T00:00:00Z,DE,Germany,EURO,431,178281,31,8247
8052,2020-05-25T00:00:00Z,DE,Germany,EURO,289,178570,10,8257
8053,2020-05-26T00:00:00Z,DE,Germany,EURO,432,179002,45,8302
8054,2020-05-27T00:00:00Z,DE,Germany,EURO,362,179364,47,8349
8055,2020-05-28T00:00:00Z,DE,Germany,EURO,353,179717,62,8411
8056,2020-05-29T00:00:00Z,DE,Germany,EURO,741,180458,39,8450
8057,2020-05-30T00:00:00Z,DE,Germany,EURO,738,181196,39,8489
8058,2020-05-31T00:00:00Z,DE,Germany,EURO,286,181482,11,8500
8059,2020-06-01T00:00:00Z,DE,Germany,EURO,333,181815,11,8511
8060,2020-06-02T00:00:00Z,DE,Germany,EURO,213,182028,11,8522
8061,2020-06-03T00:00:00Z,DE,Germany,EURO,342,182370,29,8551
8062,2020-06-04T00:00:00Z,DE,Germany,EURO,394,182764,30,8581
8063,2020-06-05T00:00:00Z,DE,Germany,EURO,507,183271,32,8613
8064,2020-06-06T00:00:00Z,DE,Germany,EURO,407,183678,33,8646
8065,2020-06-07T00:00:00Z,DE,Germany,EURO,301,183979,22,8668
8066,2020-06-08T00:00:00Z,DE,Germany,EURO,214,184193,6,8674
8067,2020-06-09T00:00:00Z,DE,Germany,EURO,350,184543,37,8711
8068,2020-06-10T00:00:00Z,DE,Germany,EURO,318,184861,18,8729
8069,2020-06-11T00:00:00Z,DE,Germany,EURO,555,185416,26,8755
8070,2020-06-12T00:00:00Z,DE,Germany,EURO,258,185674,8,8763
8071,2020-06-13T00:00:00Z,DE,Germany,EURO,348,186022,18,8781
8072,2020-06-14T00:00:00Z,DE,Germany,EURO,247,186269,6,8787
8073,2020-06-15T00:00:00Z,DE,Germany,EURO,192,186461,4,8791
8074,2020-06-16T00:00:00Z,DE,Germany,EURO,378,186839,9,8800
8075,2020-06-17T00:00:00Z,DE,Germany,EURO,345,187184,30,8830
8076,2020-06-18T00:00:00Z,DE,Germany,EURO,580,187764,26,8856
8077,2020-06-19T00:00:00Z,DE,Germany,EURO,770,188534,16,8872
8078,2020-06-20T00:00:00Z,DE,Germany,EURO,601,189135,11,8883
8178,2020-03-03T00:00:00Z,GI,Gibraltar,EURO,1,1,0,0
8179,2020-03-04T00:00:00Z,GI,Gibraltar,EURO,0,1,0,0
8180,2020-03-05T00:00:00Z,GI,Gibraltar,EURO,0,1,0,0
8181,2020-03-06T00:00:00Z,GI,Gibraltar,EURO,0,1,0,0
8182,2020-03-07T00:00:00Z,GI,Gibraltar,EURO,0,1,0,0
8183,2020-03-08T00:00:00Z,GI,Gibraltar,EURO,0,1,0,0
8184,2020-03-09T00:00:00Z,GI,Gibraltar,EURO,0,1,0,0
8185,2020-03-10T00:00:00Z,GI,Gibraltar,EURO,0,1,0,0
8186,2020-03-11T00:00:00Z,GI,Gibraltar,EURO,0,1,0,0
8187,2020-03-12T00:00:00Z,GI,Gibraltar,EURO,0,1,0,0
8188,2020-03-13T00:00:00Z,GI,Gibraltar,EURO,0,1,0,0
8189,2020-03-14T00:00:00Z,GI,Gibraltar,EURO,0,1,0,0
8190,2020-03-15T00:00:00Z,GI,Gibraltar,EURO,0,1,0,0
8191,2020-03-16T00:00:00Z,GI,Gibraltar,EURO,2,3,0,0
8192,2020-03-17T00:00:00Z,GI,Gibraltar,EURO,0,3,0,0
8193,2020-03-18T00:00:00Z,GI,Gibraltar,EURO,5,8,0,0
8194,2020-03-19T00:00:00Z,GI,Gibraltar,EURO,2,10,0,0
8195,2020-03-20T00:00:00Z,GI,Gibraltar,EURO,0,10,0,0
8196,2020-03-21T00:00:00Z,GI,Gibraltar,EURO,0,10,0,0
8197,2020-03-22T00:00:00Z,GI,Gibraltar,EURO,0,10,0,0
8198,2020-03-23T00:00:00Z,GI,Gibraltar,EURO,5,15,0,0
8199,2020-03-24T00:00:00Z,GI,Gibraltar,EURO,0,15,0,0
8200,2020-03-25T00:00:00Z,GI,Gibraltar,EURO,0,15,0,0
8201,2020-03-26T00:00:00Z,GI,Gibraltar,EURO,11,26,0,0
8202,2020-03-27T00:00:00Z,GI,Gibraltar,EURO,9,35,0,0
8203,2020-03-28T00:00:00Z,GI,Gibraltar,EURO,20,55,0,0
8204,2020-03-29T00:00:00Z,GI,Gibraltar,EURO,1,56,0,0
8205,2020-03-30T00:00:00Z,GI,Gibraltar,EURO,9,65,0,0
8206,2020-03-31T00:00:00Z,GI,Gibraltar,EURO,4,69,0,0
8207,2020-04-01T00:00:00Z,GI,Gibraltar,EURO,0,69,0,0
8208,2020-04-02T00:00:00Z,GI,Gibraltar,EURO,0,69,0,0
8209,2020-04-03T00:00:00Z,GI,Gibraltar,EURO,12,81,0,0
8210,2020-04-04T00:00:00Z,GI,Gibraltar,EURO,14,95,0,0
8211,2020-04-05T00:00:00Z,GI,Gibraltar,EURO,3,98,0,0
8212,2020-04-06T00:00:00Z,GI,Gibraltar,EURO,5,103,0,0
8213,2020-04-07T00:00:00Z,GI,Gibraltar,EURO,0,103,0,0
8214,2020-04-08T00:00:00Z,GI,Gibraltar,EURO,10,113,0,0
8215,2020-04-09T00:00:00Z,GI,Gibraltar,EURO,0,113,0,0
8216,2020-04-10T00:00:00Z,GI,Gibraltar,EURO,0,113,0,0
8217,2020-04-11T00:00:00Z,GI,Gibraltar,EURO,0,113,0,0
8218,2020-04-12T00:00:00Z,GI,Gibraltar,EURO,0,113,0,0
8219,2020-04-13T00:00:00Z,GI,Gibraltar,EURO,16,129,0,0
8220,2020-04-14T00:00:00Z,GI,Gibraltar,EURO,0,129,0,0
8221,2020-04-15T00:00:00Z,GI,Gibraltar,EURO,0,129,0,0
8222,2020-04-16T00:00:00Z,GI,Gibraltar,EURO,0,129,0,0
8223,2020-04-17T00:00:00Z,GI,Gibraltar,EURO,2,131,0,0
8224,2020-04-18T00:00:00Z,GI,Gibraltar,EURO,2,133,0,0
8225,2020-04-19T00:00:00Z,GI,Gibraltar,EURO,0,133,0,0
8226,2020-04-20T00:00:00Z,GI,Gibraltar,EURO,0,133,0,0
8227,2020-04-21T00:00:00Z,GI,Gibraltar,EURO,0,133,0,0
8228,2020-04-22T00:00:00Z,GI,Gibraltar,EURO,0,133,0,0
8229,2020-04-23T00:00:00Z,GI,Gibraltar,EURO,0,133,0,0
8230,2020-04-24T00:00:00Z,GI,Gibraltar,EURO,0,133,0,0
8231,2020-04-25T00:00:00Z,GI,Gibraltar,EURO,0,133,0,0
8232,2020-04-26T00:00:00Z,GI,Gibraltar,EURO,3,136,0,0
8233,2020-04-27T00:00:00Z,GI,Gibraltar,EURO,5,141,0,0
8234,2020-04-28T00:00:00Z,GI,Gibraltar,EURO,0,141,0,0
8235,2020-04-29T00:00:00Z,GI,Gibraltar,EURO,0,141,0,0
8236,2020-04-30T00:00:00Z,GI,Gibraltar,EURO,0,141,0,0
8237,2020-05-01T00:00:00Z,GI,Gibraltar,EURO,0,141,0,0
8238,2020-05-02T00:00:00Z,GI,Gibraltar,EURO,3,144,0,0
8239,2020-05-03T00:00:00Z,GI,Gibraltar,EURO,0,144,0,0
8240,2020-05-04T00:00:00Z,GI,Gibraltar,EURO,0,144,0,0
8241,2020-05-05T00:00:00Z,GI,Gibraltar,EURO,0,144,0,0
8242,2020-05-06T00:00:00Z,GI,Gibraltar,EURO,0,144,0,0
8243,2020-05-07T00:00:00Z,GI,Gibraltar,EURO,0,144,0,0
8244,2020-05-08T00:00:00Z,GI,Gibraltar,EURO,0,144,0,0
8245,2020-05-09T00:00:00Z,GI,Gibraltar,EURO,0,144,0,0
8246,2020-05-10T00:00:00Z,GI,Gibraltar,EURO,2,146,0,0
8247,2020-05-11T00:00:00Z,GI,Gibraltar,EURO,0,146,0,0
8248,2020-05-12T00:00:00Z,GI,Gibraltar,EURO,0,146,0,0
8249,2020-05-13T00:00:00Z,GI,Gibraltar,EURO,1,147,0,0
8250,2020-05-14T00:00:00Z,GI,Gibraltar,EURO,0,147,0,0
8251,2020-05-15T00:00:00Z,GI,Gibraltar,EURO,0,147,0,0
8252,2020-05-16T00:00:00Z,GI,Gibraltar,EURO,0,147,0,0
8253,2020-05-17T00:00:00Z,GI,Gibraltar,EURO,0,147,0,0
8254,2020-05-18T00:00:00Z,GI,Gibraltar,EURO,0,147,0,0
8255,2020-05-19T00:00:00Z,GI,Gibraltar,EURO,0,147,0,0
8256,2020-05-20T00:00:00Z,GI,Gibraltar,EURO,0,147,0,0
8257,2020-05-21T00:00:00Z,GI,Gibraltar,EURO,0,147,0,0
8258,2020-05-22T00:00:00Z,GI,Gibraltar,EURO,2,149,0,0
8259,2020-05-23T00:00:00Z,GI,Gibraltar,EURO,2,151,0,0
8260,2020-05-24T00:00:00Z,GI,Gibraltar,EURO,0,151,0,0
8261,2020-05-25T00:00:00Z,GI,Gibraltar,EURO,3,154,0,0
8262,2020-05-26T00:00:00Z,GI,Gibraltar,EURO,0,154,0,0
8263,2020-05-27T00:00:00Z,GI,Gibraltar,EURO,0,154,0,0
8264,2020-05-28T00:00:00Z,GI,Gibraltar,EURO,0,154,0,0
8265,2020-05-29T00:00:00Z,GI,Gibraltar,EURO,3,157,0,0
8266,2020-05-30T00:00:00Z,GI,Gibraltar,EURO,1,158,0,0
8267,2020-05-31T00:00:00Z,GI,Gibraltar,EURO,3,161,0,0
8268,2020-06-01T00:00:00Z,GI,Gibraltar,EURO,8,169,0,0
8269,2020-06-02T00:00:00Z,GI,Gibraltar,EURO,1,170,0,0
8270,2020-06-03T00:00:00Z,GI,Gibraltar,EURO,0,170,0,0
8271,2020-06-04T00:00:00Z,GI,Gibraltar,EURO,2,172,0,0
8272,2020-06-05T00:00:00Z,GI,Gibraltar,EURO,1,173,0,0
8273,2020-06-06T00:00:00Z,GI,Gibraltar,EURO,1,174,0,0
8274,2020-06-07T00:00:00Z,GI,Gibraltar,EURO,0,174,0,0
8275,2020-06-08T00:00:00Z,GI,Gibraltar,EURO,1,175,0,0
8276,2020-06-09T00:00:00Z,GI,Gibraltar,EURO,1,176,0,0
8277,2020-06-10T00:00:00Z,GI,Gibraltar,EURO,0,176,0,0
8278,2020-06-11T00:00:00Z,GI,Gibraltar,EURO,0,176,0,0
8279,2020-06-12T00:00:00Z,GI,Gibraltar,EURO,0,176,0,0
8280,2020-06-13T00:00:00Z,GI,Gibraltar,EURO,0,176,0,0
8281,2020-06-14T00:00:00Z,GI,Gibraltar,EURO,0,176,0,0
8282,2020-06-15T00:00:00Z,GI,Gibraltar,EURO,0,176,0,0
8283,2020-06-16T00:00:00Z,GI,Gibraltar,EURO,0,176,0,0
8284,2020-06-17T00:00:00Z,GI,Gibraltar,EURO,0,176,0,0
8285,2020-06-18T00:00:00Z,GI,Gibraltar,EURO,0,176,0,0
8286,2020-06-19T00:00:00Z,GI,Gibraltar,EURO,0,176,0,0
8287,2020-06-20T00:00:00Z,GI,Gibraltar,EURO,0,176,0,0
8288,2020-02-26T00:00:00Z,GR,Greece,EURO,1,1,0,0
8289,2020-02-27T00:00:00Z,GR,Greece,EURO,2,3,0,0
8290,2020-02-28T00:00:00Z,GR,Greece,EURO,0,3,0,0
8291,2020-02-29T00:00:00Z,GR,Greece,EURO,0,3,0,0
8292,2020-03-01T00:00:00Z,GR,Greece,EURO,4,7,0,0
8293,2020-03-02T00:00:00Z,GR,Greece,EURO,0,7,0,0
8294,2020-03-03T00:00:00Z,GR,Greece,EURO,0,7,0,0
8295,2020-03-04T00:00:00Z,GR,Greece,EURO,2,9,0,0
8296,2020-03-05T00:00:00Z,GR,Greece,EURO,23,32,0,0
8297,2020-03-06T00:00:00Z,GR,Greece,EURO,0,32,0,0
8298,2020-03-07T00:00:00Z,GR,Greece,EURO,34,66,0,0
8299,2020-03-08T00:00:00Z,GR,Greece,EURO,7,73,0,0
8300,2020-03-09T00:00:00Z,GR,Greece,EURO,0,73,0,0
8301,2020-03-10T00:00:00Z,GR,Greece,EURO,17,90,0,0
8302,2020-03-11T00:00:00Z,GR,Greece,EURO,0,90,0,0
8303,2020-03-12T00:00:00Z,GR,Greece,EURO,9,99,1,1
8304,2020-03-13T00:00:00Z,GR,Greece,EURO,0,99,0,1
8305,2020-03-14T00:00:00Z,GR,Greece,EURO,129,228,0,1
8306,2020-03-15T00:00:00Z,GR,Greece,EURO,103,331,3,4
8307,2020-03-16T00:00:00Z,GR,Greece,EURO,0,331,0,4
8308,2020-03-17T00:00:00Z,GR,Greece,EURO,56,387,0,4
8309,2020-03-18T00:00:00Z,GR,Greece,EURO,31,418,1,5
8310,2020-03-19T00:00:00Z,GR,Greece,EURO,0,418,0,5
8311,2020-03-20T00:00:00Z,GR,Greece,EURO,77,495,3,8
8312,2020-03-21T00:00:00Z,GR,Greece,EURO,35,530,5,13
8313,2020-03-22T00:00:00Z,GR,Greece,EURO,0,530,0,13
8314,2020-03-23T00:00:00Z,GR,Greece,EURO,94,624,2,15
8315,2020-03-24T00:00:00Z,GR,Greece,EURO,71,695,2,17
8316,2020-03-25T00:00:00Z,GR,Greece,EURO,48,743,3,20
8317,2020-03-26T00:00:00Z,GR,Greece,EURO,78,821,2,22
8318,2020-03-27T00:00:00Z,GR,Greece,EURO,71,892,4,26
8319,2020-03-28T00:00:00Z,GR,Greece,EURO,74,966,2,28
8320,2020-03-29T00:00:00Z,GR,Greece,EURO,95,1061,4,32
8321,2020-03-30T00:00:00Z,GR,Greece,EURO,95,1156,6,38
8322,2020-03-31T00:00:00Z,GR,Greece,EURO,56,1212,5,43
8323,2020-04-01T00:00:00Z,GR,Greece,EURO,102,1314,6,49
8324,2020-04-02T00:00:00Z,GR,Greece,EURO,61,1375,1,50
8325,2020-04-03T00:00:00Z,GR,Greece,EURO,139,1514,3,53
8326,2020-04-04T00:00:00Z,GR,Greece,EURO,99,1613,6,59
8327,2020-04-05T00:00:00Z,GR,Greece,EURO,60,1673,9,68
8328,2020-04-06T00:00:00Z,GR,Greece,EURO,62,1735,5,73
8329,2020-04-07T00:00:00Z,GR,Greece,EURO,20,1755,6,79
8330,2020-04-08T00:00:00Z,GR,Greece,EURO,77,1832,2,81
8331,2020-04-09T00:00:00Z,GR,Greece,EURO,52,1884,2,83
8332,2020-04-10T00:00:00Z,GR,Greece,EURO,71,1955,3,86
8333,2020-04-11T00:00:00Z,GR,Greece,EURO,56,2011,4,90
8334,2020-04-12T00:00:00Z,GR,Greece,EURO,70,2081,3,93
8335,2020-04-13T00:00:00Z,GR,Greece,EURO,33,2114,5,98
8336,2020-04-14T00:00:00Z,GR,Greece,EURO,31,2145,1,99
8337,2020-04-15T00:00:00Z,GR,Greece,EURO,25,2170,2,101
8338,2020-04-16T00:00:00Z,GR,Greece,EURO,22,2192,1,102
8339,2020-04-17T00:00:00Z,GR,Greece,EURO,15,2207,3,105
8340,2020-04-18T00:00:00Z,GR,Greece,EURO,0,2207,0,105
8341,2020-04-19T00:00:00Z,GR,Greece,EURO,0,2207,0,105
8342,2020-04-20T00:00:00Z,GR,Greece,EURO,28,2235,5,110
8343,2020-04-21T00:00:00Z,GR,Greece,EURO,10,2245,6,116
8344,2020-04-22T00:00:00Z,GR,Greece,EURO,156,2401,5,121
8345,2020-04-23T00:00:00Z,GR,Greece,EURO,7,2408,0,121
8346,2020-04-24T00:00:00Z,GR,Greece,EURO,55,2463,4,125
8347,2020-04-25T00:00:00Z,GR,Greece,EURO,27,2490,5,130
8348,2020-04-26T00:00:00Z,GR,Greece,EURO,16,2506,0,130
8349,2020-04-27T00:00:00Z,GR,Greece,EURO,0,2506,0,130
8350,2020-04-28T00:00:00Z,GR,Greece,EURO,28,2534,6,136
8351,2020-04-29T00:00:00Z,GR,Greece,EURO,0,2534,0,136
8352,2020-04-30T00:00:00Z,GR,Greece,EURO,42,2576,3,139
8353,2020-05-01T00:00:00Z,GR,Greece,EURO,15,2591,1,140
8354,2020-05-02T00:00:00Z,GR,Greece,EURO,0,2591,0,140
8355,2020-05-03T00:00:00Z,GR,Greece,EURO,29,2620,3,143
8356,2020-05-04T00:00:00Z,GR,Greece,EURO,6,2626,1,144
8357,2020-05-05T00:00:00Z,GR,Greece,EURO,6,2632,2,146
8358,2020-05-06T00:00:00Z,GR,Greece,EURO,10,2642,0,146
8359,2020-05-07T00:00:00Z,GR,Greece,EURO,21,2663,1,147
8360,2020-05-08T00:00:00Z,GR,Greece,EURO,15,2678,1,148
8361,2020-05-09T00:00:00Z,GR,Greece,EURO,13,2691,2,150
8362,2020-05-10T00:00:00Z,GR,Greece,EURO,19,2710,1,151
8363,2020-05-11T00:00:00Z,GR,Greece,EURO,6,2716,0,151
8364,2020-05-12T00:00:00Z,GR,Greece,EURO,10,2726,0,151
8365,2020-05-13T00:00:00Z,GR,Greece,EURO,18,2744,1,152
8366,2020-05-14T00:00:00Z,GR,Greece,EURO,16,2760,3,155
8367,2020-05-15T00:00:00Z,GR,Greece,EURO,10,2770,1,156
8368,2020-05-16T00:00:00Z,GR,Greece,EURO,40,2810,4,160
8369,2020-05-17T00:00:00Z,GR,Greece,EURO,9,2819,2,162
8370,2020-05-18T00:00:00Z,GR,Greece,EURO,15,2834,1,163
8371,2020-05-19T00:00:00Z,GR,Greece,EURO,2,2836,2,165
8372,2020-05-20T00:00:00Z,GR,Greece,EURO,4,2840,0,165
8373,2020-05-21T00:00:00Z,GR,Greece,EURO,10,2850,1,166
8374,2020-05-22T00:00:00Z,GR,Greece,EURO,3,2853,2,168
8375,2020-05-23T00:00:00Z,GR,Greece,EURO,20,2873,1,169
8376,2020-05-24T00:00:00Z,GR,Greece,EURO,3,2876,2,171
8377,2020-05-25T00:00:00Z,GR,Greece,EURO,2,2878,0,171
8378,2020-05-26T00:00:00Z,GR,Greece,EURO,4,2882,1,172
8379,2020-05-27T00:00:00Z,GR,Greece,EURO,10,2892,1,173
8380,2020-05-28T00:00:00Z,GR,Greece,EURO,11,2903,0,173
8381,2020-05-29T00:00:00Z,GR,Greece,EURO,3,2906,2,175
8382,2020-05-30T00:00:00Z,GR,Greece,EURO,3,2909,0,175
8383,2020-05-31T00:00:00Z,GR,Greece,EURO,6,2915,0,175
8384,2020-06-01T00:00:00Z,GR,Greece,EURO,2,2917,0,175
8385,2020-06-02T00:00:00Z,GR,Greece,EURO,0,2917,0,175
8386,2020-06-03T00:00:00Z,GR,Greece,EURO,1,2918,4,179
8387,2020-06-04T00:00:00Z,GR,Greece,EURO,19,2937,0,179
8388,2020-06-05T00:00:00Z,GR,Greece,EURO,0,2937,0,179
8389,2020-06-06T00:00:00Z,GR,Greece,EURO,0,2937,0,179
8390,2020-06-07T00:00:00Z,GR,Greece,EURO,15,2952,1,180
8391,2020-06-08T00:00:00Z,GR,Greece,EURO,0,2952,0,180
8392,2020-06-09T00:00:00Z,GR,Greece,EURO,97,3049,2,182
8393,2020-06-10T00:00:00Z,GR,Greece,EURO,9,3058,1,183
8394,2020-06-11T00:00:00Z,GR,Greece,EURO,10,3068,0,183
8395,2020-06-12T00:00:00Z,GR,Greece,EURO,20,3088,0,183
8396,2020-06-13T00:00:00Z,GR,Greece,EURO,20,3108,0,183
8397,2020-06-14T00:00:00Z,GR,Greece,EURO,4,3112,0,183
8398,2020-06-15T00:00:00Z,GR,Greece,EURO,9,3121,0,183
8399,2020-06-16T00:00:00Z,GR,Greece,EURO,13,3134,1,184
8400,2020-06-17T00:00:00Z,GR,Greece,EURO,14,3148,1,185
8401,2020-06-18T00:00:00Z,GR,Greece,EURO,55,3203,2,187
8402,2020-06-19T00:00:00Z,GR,Greece,EURO,24,3227,1,188
8403,2020-06-20T00:00:00Z,GR,Greece,EURO,10,3237,1,189
8404,2020-03-18T00:00:00Z,GL,Greenland,EURO,2,2,0,0
8405,2020-03-19T00:00:00Z,GL,Greenland,EURO,0,2,0,0
8406,2020-03-20T00:00:00Z,GL,Greenland,EURO,0,2,0,0
8407,2020-03-21T00:00:00Z,GL,Greenland,EURO,0,2,0,0
8408,2020-03-22T00:00:00Z,GL,Greenland,EURO,0,2,0,0
8409,2020-03-23T00:00:00Z,GL,Greenland,EURO,0,2,0,0
8410,2020-03-24T00:00:00Z,GL,Greenland,EURO,2,4,0,0
8411,2020-03-25T00:00:00Z,GL,Greenland,EURO,0,4,0,0
8412,2020-03-26T00:00:00Z,GL,Greenland,EURO,1,5,0,0
8413,2020-03-27T00:00:00Z,GL,Greenland,EURO,1,6,0,0
8414,2020-03-28T00:00:00Z,GL,Greenland,EURO,3,9,0,0
8415,2020-03-29T00:00:00Z,GL,Greenland,EURO,1,10,0,0
8416,2020-03-30T00:00:00Z,GL,Greenland,EURO,0,10,0,0
8417,2020-03-31T00:00:00Z,GL,Greenland,EURO,0,10,0,0
8418,2020-04-01T00:00:00Z,GL,Greenland,EURO,0,10,0,0
8419,2020-04-02T00:00:00Z,GL,Greenland,EURO,0,10,0,0
8420,2020-04-03T00:00:00Z,GL,Greenland,EURO,0,10,0,0
8421,2020-04-04T00:00:00Z,GL,Greenland,EURO,0,10,0,0
8422,2020-04-05T00:00:00Z,GL,Greenland,EURO,0,10,0,0
8423,2020-04-06T00:00:00Z,GL,Greenland,EURO,1,11,0,0
8424,2020-04-07T00:00:00Z,GL,Greenland,EURO,0,11,0,0
8425,2020-04-08T00:00:00Z,GL,Greenland,EURO,0,11,0,0
8426,2020-04-09T00:00:00Z,GL,Greenland,EURO,0,11,0,0
8427,2020-04-10T00:00:00Z,GL,Greenland,EURO,0,11,0,0
8428,2020-04-11T00:00:00Z,GL,Greenland,EURO,0,11,0,0
8429,2020-04-12T00:00:00Z,GL,Greenland,EURO,0,11,0,0
8430,2020-04-13T00:00:00Z,GL,Greenland,EURO,0,11,0,0
8431,2020-04-14T00:00:00Z,GL,Greenland,EURO,0,11,0,0
8432,2020-04-15T00:00:00Z,GL,Greenland,EURO,0,11,0,0
8433,2020-04-16T00:00:00Z,GL,Greenland,EURO,0,11,0,0
8434,2020-04-17T00:00:00Z,GL,Greenland,EURO,0,11,0,0
8435,2020-04-18T00:00:00Z,GL,Greenland,EURO,0,11,0,0
8436,2020-04-19T00:00:00Z,GL,Greenland,EURO,0,11,0,0
8437,2020-04-20T00:00:00Z,GL,Greenland,EURO,0,11,0,0
8438,2020-04-21T00:00:00Z,GL,Greenland,EURO,0,11,0,0
8439,2020-04-22T00:00:00Z,GL,Greenland,EURO,0,11,0,0
8440,2020-04-23T00:00:00Z,GL,Greenland,EURO,0,11,0,0
8441,2020-04-24T00:00:00Z,GL,Greenland,EURO,0,11,0,0
8442,2020-04-25T00:00:00Z,GL,Greenland,EURO,0,11,0,0
8443,2020-04-26T00:00:00Z,GL,Greenland,EURO,0,11,0,0
8444,2020-04-27T00:00:00Z,GL,Greenland,EURO,0,11,0,0
8445,2020-04-28T00:00:00Z,GL,Greenland,EURO,0,11,0,0
8446,2020-04-29T00:00:00Z,GL,Greenland,EURO,0,11,0,0
8447,2020-04-30T00:00:00Z,GL,Greenland,EURO,0,11,0,0
8448,2020-05-01T00:00:00Z,GL,Greenland,EURO,0,11,0,0
8449,2020-05-02T00:00:00Z,GL,Greenland,EURO,0,11,0,0
8450,2020-05-03T00:00:00Z,GL,Greenland,EURO,0,11,0,0
8451,2020-05-04T00:00:00Z,GL,Greenland,EURO,0,11,0,0
8452,2020-05-05T00:00:00Z,GL,Greenland,EURO,0,11,0,0
8453,2020-05-06T00:00:00Z,GL,Greenland,EURO,0,11,0,0
8454,2020-05-07T00:00:00Z,GL,Greenland,EURO,0,11,0,0
8455,2020-05-08T00:00:00Z,GL,Greenland,EURO,0,11,0,0
8456,2020-05-09T00:00:00Z,GL,Greenland,EURO,0,11,0,0
8457,2020-05-10T00:00:00Z,GL,Greenland,EURO,0,11,0,0
8458,2020-05-11T00:00:00Z,GL,Greenland,EURO,0,11,0,0
8459,2020-05-12T00:00:00Z,GL,Greenland,EURO,0,11,0,0
8460,2020-05-13T00:00:00Z,GL,Greenland,EURO,0,11,0,0
8461,2020-05-14T00:00:00Z,GL,Greenland,EURO,0,11,0,0
8462,2020-05-15T00:00:00Z,GL,Greenland,EURO,0,11,0,0
8463,2020-05-16T00:00:00Z,GL,Greenland,EURO,0,11,0,0
8464,2020-05-17T00:00:00Z,GL,Greenland,EURO,0,11,0,0
8465,2020-05-18T00:00:00Z,GL,Greenland,EURO,0,11,0,0
8466,2020-05-19T00:00:00Z,GL,Greenland,EURO,0,11,0,0
8467,2020-05-20T00:00:00Z,GL,Greenland,EURO,0,11,0,0
8468,2020-05-21T00:00:00Z,GL,Greenland,EURO,0,11,0,0
8469,2020-05-22T00:00:00Z,GL,Greenland,EURO,0,11,0,0
8470,2020-05-23T00:00:00Z,GL,Greenland,EURO,0,11,0,0
8471,2020-05-24T00:00:00Z,GL,Greenland,EURO,0,11,0,0
8472,2020-05-25T00:00:00Z,GL,Greenland,EURO,0,11,0,0
8473,2020-05-26T00:00:00Z,GL,Greenland,EURO,1,12,0,0
8474,2020-05-27T00:00:00Z,GL,Greenland,EURO,0,12,0,0
8475,2020-05-28T00:00:00Z,GL,Greenland,EURO,0,12,0,0
8476,2020-05-29T00:00:00Z,GL,Greenland,EURO,1,13,0,0
8477,2020-05-30T00:00:00Z,GL,Greenland,EURO,0,13,0,0
8478,2020-05-31T00:00:00Z,GL,Greenland,EURO,0,13,0,0
8479,2020-06-01T00:00:00Z,GL,Greenland,EURO,0,13,0,0
8480,2020-06-02T00:00:00Z,GL,Greenland,EURO,0,13,0,0
8481,2020-06-03T00:00:00Z,GL,Greenland,EURO,0,13,0,0
8482,2020-06-04T00:00:00Z,GL,Greenland,EURO,0,13,0,0
8483,2020-06-05T00:00:00Z,GL,Greenland,EURO,0,13,0,0
8484,2020-06-06T00:00:00Z,GL,Greenland,EURO,0,13,0,0
8485,2020-06-07T00:00:00Z,GL,Greenland,EURO,0,13,0,0
8486,2020-06-08T00:00:00Z,GL,Greenland,EURO,0,13,0,0
8487,2020-06-09T00:00:00Z,GL,Greenland,EURO,0,13,0,0
8488,2020-06-10T00:00:00Z,GL,Greenland,EURO,0,13,0,0
8489,2020-06-11T00:00:00Z,GL,Greenland,EURO,0,13,0,0
8490,2020-06-12T00:00:00Z,GL,Greenland,EURO,0,13,0,0
8491,2020-06-13T00:00:00Z,GL,Greenland,EURO,0,13,0,0
8492,2020-06-14T00:00:00Z,GL,Greenland,EURO,0,13,0,0
8493,2020-06-15T00:00:00Z,GL,Greenland,EURO,0,13,0,0
8494,2020-06-16T00:00:00Z,GL,Greenland,EURO,0,13,0,0
8495,2020-06-17T00:00:00Z,GL,Greenland,EURO,0,13,0,0
8496,2020-06-18T00:00:00Z,GL,Greenland,EURO,0,13,0,0
8497,2020-06-19T00:00:00Z,GL,Greenland,EURO,0,13,0,0
8498,2020-06-20T00:00:00Z,GL,Greenland,EURO,0,13,0,0
8882,2020-03-09T00:00:00Z,GG,Guernsey,EURO,1,1,0,0
8883,2020-03-10T00:00:00Z,GG,Guernsey,EURO,0,1,0,0
8884,2020-03-11T00:00:00Z,GG,Guernsey,EURO,0,1,0,0
8885,2020-03-12T00:00:00Z,GG,Guernsey,EURO,0,1,0,0
8886,2020-03-13T00:00:00Z,GG,Guernsey,EURO,0,1,0,0
8887,2020-03-14T00:00:00Z,GG,Guernsey,EURO,0,1,0,0
8888,2020-03-15T00:00:00Z,GG,Guernsey,EURO,0,1,0,0
8889,2020-03-16T00:00:00Z,GG,Guernsey,EURO,0,1,0,0
8890,2020-03-17T00:00:00Z,GG,Guernsey,EURO,0,1,0,0
8891,2020-03-18T00:00:00Z,GG,Guernsey,EURO,0,1,0,0
8892,2020-03-19T00:00:00Z,GG,Guernsey,EURO,0,1,0,0
8893,2020-03-20T00:00:00Z,GG,Guernsey,EURO,0,1,0,0
8894,2020-03-21T00:00:00Z,GG,Guernsey,EURO,0,1,0,0
8895,2020-03-22T00:00:00Z,GG,Guernsey,EURO,0,1,0,0
8896,2020-03-23T00:00:00Z,GG,Guernsey,EURO,16,17,0,0
8897,2020-03-24T00:00:00Z,GG,Guernsey,EURO,3,20,0,0
8898,2020-03-25T00:00:00Z,GG,Guernsey,EURO,3,23,0,0
8899,2020-03-26T00:00:00Z,GG,Guernsey,EURO,7,30,0,0
8900,2020-03-27T00:00:00Z,GG,Guernsey,EURO,4,34,0,0
8901,2020-03-28T00:00:00Z,GG,Guernsey,EURO,2,36,0,0
8902,2020-03-29T00:00:00Z,GG,Guernsey,EURO,3,39,0,0
8903,2020-03-30T00:00:00Z,GG,Guernsey,EURO,0,39,0,0
8904,2020-03-31T00:00:00Z,GG,Guernsey,EURO,6,45,0,0
8905,2020-04-01T00:00:00Z,GG,Guernsey,EURO,15,60,1,1
8906,2020-04-02T00:00:00Z,GG,Guernsey,EURO,18,78,0,1
8907,2020-04-03T00:00:00Z,GG,Guernsey,EURO,13,91,0,1
8908,2020-04-04T00:00:00Z,GG,Guernsey,EURO,23,114,1,2
8909,2020-04-05T00:00:00Z,GG,Guernsey,EURO,22,136,0,2
8910,2020-04-06T00:00:00Z,GG,Guernsey,EURO,18,154,1,3
8911,2020-04-07T00:00:00Z,GG,Guernsey,EURO,0,154,0,3
8912,2020-04-08T00:00:00Z,GG,Guernsey,EURO,12,166,1,4
8913,2020-04-09T00:00:00Z,GG,Guernsey,EURO,0,166,0,4
8914,2020-04-10T00:00:00Z,GG,Guernsey,EURO,15,181,1,5
8915,2020-04-11T00:00:00Z,GG,Guernsey,EURO,10,191,0,5
8916,2020-04-12T00:00:00Z,GG,Guernsey,EURO,9,200,1,6
8917,2020-04-13T00:00:00Z,GG,Guernsey,EURO,9,209,0,6
8918,2020-04-14T00:00:00Z,GG,Guernsey,EURO,9,218,0,6
8919,2020-04-15T00:00:00Z,GG,Guernsey,EURO,1,219,0,6
8920,2020-04-16T00:00:00Z,GG,Guernsey,EURO,4,223,1,7
8921,2020-04-17T00:00:00Z,GG,Guernsey,EURO,5,228,1,8
8922,2020-04-18T00:00:00Z,GG,Guernsey,EURO,6,234,1,9
8923,2020-04-19T00:00:00Z,GG,Guernsey,EURO,2,236,0,9
8924,2020-04-20T00:00:00Z,GG,Guernsey,EURO,3,239,0,9
8925,2020-04-21T00:00:00Z,GG,Guernsey,EURO,0,239,0,9
8926,2020-04-22T00:00:00Z,GG,Guernsey,EURO,0,239,1,10
8927,2020-04-23T00:00:00Z,GG,Guernsey,EURO,2,241,0,10
8928,2020-04-24T00:00:00Z,GG,Guernsey,EURO,2,243,0,10
8929,2020-04-25T00:00:00Z,GG,Guernsey,EURO,2,245,0,10
8930,2020-04-26T00:00:00Z,GG,Guernsey,EURO,0,245,1,11
8931,2020-04-27T00:00:00Z,GG,Guernsey,EURO,0,245,1,12
8932,2020-04-28T00:00:00Z,GG,Guernsey,EURO,2,247,1,13
8933,2020-04-29T00:00:00Z,GG,Guernsey,EURO,0,247,0,13
8934,2020-04-30T00:00:00Z,GG,Guernsey,EURO,0,247,0,13
8935,2020-05-01T00:00:00Z,GG,Guernsey,EURO,4,251,0,13
8936,2020-05-02T00:00:00Z,GG,Guernsey,EURO,0,251,0,13
8937,2020-05-03T00:00:00Z,GG,Guernsey,EURO,1,252,0,13
8938,2020-05-04T00:00:00Z,GG,Guernsey,EURO,0,252,0,13
8939,2020-05-05T00:00:00Z,GG,Guernsey,EURO,0,252,0,13
8940,2020-05-06T00:00:00Z,GG,Guernsey,EURO,0,252,0,13
8941,2020-05-07T00:00:00Z,GG,Guernsey,EURO,0,252,0,13
8942,2020-05-08T00:00:00Z,GG,Guernsey,EURO,0,252,0,13
8943,2020-05-09T00:00:00Z,GG,Guernsey,EURO,0,252,0,13
8944,2020-05-10T00:00:00Z,GG,Guernsey,EURO,0,252,0,13
8945,2020-05-11T00:00:00Z,GG,Guernsey,EURO,0,252,0,13
8946,2020-05-12T00:00:00Z,GG,Guernsey,EURO,0,252,0,13
8947,2020-05-13T00:00:00Z,GG,Guernsey,EURO,0,252,0,13
8948,2020-05-14T00:00:00Z,GG,Guernsey,EURO,0,252,0,13
8949,2020-05-15T00:00:00Z,GG,Guernsey,EURO,0,252,0,13
8950,2020-05-16T00:00:00Z,GG,Guernsey,EURO,0,252,0,13
8951,2020-05-17T00:00:00Z,GG,Guernsey,EURO,0,252,0,13
8952,2020-05-18T00:00:00Z,GG,Guernsey,EURO,0,252,0,13
8953,2020-05-19T00:00:00Z,GG,Guernsey,EURO,0,252,0,13
8954,2020-05-20T00:00:00Z,GG,Guernsey,EURO,0,252,0,13
8955,2020-05-21T00:00:00Z,GG,Guernsey,EURO,0,252,0,13
8956,2020-05-22T00:00:00Z,GG,Guernsey,EURO,0,252,0,13
8957,2020-05-23T00:00:00Z,GG,Guernsey,EURO,0,252,0,13
8958,2020-05-24T00:00:00Z,GG,Guernsey,EURO,0,252,0,13
8959,2020-05-25T00:00:00Z,GG,Guernsey,EURO,0,252,0,13
8960,2020-05-26T00:00:00Z,GG,Guernsey,EURO,0,252,0,13
8961,2020-05-27T00:00:00Z,GG,Guernsey,EURO,0,252,0,13
8962,2020-05-28T00:00:00Z,GG,Guernsey,EURO,0,252,0,13
8963,2020-05-29T00:00:00Z,GG,Guernsey,EURO,0,252,0,13
8964,2020-05-30T00:00:00Z,GG,Guernsey,EURO,0,252,0,13
8965,2020-05-31T00:00:00Z,GG,Guernsey,EURO,0,252,0,13
8966,2020-06-01T00:00:00Z,GG,Guernsey,EURO,0,252,0,13
8967,2020-06-02T00:00:00Z,GG,Guernsey,EURO,0,252,0,13
8968,2020-06-03T00:00:00Z,GG,Guernsey,EURO,0,252,0,13
8969,2020-06-04T00:00:00Z,GG,Guernsey,EURO,0,252,0,13
8970,2020-06-05T00:00:00Z,GG,Guernsey,EURO,0,252,0,13
8971,2020-06-06T00:00:00Z,GG,Guernsey,EURO,0,252,0,13
8972,2020-06-07T00:00:00Z,GG,Guernsey,EURO,0,252,0,13
8973,2020-06-08T00:00:00Z,GG,Guernsey,EURO,0,252,0,13
8974,2020-06-09T00:00:00Z,GG,Guernsey,EURO,0,252,0,13
8975,2020-06-10T00:00:00Z,GG,Guernsey,EURO,0,252,0,13
8976,2020-06-11T00:00:00Z,GG,Guernsey,EURO,0,252,0,13
8977,2020-06-12T00:00:00Z,GG,Guernsey,EURO,0,252,0,13
8978,2020-06-13T00:00:00Z,GG,Guernsey,EURO,0,252,0,13
8979,2020-06-14T00:00:00Z,GG,Guernsey,EURO,0,252,0,13
8980,2020-06-15T00:00:00Z,GG,Guernsey,EURO,0,252,0,13
8981,2020-06-16T00:00:00Z,GG,Guernsey,EURO,0,252,0,13
8982,2020-06-17T00:00:00Z,GG,Guernsey,EURO,0,252,0,13
8983,2020-06-18T00:00:00Z,GG,Guernsey,EURO,0,252,0,13
8984,2020-06-19T00:00:00Z,GG,Guernsey,EURO,0,252,0,13
8985,2020-06-20T00:00:00Z,GG,Guernsey,EURO,0,252,0,13
9365,2020-03-06T00:00:00Z,VA,Holy See,EURO,1,1,0,0
9366,2020-03-07T00:00:00Z,VA,Holy See,EURO,0,1,0,0
9367,2020-03-08T00:00:00Z,VA,Holy See,EURO,0,1,0,0
9368,2020-03-09T00:00:00Z,VA,Holy See,EURO,0,1,0,0
9369,2020-03-10T00:00:00Z,VA,Holy See,EURO,0,1,0,0
9370,2020-03-11T00:00:00Z,VA,Holy See,EURO,0,1,0,0
9371,2020-03-12T00:00:00Z,VA,Holy See,EURO,0,1,0,0
9372,2020-03-13T00:00:00Z,VA,Holy See,EURO,0,1,0,0
9373,2020-03-14T00:00:00Z,VA,Holy See,EURO,0,1,0,0
9374,2020-03-15T00:00:00Z,VA,Holy See,EURO,0,1,0,0
9375,2020-03-16T00:00:00Z,VA,Holy See,EURO,0,1,0,0
9376,2020-03-17T00:00:00Z,VA,Holy See,EURO,0,1,0,0
9377,2020-03-18T00:00:00Z,VA,Holy See,EURO,0,1,0,0
9378,2020-03-19T00:00:00Z,VA,Holy See,EURO,0,1,0,0
9379,2020-03-20T00:00:00Z,VA,Holy See,EURO,0,1,0,0
9380,2020-03-21T00:00:00Z,VA,Holy See,EURO,0,1,0,0
9381,2020-03-22T00:00:00Z,VA,Holy See,EURO,0,1,0,0
9382,2020-03-23T00:00:00Z,VA,Holy See,EURO,0,1,0,0
9383,2020-03-24T00:00:00Z,VA,Holy See,EURO,0,1,0,0
9384,2020-03-25T00:00:00Z,VA,Holy See,EURO,0,1,0,0
9385,2020-03-26T00:00:00Z,VA,Holy See,EURO,3,4,0,0
9386,2020-03-27T00:00:00Z,VA,Holy See,EURO,0,4,0,0
9387,2020-03-28T00:00:00Z,VA,Holy See,EURO,0,4,0,0
9388,2020-03-29T00:00:00Z,VA,Holy See,EURO,0,4,0,0
9389,2020-03-30T00:00:00Z,VA,Holy See,EURO,2,6,0,0
9390,2020-03-31T00:00:00Z,VA,Holy See,EURO,0,6,0,0
9391,2020-04-01T00:00:00Z,VA,Holy See,EURO,0,6,0,0
9392,2020-04-02T00:00:00Z,VA,Holy See,EURO,0,6,0,0
9393,2020-04-03T00:00:00Z,VA,Holy See,EURO,1,7,0,0
9394,2020-04-04T00:00:00Z,VA,Holy See,EURO,0,7,0,0
9395,2020-04-05T00:00:00Z,VA,Holy See,EURO,0,7,0,0
9396,2020-04-06T00:00:00Z,VA,Holy See,EURO,0,7,0,0
9397,2020-04-07T00:00:00Z,VA,Holy See,EURO,0,7,0,0
9398,2020-04-08T00:00:00Z,VA,Holy See,EURO,0,7,0,0
9399,2020-04-09T00:00:00Z,VA,Holy See,EURO,1,8,0,0
9400,2020-04-10T00:00:00Z,VA,Holy See,EURO,0,8,0,0
9401,2020-04-11T00:00:00Z,VA,Holy See,EURO,0,8,0,0
9402,2020-04-12T00:00:00Z,VA,Holy See,EURO,0,8,0,0
9403,2020-04-13T00:00:00Z,VA,Holy See,EURO,0,8,0,0
9404,2020-04-14T00:00:00Z,VA,Holy See,EURO,0,8,0,0
9405,2020-04-15T00:00:00Z,VA,Holy See,EURO,0,8,0,0
9406,2020-04-16T00:00:00Z,VA,Holy See,EURO,0,8,0,0
9407,2020-04-17T00:00:00Z,VA,Holy See,EURO,0,8,0,0
9408,2020-04-18T00:00:00Z,VA,Holy See,EURO,0,8,0,0
9409,2020-04-19T00:00:00Z,VA,Holy See,EURO,0,8,0,0
9410,2020-04-20T00:00:00Z,VA,Holy See,EURO,0,8,0,0
9411,2020-04-21T00:00:00Z,VA,Holy See,EURO,1,9,0,0
9412,2020-04-22T00:00:00Z,VA,Holy See,EURO,0,9,0,0
9413,2020-04-23T00:00:00Z,VA,Holy See,EURO,0,9,0,0
9414,2020-04-24T00:00:00Z,VA,Holy See,EURO,0,9,0,0
9415,2020-04-25T00:00:00Z,VA,Holy See,EURO,0,9,0,0
9416,2020-04-26T00:00:00Z,VA,Holy See,EURO,0,9,0,0
9417,2020-04-27T00:00:00Z,VA,Holy See,EURO,0,9,0,0
9418,2020-04-28T00:00:00Z,VA,Holy See,EURO,0,9,0,0
9419,2020-04-29T00:00:00Z,VA,Holy See,EURO,1,10,0,0
9420,2020-04-30T00:00:00Z,VA,Holy See,EURO,0,10,0,0
9421,2020-05-01T00:00:00Z,VA,Holy See,EURO,1,11,0,0
9422,2020-05-02T00:00:00Z,VA,Holy See,EURO,0,11,0,0
9423,2020-05-03T00:00:00Z,VA,Holy See,EURO,0,11,0,0
9424,2020-05-04T00:00:00Z,VA,Holy See,EURO,0,11,0,0
9425,2020-05-05T00:00:00Z,VA,Holy See,EURO,0,11,0,0
9426,2020-05-06T00:00:00Z,VA,Holy See,EURO,0,11,0,0
9427,2020-05-07T00:00:00Z,VA,Holy See,EURO,1,12,0,0
9428,2020-05-08T00:00:00Z,VA,Holy See,EURO,0,12,0,0
9429,2020-05-09T00:00:00Z,VA,Holy See,EURO,0,12,0,0
9430,2020-05-10T00:00:00Z,VA,Holy See,EURO,0,12,0,0
9431,2020-05-11T00:00:00Z,VA,Holy See,EURO,0,12,0,0
9432,2020-05-12T00:00:00Z,VA,Holy See,EURO,0,12,0,0
9433,2020-05-13T00:00:00Z,VA,Holy See,EURO,0,12,0,0
9434,2020-05-14T00:00:00Z,VA,Holy See,EURO,0,12,0,0
9435,2020-05-15T00:00:00Z,VA,Holy See,EURO,0,12,0,0
9436,2020-05-16T00:00:00Z,VA,Holy See,EURO,0,12,0,0
9437,2020-05-17T00:00:00Z,VA,Holy See,EURO,0,12,0,0
9438,2020-05-18T00:00:00Z,VA,Holy See,EURO,0,12,0,0
9439,2020-05-19T00:00:00Z,VA,Holy See,EURO,0,12,0,0
9440,2020-05-20T00:00:00Z,VA,Holy See,EURO,0,12,0,0
9441,2020-05-21T00:00:00Z,VA,Holy See,EURO,0,12,0,0
9442,2020-05-22T00:00:00Z,VA,Holy See,EURO,0,12,0,0
9443,2020-05-23T00:00:00Z,VA,Holy See,EURO,0,12,0,0
9444,2020-05-24T00:00:00Z,VA,Holy See,EURO,0,12,0,0
9445,2020-05-25T00:00:00Z,VA,Holy See,EURO,0,12,0,0
9446,2020-05-26T00:00:00Z,VA,Holy See,EURO,0,12,0,0
9447,2020-05-27T00:00:00Z,VA,Holy See,EURO,0,12,0,0
9448,2020-05-28T00:00:00Z,VA,Holy See,EURO,0,12,0,0
9449,2020-05-29T00:00:00Z,VA,Holy See,EURO,0,12,0,0
9450,2020-05-30T00:00:00Z,VA,Holy See,EURO,0,12,0,0
9451,2020-05-31T00:00:00Z,VA,Holy See,EURO,0,12,0,0
9452,2020-06-01T00:00:00Z,VA,Holy See,EURO,0,12,0,0
9453,2020-06-02T00:00:00Z,VA,Holy See,EURO,0,12,0,0
9454,2020-06-03T00:00:00Z,VA,Holy See,EURO,0,12,0,0
9455,2020-06-04T00:00:00Z,VA,Holy See,EURO,0,12,0,0
9456,2020-06-05T00:00:00Z,VA,Holy See,EURO,0,12,0,0
9457,2020-06-06T00:00:00Z,VA,Holy See,EURO,0,12,0,0
9458,2020-06-07T00:00:00Z,VA,Holy See,EURO,0,12,0,0
9459,2020-06-08T00:00:00Z,VA,Holy See,EURO,0,12,0,0
9460,2020-06-09T00:00:00Z,VA,Holy See,EURO,0,12,0,0
9461,2020-06-10T00:00:00Z,VA,Holy See,EURO,0,12,0,0
9462,2020-06-11T00:00:00Z,VA,Holy See,EURO,0,12,0,0
9463,2020-06-12T00:00:00Z,VA,Holy See,EURO,0,12,0,0
9464,2020-06-13T00:00:00Z,VA,Holy See,EURO,0,12,0,0
9465,2020-06-14T00:00:00Z,VA,Holy See,EURO,0,12,0,0
9466,2020-06-15T00:00:00Z,VA,Holy See,EURO,0,12,0,0
9467,2020-06-16T00:00:00Z,VA,Holy See,EURO,0,12,0,0
9468,2020-06-17T00:00:00Z,VA,Holy See,EURO,0,12,0,0
9469,2020-06-18T00:00:00Z,VA,Holy See,EURO,0,12,0,0
9470,2020-06-19T00:00:00Z,VA,Holy See,EURO,0,12,0,0
9471,2020-06-20T00:00:00Z,VA,Holy See,EURO,0,12,0,0
9573,2020-03-04T00:00:00Z,HU,Hungary,EURO,2,2,0,0
9574,2020-03-05T00:00:00Z,HU,Hungary,EURO,0,2,0,0
9575,2020-03-06T00:00:00Z,HU,Hungary,EURO,2,4,0,0
9576,2020-03-07T00:00:00Z,HU,Hungary,EURO,3,7,0,0
9577,2020-03-08T00:00:00Z,HU,Hungary,EURO,1,8,0,0
9578,2020-03-09T00:00:00Z,HU,Hungary,EURO,1,9,0,0
9579,2020-03-10T00:00:00Z,HU,Hungary,EURO,3,12,0,0
9580,2020-03-11T00:00:00Z,HU,Hungary,EURO,1,13,0,0
9581,2020-03-12T00:00:00Z,HU,Hungary,EURO,0,13,0,0
9582,2020-03-13T00:00:00Z,HU,Hungary,EURO,6,19,0,0
9583,2020-03-14T00:00:00Z,HU,Hungary,EURO,6,25,0,0
9584,2020-03-15T00:00:00Z,HU,Hungary,EURO,7,32,1,1
9585,2020-03-16T00:00:00Z,HU,Hungary,EURO,7,39,0,1
9586,2020-03-17T00:00:00Z,HU,Hungary,EURO,11,50,0,1
9587,2020-03-18T00:00:00Z,HU,Hungary,EURO,8,58,0,1
9588,2020-03-19T00:00:00Z,HU,Hungary,EURO,15,73,0,1
9589,2020-03-20T00:00:00Z,HU,Hungary,EURO,12,85,3,4
9590,2020-03-21T00:00:00Z,HU,Hungary,EURO,46,131,0,4
9591,2020-03-22T00:00:00Z,HU,Hungary,EURO,0,131,0,4
9592,2020-03-23T00:00:00Z,HU,Hungary,EURO,36,167,3,7
9593,2020-03-24T00:00:00Z,HU,Hungary,EURO,20,187,1,8
9594,2020-03-25T00:00:00Z,HU,Hungary,EURO,39,226,2,10
9595,2020-03-26T00:00:00Z,HU,Hungary,EURO,35,261,0,10
9596,2020-03-27T00:00:00Z,HU,Hungary,EURO,39,300,0,10
9597,2020-03-28T00:00:00Z,HU,Hungary,EURO,43,343,1,11
9598,2020-03-29T00:00:00Z,HU,Hungary,EURO,65,408,2,13
9599,2020-03-30T00:00:00Z,HU,Hungary,EURO,39,447,2,15
9600,2020-03-31T00:00:00Z,HU,Hungary,EURO,0,447,0,15
9601,2020-04-01T00:00:00Z,HU,Hungary,EURO,45,492,1,16
9602,2020-04-02T00:00:00Z,HU,Hungary,EURO,33,525,4,20
9603,2020-04-03T00:00:00Z,HU,Hungary,EURO,60,585,1,21
9604,2020-04-04T00:00:00Z,HU,Hungary,EURO,93,678,11,32
9605,2020-04-05T00:00:00Z,HU,Hungary,EURO,55,733,2,34
9606,2020-04-06T00:00:00Z,HU,Hungary,EURO,11,744,4,38
9607,2020-04-07T00:00:00Z,HU,Hungary,EURO,73,817,9,47
9608,2020-04-08T00:00:00Z,HU,Hungary,EURO,78,895,11,58
9609,2020-04-09T00:00:00Z,HU,Hungary,EURO,85,980,8,66
9610,2020-04-10T00:00:00Z,HU,Hungary,EURO,210,1190,11,77
9611,2020-04-11T00:00:00Z,HU,Hungary,EURO,120,1310,8,85
9612,2020-04-12T00:00:00Z,HU,Hungary,EURO,100,1410,14,99
9613,2020-04-13T00:00:00Z,HU,Hungary,EURO,48,1458,10,109
9614,2020-04-14T00:00:00Z,HU,Hungary,EURO,54,1512,13,122
9615,2020-04-15T00:00:00Z,HU,Hungary,EURO,67,1579,12,134
9616,2020-04-16T00:00:00Z,HU,Hungary,EURO,73,1652,8,142
9617,2020-04-17T00:00:00Z,HU,Hungary,EURO,111,1763,14,156
9618,2020-04-18T00:00:00Z,HU,Hungary,EURO,71,1834,16,172
9619,2020-04-19T00:00:00Z,HU,Hungary,EURO,82,1916,17,189
9620,2020-04-20T00:00:00Z,HU,Hungary,EURO,68,1984,10,199
9621,2020-04-21T00:00:00Z,HU,Hungary,EURO,114,2098,14,213
9622,2020-04-22T00:00:00Z,HU,Hungary,EURO,70,2168,12,225
9623,2020-04-23T00:00:00Z,HU,Hungary,EURO,116,2284,0,225
9624,2020-04-24T00:00:00Z,HU,Hungary,EURO,99,2383,25,250
9625,2020-04-25T00:00:00Z,HU,Hungary,EURO,60,2443,12,262
9626,2020-04-26T00:00:00Z,HU,Hungary,EURO,57,2500,10,272
9627,2020-04-27T00:00:00Z,HU,Hungary,EURO,83,2583,8,280
9628,2020-04-28T00:00:00Z,HU,Hungary,EURO,66,2649,11,291
9629,2020-04-29T00:00:00Z,HU,Hungary,EURO,78,2727,9,300
9630,2020-04-30T00:00:00Z,HU,Hungary,EURO,48,2775,12,312
9631,2020-05-01T00:00:00Z,HU,Hungary,EURO,88,2863,11,323
9632,2020-05-02T00:00:00Z,HU,Hungary,EURO,79,2942,12,335
9633,2020-05-03T00:00:00Z,HU,Hungary,EURO,56,2998,5,340
9634,2020-05-04T00:00:00Z,HU,Hungary,EURO,37,3035,11,351
9635,2020-05-05T00:00:00Z,HU,Hungary,EURO,30,3065,12,363
9636,2020-05-06T00:00:00Z,HU,Hungary,EURO,46,3111,10,373
9637,2020-05-07T00:00:00Z,HU,Hungary,EURO,39,3150,10,383
9638,2020-05-08T00:00:00Z,HU,Hungary,EURO,28,3178,9,392
9639,2020-05-09T00:00:00Z,HU,Hungary,EURO,35,3213,13,405
9640,2020-05-10T00:00:00Z,HU,Hungary,EURO,50,3263,8,413
9641,2020-05-11T00:00:00Z,HU,Hungary,EURO,21,3284,8,421
9642,2020-05-12T00:00:00Z,HU,Hungary,EURO,29,3313,4,425
9643,2020-05-13T00:00:00Z,HU,Hungary,EURO,28,3341,5,430
9644,2020-05-14T00:00:00Z,HU,Hungary,EURO,39,3380,6,436
9645,2020-05-15T00:00:00Z,HU,Hungary,EURO,37,3417,6,442
9646,2020-05-16T00:00:00Z,HU,Hungary,EURO,56,3473,6,448
9647,2020-05-17T00:00:00Z,HU,Hungary,EURO,36,3509,3,451
9648,2020-05-18T00:00:00Z,HU,Hungary,EURO,26,3535,11,462
9649,2020-05-19T00:00:00Z,HU,Hungary,EURO,21,3556,5,467
9650,2020-05-20T00:00:00Z,HU,Hungary,EURO,42,3598,3,470
9651,2020-05-21T00:00:00Z,HU,Hungary,EURO,43,3641,3,473
9652,2020-05-22T00:00:00Z,HU,Hungary,EURO,37,3678,3,476
9653,2020-05-23T00:00:00Z,HU,Hungary,EURO,35,3713,6,482
9654,2020-05-24T00:00:00Z,HU,Hungary,EURO,28,3741,4,486
9655,2020-05-25T00:00:00Z,HU,Hungary,EURO,15,3756,5,491
9656,2020-05-26T00:00:00Z,HU,Hungary,EURO,15,3771,8,499
9657,2020-05-27T00:00:00Z,HU,Hungary,EURO,22,3793,6,505
9658,2020-05-28T00:00:00Z,HU,Hungary,EURO,23,3816,4,509
9659,2020-05-29T00:00:00Z,HU,Hungary,EURO,25,3841,8,517
9660,2020-05-30T00:00:00Z,HU,Hungary,EURO,0,3841,0,517
9661,2020-05-31T00:00:00Z,HU,Hungary,EURO,26,3867,7,524
9662,2020-06-01T00:00:00Z,HU,Hungary,EURO,9,3876,2,526
9663,2020-06-02T00:00:00Z,HU,Hungary,EURO,45,3921,6,532
9664,2020-06-03T00:00:00Z,HU,Hungary,EURO,10,3931,2,534
9665,2020-06-04T00:00:00Z,HU,Hungary,EURO,0,3931,0,534
9666,2020-06-05T00:00:00Z,HU,Hungary,EURO,23,3954,5,539
9667,2020-06-06T00:00:00Z,HU,Hungary,EURO,16,3970,3,542
9668,2020-06-07T00:00:00Z,HU,Hungary,EURO,0,3970,0,542
9669,2020-06-08T00:00:00Z,HU,Hungary,EURO,0,3970,0,542
9670,2020-06-09T00:00:00Z,HU,Hungary,EURO,44,4014,6,548
9671,2020-06-10T00:00:00Z,HU,Hungary,EURO,3,4017,2,550
9672,2020-06-11T00:00:00Z,HU,Hungary,EURO,10,4027,1,551
9673,2020-06-12T00:00:00Z,HU,Hungary,EURO,12,4039,2,553
9674,2020-06-13T00:00:00Z,HU,Hungary,EURO,14,4053,2,555
9675,2020-06-14T00:00:00Z,HU,Hungary,EURO,11,4064,4,559
9676,2020-06-15T00:00:00Z,HU,Hungary,EURO,12,4076,4,563
9677,2020-06-16T00:00:00Z,HU,Hungary,EURO,1,4077,2,565
9678,2020-06-17T00:00:00Z,HU,Hungary,EURO,1,4078,2,567
9679,2020-06-18T00:00:00Z,HU,Hungary,EURO,1,4079,1,568
9680,2020-06-19T00:00:00Z,HU,Hungary,EURO,2,4081,0,568
9681,2020-06-20T00:00:00Z,HU,Hungary,EURO,5,4086,2,570
9682,2020-03-01T00:00:00Z,IS,Iceland,EURO,2,2,0,0
9683,2020-03-02T00:00:00Z,IS,Iceland,EURO,7,9,0,0
9684,2020-03-03T00:00:00Z,IS,Iceland,EURO,7,16,0,0
9685,2020-03-04T00:00:00Z,IS,Iceland,EURO,10,26,0,0
9686,2020-03-05T00:00:00Z,IS,Iceland,EURO,0,26,0,0
9687,2020-03-06T00:00:00Z,IS,Iceland,EURO,2,28,0,0
9688,2020-03-07T00:00:00Z,IS,Iceland,EURO,17,45,0,0
9689,2020-03-08T00:00:00Z,IS,Iceland,EURO,10,55,0,0
9690,2020-03-09T00:00:00Z,IS,Iceland,EURO,0,55,0,0
9691,2020-03-10T00:00:00Z,IS,Iceland,EURO,6,61,0,0
9692,2020-03-11T00:00:00Z,IS,Iceland,EURO,0,61,0,0
9693,2020-03-12T00:00:00Z,IS,Iceland,EURO,0,61,0,0
9694,2020-03-13T00:00:00Z,IS,Iceland,EURO,56,117,0,0
9695,2020-03-14T00:00:00Z,IS,Iceland,EURO,21,138,0,0
9696,2020-03-15T00:00:00Z,IS,Iceland,EURO,0,138,0,0
9697,2020-03-16T00:00:00Z,IS,Iceland,EURO,42,180,0,0
9698,2020-03-17T00:00:00Z,IS,Iceland,EURO,45,225,0,0
9699,2020-03-18T00:00:00Z,IS,Iceland,EURO,25,250,0,0
9700,2020-03-19T00:00:00Z,IS,Iceland,EURO,80,330,0,0
9701,2020-03-20T00:00:00Z,IS,Iceland,EURO,79,409,1,1
9702,2020-03-21T00:00:00Z,IS,Iceland,EURO,64,473,0,1
9703,2020-03-22T00:00:00Z,IS,Iceland,EURO,0,473,0,1
9704,2020-03-23T00:00:00Z,IS,Iceland,EURO,95,568,0,1
9705,2020-03-24T00:00:00Z,IS,Iceland,EURO,20,588,1,2
9706,2020-03-25T00:00:00Z,IS,Iceland,EURO,60,648,0,2
9707,2020-03-26T00:00:00Z,IS,Iceland,EURO,89,737,0,2
9708,2020-03-27T00:00:00Z,IS,Iceland,EURO,65,802,0,2
9709,2020-03-28T00:00:00Z,IS,Iceland,EURO,88,890,0,2
9710,2020-03-29T00:00:00Z,IS,Iceland,EURO,73,963,0,2
9711,2020-03-30T00:00:00Z,IS,Iceland,EURO,57,1020,0,2
9712,2020-03-31T00:00:00Z,IS,Iceland,EURO,66,1086,0,2
9713,2020-04-01T00:00:00Z,IS,Iceland,EURO,49,1135,0,2
9714,2020-04-02T00:00:00Z,IS,Iceland,EURO,85,1220,0,2
9715,2020-04-03T00:00:00Z,IS,Iceland,EURO,99,1319,2,4
9716,2020-04-04T00:00:00Z,IS,Iceland,EURO,45,1364,0,4
9717,2020-04-05T00:00:00Z,IS,Iceland,EURO,53,1417,0,4
9718,2020-04-06T00:00:00Z,IS,Iceland,EURO,69,1486,0,4
9719,2020-04-07T00:00:00Z,IS,Iceland,EURO,76,1562,2,6
9720,2020-04-08T00:00:00Z,IS,Iceland,EURO,24,1586,0,6
9721,2020-04-09T00:00:00Z,IS,Iceland,EURO,30,1616,0,6
9722,2020-04-10T00:00:00Z,IS,Iceland,EURO,32,1648,0,6
9723,2020-04-11T00:00:00Z,IS,Iceland,EURO,27,1675,1,7
9724,2020-04-12T00:00:00Z,IS,Iceland,EURO,14,1689,1,8
9725,2020-04-13T00:00:00Z,IS,Iceland,EURO,12,1701,0,8
9726,2020-04-14T00:00:00Z,IS,Iceland,EURO,10,1711,0,8
9727,2020-04-15T00:00:00Z,IS,Iceland,EURO,9,1720,0,8
9728,2020-04-16T00:00:00Z,IS,Iceland,EURO,7,1727,0,8
9729,2020-04-17T00:00:00Z,IS,Iceland,EURO,12,1739,0,8
9730,2020-04-18T00:00:00Z,IS,Iceland,EURO,15,1754,0,8
9731,2020-04-19T00:00:00Z,IS,Iceland,EURO,6,1760,1,9
9732,2020-04-20T00:00:00Z,IS,Iceland,EURO,11,1771,0,9
9733,2020-04-21T00:00:00Z,IS,Iceland,EURO,2,1773,1,10
9734,2020-04-22T00:00:00Z,IS,Iceland,EURO,5,1778,0,10
9735,2020-04-23T00:00:00Z,IS,Iceland,EURO,7,1785,0,10
9736,2020-04-24T00:00:00Z,IS,Iceland,EURO,4,1789,0,10
9737,2020-04-25T00:00:00Z,IS,Iceland,EURO,0,1789,0,10
9738,2020-04-26T00:00:00Z,IS,Iceland,EURO,1,1790,0,10
9739,2020-04-27T00:00:00Z,IS,Iceland,EURO,2,1792,0,10
9740,2020-04-28T00:00:00Z,IS,Iceland,EURO,0,1792,0,10
9741,2020-04-29T00:00:00Z,IS,Iceland,EURO,3,1795,0,10
9742,2020-04-30T00:00:00Z,IS,Iceland,EURO,2,1797,0,10
9743,2020-05-01T00:00:00Z,IS,Iceland,EURO,0,1797,0,10
9744,2020-05-02T00:00:00Z,IS,Iceland,EURO,1,1798,0,10
9745,2020-05-03T00:00:00Z,IS,Iceland,EURO,0,1798,0,10
9746,2020-05-04T00:00:00Z,IS,Iceland,EURO,1,1799,0,10
9747,2020-05-05T00:00:00Z,IS,Iceland,EURO,0,1799,0,10
9748,2020-05-06T00:00:00Z,IS,Iceland,EURO,0,1799,0,10
9749,2020-05-07T00:00:00Z,IS,Iceland,EURO,0,1799,0,10
9750,2020-05-08T00:00:00Z,IS,Iceland,EURO,2,1801,0,10
9751,2020-05-09T00:00:00Z,IS,Iceland,EURO,0,1801,0,10
9752,2020-05-10T00:00:00Z,IS,Iceland,EURO,0,1801,0,10
9753,2020-05-11T00:00:00Z,IS,Iceland,EURO,0,1801,0,10
9754,2020-05-12T00:00:00Z,IS,Iceland,EURO,0,1801,0,10
9755,2020-05-13T00:00:00Z,IS,Iceland,EURO,0,1801,0,10
9756,2020-05-14T00:00:00Z,IS,Iceland,EURO,1,1802,0,10
9757,2020-05-15T00:00:00Z,IS,Iceland,EURO,0,1802,0,10
9758,2020-05-16T00:00:00Z,IS,Iceland,EURO,0,1802,0,10
9759,2020-05-17T00:00:00Z,IS,Iceland,EURO,0,1802,0,10
9760,2020-05-18T00:00:00Z,IS,Iceland,EURO,0,1802,0,10
9761,2020-05-19T00:00:00Z,IS,Iceland,EURO,0,1802,0,10
9762,2020-05-20T00:00:00Z,IS,Iceland,EURO,0,1802,0,10
9763,2020-05-21T00:00:00Z,IS,Iceland,EURO,1,1803,0,10
9764,2020-05-22T00:00:00Z,IS,Iceland,EURO,0,1803,0,10
9765,2020-05-23T00:00:00Z,IS,Iceland,EURO,0,1803,0,10
9766,2020-05-24T00:00:00Z,IS,Iceland,EURO,1,1804,0,10
9767,2020-05-25T00:00:00Z,IS,Iceland,EURO,0,1804,0,10
9768,2020-05-26T00:00:00Z,IS,Iceland,EURO,0,1804,0,10
9769,2020-05-27T00:00:00Z,IS,Iceland,EURO,0,1804,0,10
9770,2020-05-28T00:00:00Z,IS,Iceland,EURO,1,1805,0,10
9771,2020-05-29T00:00:00Z,IS,Iceland,EURO,0,1805,0,10
9772,2020-05-30T00:00:00Z,IS,Iceland,EURO,0,1805,0,10
9773,2020-05-31T00:00:00Z,IS,Iceland,EURO,1,1806,0,10
9774,2020-06-01T00:00:00Z,IS,Iceland,EURO,0,1806,0,10
9775,2020-06-02T00:00:00Z,IS,Iceland,EURO,0,1806,0,10
9776,2020-06-03T00:00:00Z,IS,Iceland,EURO,0,1806,0,10
9777,2020-06-04T00:00:00Z,IS,Iceland,EURO,0,1806,0,10
9778,2020-06-05T00:00:00Z,IS,Iceland,EURO,0,1806,0,10
9779,2020-06-06T00:00:00Z,IS,Iceland,EURO,0,1806,0,10
9780,2020-06-07T00:00:00Z,IS,Iceland,EURO,0,1806,0,10
9781,2020-06-08T00:00:00Z,IS,Iceland,EURO,1,1807,0,10
9782,2020-06-09T00:00:00Z,IS,Iceland,EURO,0,1807,0,10
9783,2020-06-10T00:00:00Z,IS,Iceland,EURO,0,1807,0,10
9784,2020-06-11T00:00:00Z,IS,Iceland,EURO,0,1807,0,10
9785,2020-06-12T00:00:00Z,IS,Iceland,EURO,0,1807,0,10
9786,2020-06-13T00:00:00Z,IS,Iceland,EURO,0,1807,0,10
9787,2020-06-14T00:00:00Z,IS,Iceland,EURO,1,1808,0,10
9788,2020-06-15T00:00:00Z,IS,Iceland,EURO,2,1810,0,10
9789,2020-06-16T00:00:00Z,IS,Iceland,EURO,0,1810,0,10
9790,2020-06-17T00:00:00Z,IS,Iceland,EURO,2,1812,0,10
9791,2020-06-18T00:00:00Z,IS,Iceland,EURO,3,1815,0,10
9792,2020-06-19T00:00:00Z,IS,Iceland,EURO,1,1816,0,10
9793,2020-06-20T00:00:00Z,IS,Iceland,EURO,3,1819,0,10
10289,2020-03-01T00:00:00Z,IE,Ireland,EURO,1,1,0,0
10290,2020-03-02T00:00:00Z,IE,Ireland,EURO,0,1,0,0
10291,2020-03-03T00:00:00Z,IE,Ireland,EURO,1,2,0,0
10292,2020-03-04T00:00:00Z,IE,Ireland,EURO,0,2,0,0
10293,2020-03-05T00:00:00Z,IE,Ireland,EURO,12,14,0,0
10294,2020-03-06T00:00:00Z,IE,Ireland,EURO,4,18,0,0
10295,2020-03-07T00:00:00Z,IE,Ireland,EURO,1,19,0,0
10296,2020-03-08T00:00:00Z,IE,Ireland,EURO,2,21,0,0
10297,2020-03-09T00:00:00Z,IE,Ireland,EURO,0,21,0,0
10298,2020-03-10T00:00:00Z,IE,Ireland,EURO,13,34,0,0
10299,2020-03-11T00:00:00Z,IE,Ireland,EURO,9,43,1,1
10300,2020-03-12T00:00:00Z,IE,Ireland,EURO,27,70,0,1
10301,2020-03-13T00:00:00Z,IE,Ireland,EURO,21,91,0,1
10302,2020-03-14T00:00:00Z,IE,Ireland,EURO,38,129,0,1
10303,2020-03-15T00:00:00Z,IE,Ireland,EURO,40,169,1,2
10304,2020-03-16T00:00:00Z,IE,Ireland,EURO,54,223,0,2
10305,2020-03-17T00:00:00Z,IE,Ireland,EURO,69,292,0,2
10306,2020-03-18T00:00:00Z,IE,Ireland,EURO,0,292,0,2
10307,2020-03-19T00:00:00Z,IE,Ireland,EURO,265,557,1,3
10308,2020-03-20T00:00:00Z,IE,Ireland,EURO,126,683,0,3
10309,2020-03-21T00:00:00Z,IE,Ireland,EURO,102,785,0,3
10310,2020-03-22T00:00:00Z,IE,Ireland,EURO,0,785,0,3
10311,2020-03-23T00:00:00Z,IE,Ireland,EURO,121,906,1,4
10312,2020-03-24T00:00:00Z,IE,Ireland,EURO,219,1125,2,6
10313,2020-03-25T00:00:00Z,IE,Ireland,EURO,204,1329,1,7
10314,2020-03-26T00:00:00Z,IE,Ireland,EURO,235,1564,2,9
10315,2020-03-27T00:00:00Z,IE,Ireland,EURO,255,1819,10,19
10316,2020-03-28T00:00:00Z,IE,Ireland,EURO,302,2121,3,22
10317,2020-03-29T00:00:00Z,IE,Ireland,EURO,294,2415,14,36
10318,2020-03-30T00:00:00Z,IE,Ireland,EURO,200,2615,10,46
10319,2020-03-31T00:00:00Z,IE,Ireland,EURO,295,2910,8,54
10320,2020-04-01T00:00:00Z,IE,Ireland,EURO,325,3235,17,71
10321,2020-04-02T00:00:00Z,IE,Ireland,EURO,212,3447,14,85
10322,2020-04-03T00:00:00Z,IE,Ireland,EURO,402,3849,13,98
10323,2020-04-04T00:00:00Z,IE,Ireland,EURO,424,4273,22,120
10324,2020-04-05T00:00:00Z,IE,Ireland,EURO,331,4604,17,137
10325,2020-04-06T00:00:00Z,IE,Ireland,EURO,507,5111,21,158
10326,2020-04-07T00:00:00Z,IE,Ireland,EURO,253,5364,16,174
10327,2020-04-08T00:00:00Z,IE,Ireland,EURO,345,5709,36,210
10328,2020-04-09T00:00:00Z,IE,Ireland,EURO,515,6224,25,235
10329,2020-04-10T00:00:00Z,IE,Ireland,EURO,1169,7393,28,263
10330,2020-04-11T00:00:00Z,IE,Ireland,EURO,696,8089,24,287
10331,2020-04-12T00:00:00Z,IE,Ireland,EURO,839,8928,33,320
10332,2020-04-13T00:00:00Z,IE,Ireland,EURO,727,9655,14,334
10333,2020-04-14T00:00:00Z,IE,Ireland,EURO,992,10647,31,365
10334,2020-04-15T00:00:00Z,IE,Ireland,EURO,832,11479,41,406
10335,2020-04-16T00:00:00Z,IE,Ireland,EURO,1068,12547,38,444
10336,2020-04-17T00:00:00Z,IE,Ireland,EURO,724,13271,42,486
10337,2020-04-18T00:00:00Z,IE,Ireland,EURO,709,13980,44,530
10338,2020-04-19T00:00:00Z,IE,Ireland,EURO,778,14758,41,571
10339,2020-04-20T00:00:00Z,IE,Ireland,EURO,493,15251,39,610
10340,2020-04-21T00:00:00Z,IE,Ireland,EURO,401,15652,77,687
10341,2020-04-22T00:00:00Z,IE,Ireland,EURO,388,16040,43,730
10342,2020-04-23T00:00:00Z,IE,Ireland,EURO,631,16671,39,769
10343,2020-04-24T00:00:00Z,IE,Ireland,EURO,936,17607,25,794
10344,2020-04-25T00:00:00Z,IE,Ireland,EURO,577,18184,35,829
10345,2020-04-26T00:00:00Z,IE,Ireland,EURO,377,18561,234,1063
10346,2020-04-27T00:00:00Z,IE,Ireland,EURO,701,19262,24,1087
10347,2020-04-28T00:00:00Z,IE,Ireland,EURO,386,19648,15,1102
10348,2020-04-29T00:00:00Z,IE,Ireland,EURO,229,19877,57,1159
10349,2020-04-30T00:00:00Z,IE,Ireland,EURO,376,20253,31,1190
10350,2020-05-01T00:00:00Z,IE,Ireland,EURO,359,20612,42,1232
10351,2020-05-02T00:00:00Z,IE,Ireland,EURO,221,20833,33,1265
10352,2020-05-03T00:00:00Z,IE,Ireland,EURO,343,21176,0,1265
10353,2020-05-04T00:00:00Z,IE,Ireland,EURO,330,21506,38,1303
10354,2020-05-05T00:00:00Z,IE,Ireland,EURO,216,21722,16,1319
10355,2020-05-06T00:00:00Z,IE,Ireland,EURO,261,21983,20,1339
10356,2020-05-07T00:00:00Z,IE,Ireland,EURO,265,22248,36,1375
10357,2020-05-08T00:00:00Z,IE,Ireland,EURO,137,22385,28,1403
10358,2020-05-09T00:00:00Z,IE,Ireland,EURO,156,22541,26,1429
10359,2020-05-10T00:00:00Z,IE,Ireland,EURO,219,22760,17,1446
10360,2020-05-11T00:00:00Z,IE,Ireland,EURO,236,22996,12,1458
10361,2020-05-12T00:00:00Z,IE,Ireland,EURO,139,23135,9,1467
10362,2020-05-13T00:00:00Z,IE,Ireland,EURO,107,23242,21,1488
10363,2020-05-14T00:00:00Z,IE,Ireland,EURO,159,23401,9,1497
10364,2020-05-15T00:00:00Z,IE,Ireland,EURO,426,23827,9,1506
10365,2020-05-16T00:00:00Z,IE,Ireland,EURO,129,23956,12,1518
10366,2020-05-17T00:00:00Z,IE,Ireland,EURO,92,24048,15,1533
10367,2020-05-18T00:00:00Z,IE,Ireland,EURO,64,24112,10,1543
10368,2020-05-19T00:00:00Z,IE,Ireland,EURO,88,24200,4,1547
10369,2020-05-20T00:00:00Z,IE,Ireland,EURO,51,24251,14,1561
10370,2020-05-21T00:00:00Z,IE,Ireland,EURO,64,24315,10,1571
10371,2020-05-22T00:00:00Z,IE,Ireland,EURO,76,24391,12,1583
10372,2020-05-23T00:00:00Z,IE,Ireland,EURO,115,24506,9,1592
10373,2020-05-24T00:00:00Z,IE,Ireland,EURO,76,24582,12,1604
10374,2020-05-25T00:00:00Z,IE,Ireland,EURO,57,24639,4,1608
10375,2020-05-26T00:00:00Z,IE,Ireland,EURO,59,24698,-2,1606
10376,2020-05-27T00:00:00Z,IE,Ireland,EURO,37,24735,9,1615
10377,2020-05-28T00:00:00Z,IE,Ireland,EURO,68,24803,16,1631
10378,2020-05-29T00:00:00Z,IE,Ireland,EURO,38,24841,8,1639
10379,2020-05-30T00:00:00Z,IE,Ireland,EURO,35,24876,6,1645
10380,2020-05-31T00:00:00Z,IE,Ireland,EURO,53,24929,4,1649
10381,2020-06-01T00:00:00Z,IE,Ireland,EURO,61,24990,1,1650
10382,2020-06-02T00:00:00Z,IE,Ireland,EURO,72,25062,0,1650
10383,2020-06-03T00:00:00Z,IE,Ireland,EURO,4,25066,8,1658
10384,2020-06-04T00:00:00Z,IE,Ireland,EURO,45,25111,1,1659
10385,2020-06-05T00:00:00Z,IE,Ireland,EURO,31,25142,5,1664
10386,2020-06-06T00:00:00Z,IE,Ireland,EURO,21,25163,6,1670
10387,2020-06-07T00:00:00Z,IE,Ireland,EURO,20,25183,0,1670
10388,2020-06-08T00:00:00Z,IE,Ireland,EURO,18,25201,9,1679
10389,2020-06-09T00:00:00Z,IE,Ireland,EURO,6,25207,4,1683
10390,2020-06-10T00:00:00Z,IE,Ireland,EURO,8,25215,8,1691
10391,2020-06-11T00:00:00Z,IE,Ireland,EURO,16,25231,4,1695
10392,2020-06-12T00:00:00Z,IE,Ireland,EURO,7,25238,8,1703
10393,2020-06-13T00:00:00Z,IE,Ireland,EURO,12,25250,2,1705
10394,2020-06-14T00:00:00Z,IE,Ireland,EURO,45,25295,0,1705
10395,2020-06-15T00:00:00Z,IE,Ireland,EURO,8,25303,1,1706
10396,2020-06-16T00:00:00Z,IE,Ireland,EURO,18,25321,0,1706
10397,2020-06-17T00:00:00Z,IE,Ireland,EURO,13,25334,3,1709
10398,2020-06-18T00:00:00Z,IE,Ireland,EURO,7,25341,1,1710
10399,2020-06-19T00:00:00Z,IE,Ireland,EURO,14,25355,4,1714
10400,2020-06-20T00:00:00Z,IE,Ireland,EURO,13,25368,0,1714
10401,2020-03-20T00:00:00Z,IM,Isle of Man,EURO,1,1,0,0
10402,2020-03-21T00:00:00Z,IM,Isle of Man,EURO,1,2,0,0
10403,2020-03-22T00:00:00Z,IM,Isle of Man,EURO,0,2,0,0
10404,2020-03-23T00:00:00Z,IM,Isle of Man,EURO,0,2,0,0
10405,2020-03-24T00:00:00Z,IM,Isle of Man,EURO,11,13,0,0
10406,2020-03-25T00:00:00Z,IM,Isle of Man,EURO,10,23,0,0
10407,2020-03-26T00:00:00Z,IM,Isle of Man,EURO,0,23,0,0
10408,2020-03-27T00:00:00Z,IM,Isle of Man,EURO,3,26,0,0
10409,2020-03-28T00:00:00Z,IM,Isle of Man,EURO,3,29,0,0
10410,2020-03-29T00:00:00Z,IM,Isle of Man,EURO,3,32,0,0
10411,2020-03-30T00:00:00Z,IM,Isle of Man,EURO,10,42,0,0
10412,2020-03-31T00:00:00Z,IM,Isle of Man,EURO,0,42,0,0
10413,2020-04-01T00:00:00Z,IM,Isle of Man,EURO,10,52,0,0
10414,2020-04-02T00:00:00Z,IM,Isle of Man,EURO,13,65,0,0
10415,2020-04-03T00:00:00Z,IM,Isle of Man,EURO,6,71,1,1
10416,2020-04-04T00:00:00Z,IM,Isle of Man,EURO,43,114,0,1
10417,2020-04-05T00:00:00Z,IM,Isle of Man,EURO,12,126,0,1
10418,2020-04-06T00:00:00Z,IM,Isle of Man,EURO,1,127,0,1
10419,2020-04-07T00:00:00Z,IM,Isle of Man,EURO,0,127,0,1
10420,2020-04-08T00:00:00Z,IM,Isle of Man,EURO,23,150,0,1
10421,2020-04-09T00:00:00Z,IM,Isle of Man,EURO,0,150,0,1
10422,2020-04-10T00:00:00Z,IM,Isle of Man,EURO,15,165,0,1
10423,2020-04-11T00:00:00Z,IM,Isle of Man,EURO,25,190,0,1
10424,2020-04-12T00:00:00Z,IM,Isle of Man,EURO,14,204,0,1
10425,2020-04-13T00:00:00Z,IM,Isle of Man,EURO,22,226,0,1
10426,2020-04-14T00:00:00Z,IM,Isle of Man,EURO,2,228,1,2
10427,2020-04-15T00:00:00Z,IM,Isle of Man,EURO,14,242,0,2
10428,2020-04-16T00:00:00Z,IM,Isle of Man,EURO,12,254,0,2
10429,2020-04-17T00:00:00Z,IM,Isle of Man,EURO,4,258,2,4
10430,2020-04-18T00:00:00Z,IM,Isle of Man,EURO,31,289,0,4
10431,2020-04-19T00:00:00Z,IM,Isle of Man,EURO,2,291,0,4
10432,2020-04-20T00:00:00Z,IM,Isle of Man,EURO,6,297,0,4
10433,2020-04-21T00:00:00Z,IM,Isle of Man,EURO,0,297,0,4
10434,2020-04-22T00:00:00Z,IM,Isle of Man,EURO,10,307,6,10
10435,2020-04-23T00:00:00Z,IM,Isle of Man,EURO,0,307,0,10
10436,2020-04-24T00:00:00Z,IM,Isle of Man,EURO,0,307,6,16
10437,2020-04-25T00:00:00Z,IM,Isle of Man,EURO,1,308,1,17
10438,2020-04-26T00:00:00Z,IM,Isle of Man,EURO,0,308,1,18
10439,2020-04-27T00:00:00Z,IM,Isle of Man,EURO,0,308,0,18
10440,2020-04-28T00:00:00Z,IM,Isle of Man,EURO,0,308,0,18
10441,2020-04-29T00:00:00Z,IM,Isle of Man,EURO,0,308,2,20
10442,2020-04-30T00:00:00Z,IM,Isle of Man,EURO,1,309,1,21
10443,2020-05-01T00:00:00Z,IM,Isle of Man,EURO,2,311,1,22
10444,2020-05-02T00:00:00Z,IM,Isle of Man,EURO,0,311,0,22
10445,2020-05-03T00:00:00Z,IM,Isle of Man,EURO,4,315,1,23
10446,2020-05-04T00:00:00Z,IM,Isle of Man,EURO,5,320,0,23
10447,2020-05-05T00:00:00Z,IM,Isle of Man,EURO,1,321,0,23
10448,2020-05-06T00:00:00Z,IM,Isle of Man,EURO,4,325,0,23
10449,2020-05-07T00:00:00Z,IM,Isle of Man,EURO,1,326,0,23
10450,2020-05-08T00:00:00Z,IM,Isle of Man,EURO,1,327,0,23
10451,2020-05-09T00:00:00Z,IM,Isle of Man,EURO,2,329,0,23
10452,2020-05-10T00:00:00Z,IM,Isle of Man,EURO,0,329,0,23
10453,2020-05-11T00:00:00Z,IM,Isle of Man,EURO,1,330,0,23
10454,2020-05-12T00:00:00Z,IM,Isle of Man,EURO,0,330,0,23
10455,2020-05-13T00:00:00Z,IM,Isle of Man,EURO,0,330,0,23
10456,2020-05-14T00:00:00Z,IM,Isle of Man,EURO,1,331,0,23
10457,2020-05-15T00:00:00Z,IM,Isle of Man,EURO,0,331,0,23
10458,2020-05-16T00:00:00Z,IM,Isle of Man,EURO,2,333,1,24
10459,2020-05-17T00:00:00Z,IM,Isle of Man,EURO,1,334,0,24
10460,2020-05-18T00:00:00Z,IM,Isle of Man,EURO,1,335,0,24
10461,2020-05-19T00:00:00Z,IM,Isle of Man,EURO,0,335,0,24
10462,2020-05-20T00:00:00Z,IM,Isle of Man,EURO,0,335,0,24
10463,2020-05-21T00:00:00Z,IM,Isle of Man,EURO,0,335,0,24
10464,2020-05-22T00:00:00Z,IM,Isle of Man,EURO,1,336,0,24
10465,2020-05-23T00:00:00Z,IM,Isle of Man,EURO,0,336,0,24
10466,2020-05-24T00:00:00Z,IM,Isle of Man,EURO,0,336,0,24
10467,2020-05-25T00:00:00Z,IM,Isle of Man,EURO,0,336,0,24
10468,2020-05-26T00:00:00Z,IM,Isle of Man,EURO,0,336,0,24
10469,2020-05-27T00:00:00Z,IM,Isle of Man,EURO,0,336,0,24
10470,2020-05-28T00:00:00Z,IM,Isle of Man,EURO,0,336,0,24
10471,2020-05-29T00:00:00Z,IM,Isle of Man,EURO,0,336,0,24
10472,2020-05-30T00:00:00Z,IM,Isle of Man,EURO,0,336,0,24
10473,2020-05-31T00:00:00Z,IM,Isle of Man,EURO,0,336,0,24
10474,2020-06-01T00:00:00Z,IM,Isle of Man,EURO,0,336,0,24
10475,2020-06-02T00:00:00Z,IM,Isle of Man,EURO,0,336,0,24
10476,2020-06-03T00:00:00Z,IM,Isle of Man,EURO,0,336,0,24
10477,2020-06-04T00:00:00Z,IM,Isle of Man,EURO,0,336,0,24
10478,2020-06-05T00:00:00Z,IM,Isle of Man,EURO,0,336,0,24
10479,2020-06-06T00:00:00Z,IM,Isle of Man,EURO,0,336,0,24
10480,2020-06-07T00:00:00Z,IM,Isle of Man,EURO,0,336,0,24
10481,2020-06-08T00:00:00Z,IM,Isle of Man,EURO,0,336,0,24
10482,2020-06-09T00:00:00Z,IM,Isle of Man,EURO,0,336,0,24
10483,2020-06-10T00:00:00Z,IM,Isle of Man,EURO,0,336,0,24
10484,2020-06-11T00:00:00Z,IM,Isle of Man,EURO,0,336,0,24
10485,2020-06-12T00:00:00Z,IM,Isle of Man,EURO,0,336,0,24
10486,2020-06-13T00:00:00Z,IM,Isle of Man,EURO,0,336,0,24
10487,2020-06-14T00:00:00Z,IM,Isle of Man,EURO,0,336,0,24
10488,2020-06-15T00:00:00Z,IM,Isle of Man,EURO,0,336,0,24
10489,2020-06-16T00:00:00Z,IM,Isle of Man,EURO,0,336,0,24
10490,2020-06-17T00:00:00Z,IM,Isle of Man,EURO,0,336,0,24
10491,2020-06-18T00:00:00Z,IM,Isle of Man,EURO,0,336,0,24
10492,2020-06-19T00:00:00Z,IM,Isle of Man,EURO,0,336,0,24
10493,2020-06-20T00:00:00Z,IM,Isle of Man,EURO,0,336,0,24
10494,2020-02-21T00:00:00Z,IL,Israel,EURO,1,1,0,0
10495,2020-02-22T00:00:00Z,IL,Israel,EURO,0,1,0,0
10496,2020-02-23T00:00:00Z,IL,Israel,EURO,0,1,0,0
10497,2020-02-24T00:00:00Z,IL,Israel,EURO,1,2,0,0
10498,2020-02-25T00:00:00Z,IL,Israel,EURO,0,2,0,0
10499,2020-02-26T00:00:00Z,IL,Israel,EURO,0,2,0,0
10500,2020-02-27T00:00:00Z,IL,Israel,EURO,1,3,0,0
10501,2020-02-28T00:00:00Z,IL,Israel,EURO,2,5,0,0
10502,2020-02-29T00:00:00Z,IL,Israel,EURO,2,7,0,0
10503,2020-03-01T00:00:00Z,IL,Israel,EURO,0,7,0,0
10504,2020-03-02T00:00:00Z,IL,Israel,EURO,3,10,0,0
10505,2020-03-03T00:00:00Z,IL,Israel,EURO,2,12,0,0
10506,2020-03-04T00:00:00Z,IL,Israel,EURO,3,15,0,0
10507,2020-03-05T00:00:00Z,IL,Israel,EURO,0,15,0,0
10508,2020-03-06T00:00:00Z,IL,Israel,EURO,4,19,0,0
10509,2020-03-07T00:00:00Z,IL,Israel,EURO,2,21,0,0
10510,2020-03-08T00:00:00Z,IL,Israel,EURO,18,39,0,0
10511,2020-03-09T00:00:00Z,IL,Israel,EURO,0,39,0,0
10512,2020-03-10T00:00:00Z,IL,Israel,EURO,19,58,0,0
10513,2020-03-11T00:00:00Z,IL,Israel,EURO,17,75,0,0
10514,2020-03-12T00:00:00Z,IL,Israel,EURO,24,99,0,0
10515,2020-03-13T00:00:00Z,IL,Israel,EURO,27,126,0,0
10516,2020-03-14T00:00:00Z,IL,Israel,EURO,52,178,0,0
10517,2020-03-15T00:00:00Z,IL,Israel,EURO,22,200,0,0
10518,2020-03-16T00:00:00Z,IL,Israel,EURO,50,250,0,0
10519,2020-03-17T00:00:00Z,IL,Israel,EURO,54,304,0,0
10520,2020-03-18T00:00:00Z,IL,Israel,EURO,123,427,0,0
10521,2020-03-19T00:00:00Z,IL,Israel,EURO,102,529,0,0
10522,2020-03-20T00:00:00Z,IL,Israel,EURO,183,712,1,1
10523,2020-03-21T00:00:00Z,IL,Israel,EURO,171,883,0,1
10524,2020-03-22T00:00:00Z,IL,Israel,EURO,0,883,0,1
10525,2020-03-23T00:00:00Z,IL,Israel,EURO,188,1071,0,1
10526,2020-03-24T00:00:00Z,IL,Israel,EURO,167,1238,0,1
10527,2020-03-25T00:00:00Z,IL,Israel,EURO,932,2170,4,5
10528,2020-03-26T00:00:00Z,IL,Israel,EURO,199,2369,0,5
10529,2020-03-27T00:00:00Z,IL,Israel,EURO,666,3035,5,10
10530,2020-03-28T00:00:00Z,IL,Israel,EURO,425,3460,2,12
10531,2020-03-29T00:00:00Z,IL,Israel,EURO,405,3865,3,15
10532,2020-03-30T00:00:00Z,IL,Israel,EURO,382,4247,0,15
10533,2020-03-31T00:00:00Z,IL,Israel,EURO,584,4831,2,17
10534,2020-04-01T00:00:00Z,IL,Israel,EURO,298,5129,4,21
10535,2020-04-02T00:00:00Z,IL,Israel,EURO,462,5591,0,21
10536,2020-04-03T00:00:00Z,IL,Israel,EURO,620,6211,8,29
10537,2020-04-04T00:00:00Z,IL,Israel,EURO,819,7030,7,36
10538,2020-04-05T00:00:00Z,IL,Israel,EURO,559,7589,6,42
10539,2020-04-06T00:00:00Z,IL,Israel,EURO,429,8018,4,46
10540,2020-04-07T00:00:00Z,IL,Israel,EURO,593,8611,6,52
10541,2020-04-08T00:00:00Z,IL,Israel,EURO,793,9404,19,71
10542,2020-04-09T00:00:00Z,IL,Israel,EURO,0,9404,0,71
10543,2020-04-10T00:00:00Z,IL,Israel,EURO,351,9755,8,79
10544,2020-04-11T00:00:00Z,IL,Israel,EURO,340,10095,13,92
10545,2020-04-12T00:00:00Z,IL,Israel,EURO,430,10525,4,96
10546,2020-04-13T00:00:00Z,IL,Israel,EURO,353,10878,7,103
10547,2020-04-14T00:00:00Z,IL,Israel,EURO,357,11235,7,110
10548,2020-04-15T00:00:00Z,IL,Israel,EURO,633,11868,7,117
10549,2020-04-16T00:00:00Z,IL,Israel,EURO,332,12200,9,126
10550,2020-04-17T00:00:00Z,IL,Israel,EURO,391,12591,14,140
10551,2020-04-18T00:00:00Z,IL,Israel,EURO,264,12855,8,148
10552,2020-04-19T00:00:00Z,IL,Israel,EURO,252,13107,10,158
10553,2020-04-20T00:00:00Z,IL,Israel,EURO,255,13362,13,171
10554,2020-04-21T00:00:00Z,IL,Israel,EURO,521,13883,10,181
10555,2020-04-22T00:00:00Z,IL,Israel,EURO,59,13942,3,184
10556,2020-04-23T00:00:00Z,IL,Israel,EURO,556,14498,5,189
10557,2020-04-24T00:00:00Z,IL,Israel,EURO,305,14803,3,192
10558,2020-04-25T00:00:00Z,IL,Israel,EURO,225,15028,2,194
10559,2020-04-26T00:00:00Z,IL,Israel,EURO,370,15398,5,199
10560,2020-04-27T00:00:00Z,IL,Israel,EURO,0,15398,0,199
10561,2020-04-28T00:00:00Z,IL,Israel,EURO,68,15466,3,202
10562,2020-04-29T00:00:00Z,IL,Israel,EURO,316,15782,10,212
10563,2020-04-30T00:00:00Z,IL,Israel,EURO,0,15782,0,212
10564,2020-05-01T00:00:00Z,IL,Israel,EURO,222,16004,11,223
10565,2020-05-02T00:00:00Z,IL,Israel,EURO,148,16152,4,227
10566,2020-05-03T00:00:00Z,IL,Israel,EURO,0,16152,0,227
10567,2020-05-04T00:00:00Z,IL,Israel,EURO,0,16152,0,227
10568,2020-05-05T00:00:00Z,IL,Israel,EURO,85,16237,7,234
10569,2020-05-06T00:00:00Z,IL,Israel,EURO,31,16268,3,237
10570,2020-05-07T00:00:00Z,IL,Israel,EURO,46,16314,1,238
10571,2020-05-08T00:00:00Z,IL,Israel,EURO,32,16346,1,239
10572,2020-05-09T00:00:00Z,IL,Israel,EURO,98,16444,6,245
10573,2020-05-10T00:00:00Z,IL,Israel,EURO,0,16444,0,245
10574,2020-05-11T00:00:00Z,IL,Israel,EURO,48,16492,9,254
10575,2020-05-12T00:00:00Z,IL,Israel,EURO,34,16526,4,258
10576,2020-05-13T00:00:00Z,IL,Israel,EURO,13,16539,4,262
10577,2020-05-14T00:00:00Z,IL,Israel,EURO,0,16539,0,262
10578,2020-05-15T00:00:00Z,IL,Israel,EURO,28,16567,2,264
10579,2020-05-16T00:00:00Z,IL,Israel,EURO,22,16589,2,266
10580,2020-05-17T00:00:00Z,IL,Israel,EURO,19,16608,2,268
10581,2020-05-18T00:00:00Z,IL,Israel,EURO,-1,16607,3,271
10582,2020-05-19T00:00:00Z,IL,Israel,EURO,14,16621,1,272
10583,2020-05-20T00:00:00Z,IL,Israel,EURO,29,16650,5,277
10584,2020-05-21T00:00:00Z,IL,Israel,EURO,9,16659,1,278
10585,2020-05-22T00:00:00Z,IL,Israel,EURO,31,16690,1,279
10586,2020-05-23T00:00:00Z,IL,Israel,EURO,0,16690,0,279
10587,2020-05-24T00:00:00Z,IL,Israel,EURO,22,16712,0,279
10588,2020-05-25T00:00:00Z,IL,Israel,EURO,0,16712,0,279
10589,2020-05-26T00:00:00Z,IL,Israel,EURO,8,16720,1,280
10590,2020-05-27T00:00:00Z,IL,Israel,EURO,23,16743,1,281
10591,2020-05-28T00:00:00Z,IL,Israel,EURO,28,16771,0,281
10592,2020-05-29T00:00:00Z,IL,Israel,EURO,38,16809,0,281
10593,2020-05-30T00:00:00Z,IL,Israel,EURO,0,16809,0,281
10594,2020-05-31T00:00:00Z,IL,Israel,EURO,262,17071,4,285
10595,2020-06-01T00:00:00Z,IL,Israel,EURO,0,17071,0,285
10596,2020-06-02T00:00:00Z,IL,Israel,EURO,148,17219,2,287
10597,2020-06-03T00:00:00Z,IL,Israel,EURO,0,17219,0,287
10598,2020-06-04T00:00:00Z,IL,Israel,EURO,0,17219,0,287
10599,2020-06-05T00:00:00Z,IL,Israel,EURO,276,17495,4,291
10600,2020-06-06T00:00:00Z,IL,Israel,EURO,67,17562,0,291
10601,2020-06-07T00:00:00Z,IL,Israel,EURO,144,17706,1,292
10602,2020-06-08T00:00:00Z,IL,Israel,EURO,77,17783,2,294
10603,2020-06-09T00:00:00Z,IL,Israel,EURO,132,17915,1,295
10604,2020-06-10T00:00:00Z,IL,Israel,EURO,174,18089,3,298
10605,2020-06-11T00:00:00Z,IL,Israel,EURO,179,18268,1,299
10606,2020-06-12T00:00:00Z,IL,Israel,EURO,193,18461,1,300
10607,2020-06-13T00:00:00Z,IL,Israel,EURO,240,18701,0,300
10608,2020-06-14T00:00:00Z,IL,Israel,EURO,175,18876,0,300
10609,2020-06-15T00:00:00Z,IL,Israel,EURO,132,19008,0,300
10610,2020-06-16T00:00:00Z,IL,Israel,EURO,113,19121,2,302
10611,2020-06-17T00:00:00Z,IL,Israel,EURO,217,19338,0,302
10612,2020-06-18T00:00:00Z,IL,Israel,EURO,299,19637,1,303
10613,2020-06-19T00:00:00Z,IL,Israel,EURO,239,19876,0,303
10614,2020-06-20T00:00:00Z,IL,Israel,EURO,312,20188,1,304
10615,2020-01-29T00:00:00Z,IT,Italy,EURO,2,2,0,0
10616,2020-01-30T00:00:00Z,IT,Italy,EURO,0,2,0,0
10617,2020-01-31T00:00:00Z,IT,Italy,EURO,0,2,0,0
10618,2020-02-01T00:00:00Z,IT,Italy,EURO,0,2,0,0
10619,2020-02-02T00:00:00Z,IT,Italy,EURO,0,2,0,0
10620,2020-02-03T00:00:00Z,IT,Italy,EURO,0,2,0,0
10621,2020-02-04T00:00:00Z,IT,Italy,EURO,0,2,0,0
10622,2020-02-05T00:00:00Z,IT,Italy,EURO,0,2,0,0
10623,2020-02-06T00:00:00Z,IT,Italy,EURO,0,2,0,0
10624,2020-02-07T00:00:00Z,IT,Italy,EURO,1,3,0,0
10625,2020-02-08T00:00:00Z,IT,Italy,EURO,0,3,0,0
10626,2020-02-09T00:00:00Z,IT,Italy,EURO,0,3,0,0
10627,2020-02-10T00:00:00Z,IT,Italy,EURO,0,3,0,0
10628,2020-02-11T00:00:00Z,IT,Italy,EURO,0,3,0,0
10629,2020-02-12T00:00:00Z,IT,Italy,EURO,0,3,0,0
10630,2020-02-13T00:00:00Z,IT,Italy,EURO,0,3,0,0
10631,2020-02-14T00:00:00Z,IT,Italy,EURO,0,3,0,0
10632,2020-02-15T00:00:00Z,IT,Italy,EURO,0,3,0,0
10633,2020-02-16T00:00:00Z,IT,Italy,EURO,0,3,0,0
10634,2020-02-17T00:00:00Z,IT,Italy,EURO,0,3,0,0
10635,2020-02-18T00:00:00Z,IT,Italy,EURO,0,3,0,0
10636,2020-02-19T00:00:00Z,IT,Italy,EURO,0,3,0,0
10637,2020-02-20T00:00:00Z,IT,Italy,EURO,0,3,0,0
10638,2020-02-21T00:00:00Z,IT,Italy,EURO,1,4,0,0
10639,2020-02-22T00:00:00Z,IT,Italy,EURO,7,11,2,2
10640,2020-02-23T00:00:00Z,IT,Italy,EURO,113,124,0,2
10641,2020-02-24T00:00:00Z,IT,Italy,EURO,105,229,5,7
10642,2020-02-25T00:00:00Z,IT,Italy,EURO,93,322,5,12
10643,2020-02-26T00:00:00Z,IT,Italy,EURO,78,400,0,12
10644,2020-02-27T00:00:00Z,IT,Italy,EURO,250,650,5,17
10645,2020-02-28T00:00:00Z,IT,Italy,EURO,238,888,4,21
10646,2020-02-29T00:00:00Z,IT,Italy,EURO,240,1128,8,29
10647,2020-03-01T00:00:00Z,IT,Italy,EURO,561,1689,6,35
10648,2020-03-02T00:00:00Z,IT,Italy,EURO,347,2036,17,52
10649,2020-03-03T00:00:00Z,IT,Italy,EURO,466,2502,28,80
10650,2020-03-04T00:00:00Z,IT,Italy,EURO,587,3089,27,107
10651,2020-03-05T00:00:00Z,IT,Italy,EURO,769,3858,41,148
10652,2020-03-06T00:00:00Z,IT,Italy,EURO,778,4636,49,197
10653,2020-03-07T00:00:00Z,IT,Italy,EURO,1247,5883,37,234
10654,2020-03-08T00:00:00Z,IT,Italy,EURO,1492,7375,132,366
10655,2020-03-09T00:00:00Z,IT,Italy,EURO,1797,9172,97,463
10656,2020-03-10T00:00:00Z,IT,Italy,EURO,977,10149,168,631
10657,2020-03-11T00:00:00Z,IT,Italy,EURO,2313,12462,196,827
10658,2020-03-12T00:00:00Z,IT,Italy,EURO,2651,15113,189,1016
10659,2020-03-13T00:00:00Z,IT,Italy,EURO,2547,17660,252,1268
10660,2020-03-14T00:00:00Z,IT,Italy,EURO,3497,21157,173,1441
10661,2020-03-15T00:00:00Z,IT,Italy,EURO,3590,24747,368,1809
10662,2020-03-16T00:00:00Z,IT,Italy,EURO,3233,27980,349,2158
10663,2020-03-17T00:00:00Z,IT,Italy,EURO,3526,31506,347,2505
10664,2020-03-18T00:00:00Z,IT,Italy,EURO,4207,35713,473,2978
10665,2020-03-19T00:00:00Z,IT,Italy,EURO,5322,41035,429,3407
10666,2020-03-20T00:00:00Z,IT,Italy,EURO,5986,47021,625,4032
10667,2020-03-21T00:00:00Z,IT,Italy,EURO,6557,53578,795,4827
10668,2020-03-22T00:00:00Z,IT,Italy,EURO,0,53578,0,4827
10669,2020-03-23T00:00:00Z,IT,Italy,EURO,5560,59138,649,5476
10670,2020-03-24T00:00:00Z,IT,Italy,EURO,4789,63927,601,6077
10671,2020-03-25T00:00:00Z,IT,Italy,EURO,5249,69176,743,6820
10672,2020-03-26T00:00:00Z,IT,Italy,EURO,5210,74386,685,7505
10673,2020-03-27T00:00:00Z,IT,Italy,EURO,6153,80539,660,8165
10674,2020-03-28T00:00:00Z,IT,Italy,EURO,5959,86498,971,9136
10675,2020-03-29T00:00:00Z,IT,Italy,EURO,5974,92472,887,10023
10676,2020-03-30T00:00:00Z,IT,Italy,EURO,5217,97689,758,10781
10677,2020-03-31T00:00:00Z,IT,Italy,EURO,4050,101739,810,11591
10678,2020-04-01T00:00:00Z,IT,Italy,EURO,4053,105792,839,12430
10679,2020-04-02T00:00:00Z,IT,Italy,EURO,4782,110574,727,13157
10680,2020-04-03T00:00:00Z,IT,Italy,EURO,4668,115242,760,13917
10681,2020-04-04T00:00:00Z,IT,Italy,EURO,4585,119827,764,14681
10682,2020-04-05T00:00:00Z,IT,Italy,EURO,4805,124632,681,15362
10683,2020-04-06T00:00:00Z,IT,Italy,EURO,4316,128948,527,15889
10684,2020-04-07T00:00:00Z,IT,Italy,EURO,3599,132547,636,16525
10685,2020-04-08T00:00:00Z,IT,Italy,EURO,3039,135586,604,17129
10686,2020-04-09T00:00:00Z,IT,Italy,EURO,3836,139422,540,17669
10687,2020-04-10T00:00:00Z,IT,Italy,EURO,4204,143626,612,18281
10688,2020-04-11T00:00:00Z,IT,Italy,EURO,3951,147577,570,18851
10689,2020-04-12T00:00:00Z,IT,Italy,EURO,4694,152271,619,19470
10690,2020-04-13T00:00:00Z,IT,Italy,EURO,4092,156363,431,19901
10691,2020-04-14T00:00:00Z,IT,Italy,EURO,3153,159516,564,20465
10692,2020-04-15T00:00:00Z,IT,Italy,EURO,2972,162488,604,21069
10693,2020-04-16T00:00:00Z,IT,Italy,EURO,2667,165155,578,21647
10694,2020-04-17T00:00:00Z,IT,Italy,EURO,3786,168941,525,22172
10695,2020-04-18T00:00:00Z,IT,Italy,EURO,3493,172434,575,22747
10696,2020-04-19T00:00:00Z,IT,Italy,EURO,3491,175925,480,23227
10697,2020-04-20T00:00:00Z,IT,Italy,EURO,3047,178972,433,23660
10698,2020-04-21T00:00:00Z,IT,Italy,EURO,2256,181228,454,24114
10699,2020-04-22T00:00:00Z,IT,Italy,EURO,2729,183957,534,24648
10700,2020-04-23T00:00:00Z,IT,Italy,EURO,3370,187327,437,25085
10701,2020-04-24T00:00:00Z,IT,Italy,EURO,2646,189973,464,25549
10702,2020-04-25T00:00:00Z,IT,Italy,EURO,3021,192994,420,25969
10703,2020-04-26T00:00:00Z,IT,Italy,EURO,2357,195351,415,26384
10704,2020-04-27T00:00:00Z,IT,Italy,EURO,2324,197675,260,26644
10705,2020-04-28T00:00:00Z,IT,Italy,EURO,1739,199414,333,26977
10706,2020-04-29T00:00:00Z,IT,Italy,EURO,2091,201505,382,27359
10707,2020-04-30T00:00:00Z,IT,Italy,EURO,2086,203591,323,27682
10708,2020-05-01T00:00:00Z,IT,Italy,EURO,1872,205463,285,27967
10709,2020-05-02T00:00:00Z,IT,Italy,EURO,1965,207428,269,28236
10710,2020-05-03T00:00:00Z,IT,Italy,EURO,1900,209328,474,28710
10711,2020-05-04T00:00:00Z,IT,Italy,EURO,1389,210717,174,28884
10712,2020-05-05T00:00:00Z,IT,Italy,EURO,1221,211938,195,29079
10713,2020-05-06T00:00:00Z,IT,Italy,EURO,1075,213013,236,29315
10714,2020-05-07T00:00:00Z,IT,Italy,EURO,1444,214457,369,29684
10715,2020-05-08T00:00:00Z,IT,Italy,EURO,1401,215858,274,29958
10716,2020-05-09T00:00:00Z,IT,Italy,EURO,1327,217185,243,30201
10717,2020-05-10T00:00:00Z,IT,Italy,EURO,1083,218268,194,30395
10718,2020-05-11T00:00:00Z,IT,Italy,EURO,802,219070,165,30560
10719,2020-05-12T00:00:00Z,IT,Italy,EURO,744,219814,179,30739
10720,2020-05-13T00:00:00Z,IT,Italy,EURO,1402,221216,172,30911
10721,2020-05-14T00:00:00Z,IT,Italy,EURO,888,222104,195,31106
10722,2020-05-15T00:00:00Z,IT,Italy,EURO,992,223096,262,31368
10723,2020-05-16T00:00:00Z,IT,Italy,EURO,789,223885,242,31610
10724,2020-05-17T00:00:00Z,IT,Italy,EURO,875,224760,153,31763
10725,2020-05-18T00:00:00Z,IT,Italy,EURO,675,225435,145,31908
10726,2020-05-19T00:00:00Z,IT,Italy,EURO,451,225886,99,32007
10727,2020-05-20T00:00:00Z,IT,Italy,EURO,813,226699,162,32169
10728,2020-05-21T00:00:00Z,IT,Italy,EURO,665,227364,161,32330
10729,2020-05-22T00:00:00Z,IT,Italy,EURO,642,228006,156,32486
10730,2020-05-23T00:00:00Z,IT,Italy,EURO,652,228658,130,32616
10731,2020-05-24T00:00:00Z,IT,Italy,EURO,669,229327,119,32735
10732,2020-05-25T00:00:00Z,IT,Italy,EURO,531,229858,50,32785
10733,2020-05-26T00:00:00Z,IT,Italy,EURO,300,230158,92,32877
10734,2020-05-27T00:00:00Z,IT,Italy,EURO,397,230555,78,32955
10735,2020-05-28T00:00:00Z,IT,Italy,EURO,584,231139,117,33072
10736,2020-05-29T00:00:00Z,IT,Italy,EURO,593,231732,70,33142
10737,2020-05-30T00:00:00Z,IT,Italy,EURO,516,232248,87,33229
10738,2020-05-31T00:00:00Z,IT,Italy,EURO,416,232664,111,33340
10739,2020-06-01T00:00:00Z,IT,Italy,EURO,355,233019,75,33415
10740,2020-06-02T00:00:00Z,IT,Italy,EURO,178,233197,60,33475
10741,2020-06-03T00:00:00Z,IT,Italy,EURO,318,233515,55,33530
10742,2020-06-04T00:00:00Z,IT,Italy,EURO,321,233836,71,33601
10743,2020-06-05T00:00:00Z,IT,Italy,EURO,177,234013,88,33689
10744,2020-06-06T00:00:00Z,IT,Italy,EURO,518,234531,85,33774
10745,2020-06-07T00:00:00Z,IT,Italy,EURO,270,234801,72,33846
10746,2020-06-08T00:00:00Z,IT,Italy,EURO,197,234998,53,33899
10747,2020-06-09T00:00:00Z,IT,Italy,EURO,280,235278,65,33964
10748,2020-06-10T00:00:00Z,IT,Italy,EURO,283,235561,79,34043
10749,2020-06-11T00:00:00Z,IT,Italy,EURO,202,235763,71,34114
10750,2020-06-12T00:00:00Z,IT,Italy,EURO,379,236142,53,34167
10751,2020-06-13T00:00:00Z,IT,Italy,EURO,163,236305,56,34223
10752,2020-06-14T00:00:00Z,IT,Italy,EURO,346,236651,78,34301
10753,2020-06-15T00:00:00Z,IT,Italy,EURO,338,236989,44,34345
10754,2020-06-16T00:00:00Z,IT,Italy,EURO,301,237290,26,34371
10755,2020-06-17T00:00:00Z,IT,Italy,EURO,210,237500,34,34405
10756,2020-06-18T00:00:00Z,IT,Italy,EURO,328,237828,43,34448
10757,2020-06-19T00:00:00Z,IT,Italy,EURO,183,238011,66,34514
10758,2020-06-20T00:00:00Z,IT,Italy,EURO,0,238011,47,34561
11021,2020-03-12T00:00:00Z,JE,Jersey,EURO,2,2,0,0
11022,2020-03-13T00:00:00Z,JE,Jersey,EURO,0,2,0,0
11023,2020-03-14T00:00:00Z,JE,Jersey,EURO,0,2,0,0
11024,2020-03-15T00:00:00Z,JE,Jersey,EURO,0,2,0,0
11025,2020-03-16T00:00:00Z,JE,Jersey,EURO,0,2,0,0
11026,2020-03-17T00:00:00Z,JE,Jersey,EURO,3,5,0,0
11027,2020-03-18T00:00:00Z,JE,Jersey,EURO,0,5,0,0
11028,2020-03-19T00:00:00Z,JE,Jersey,EURO,0,5,0,0
11029,2020-03-20T00:00:00Z,JE,Jersey,EURO,7,12,0,0
11030,2020-03-21T00:00:00Z,JE,Jersey,EURO,0,12,0,0
11031,2020-03-22T00:00:00Z,JE,Jersey,EURO,0,12,0,0
11032,2020-03-23T00:00:00Z,JE,Jersey,EURO,3,15,0,0
11033,2020-03-24T00:00:00Z,JE,Jersey,EURO,1,16,0,0
11034,2020-03-25T00:00:00Z,JE,Jersey,EURO,0,16,0,0
11035,2020-03-26T00:00:00Z,JE,Jersey,EURO,2,18,0,0
11036,2020-03-27T00:00:00Z,JE,Jersey,EURO,14,32,1,1
11037,2020-03-28T00:00:00Z,JE,Jersey,EURO,20,52,0,1
11038,2020-03-29T00:00:00Z,JE,Jersey,EURO,9,61,0,1
11039,2020-03-30T00:00:00Z,JE,Jersey,EURO,2,63,1,2
11040,2020-03-31T00:00:00Z,JE,Jersey,EURO,0,63,0,2
11041,2020-04-01T00:00:00Z,JE,Jersey,EURO,0,63,0,2
11042,2020-04-02T00:00:00Z,JE,Jersey,EURO,18,81,0,2
11043,2020-04-03T00:00:00Z,JE,Jersey,EURO,0,81,0,2
11044,2020-04-04T00:00:00Z,JE,Jersey,EURO,37,118,0,2
11045,2020-04-05T00:00:00Z,JE,Jersey,EURO,5,123,1,3
11046,2020-04-06T00:00:00Z,JE,Jersey,EURO,32,155,0,3
11047,2020-04-07T00:00:00Z,JE,Jersey,EURO,0,155,0,3
11048,2020-04-08T00:00:00Z,JE,Jersey,EURO,15,170,0,3
11049,2020-04-09T00:00:00Z,JE,Jersey,EURO,0,170,0,3
11050,2020-04-10T00:00:00Z,JE,Jersey,EURO,0,170,0,3
11051,2020-04-11T00:00:00Z,JE,Jersey,EURO,13,183,1,4
11052,2020-04-12T00:00:00Z,JE,Jersey,EURO,15,198,0,4
11053,2020-04-13T00:00:00Z,JE,Jersey,EURO,0,198,0,4
11054,2020-04-14T00:00:00Z,JE,Jersey,EURO,15,213,0,4
11055,2020-04-15T00:00:00Z,JE,Jersey,EURO,4,217,0,4
11056,2020-04-16T00:00:00Z,JE,Jersey,EURO,0,217,2,6
11057,2020-04-17T00:00:00Z,JE,Jersey,EURO,2,219,1,7
11058,2020-04-18T00:00:00Z,JE,Jersey,EURO,4,223,3,10
11059,2020-04-19T00:00:00Z,JE,Jersey,EURO,11,234,1,11
11060,2020-04-20T00:00:00Z,JE,Jersey,EURO,11,245,1,12
11061,2020-04-21T00:00:00Z,JE,Jersey,EURO,4,249,0,12
11062,2020-04-22T00:00:00Z,JE,Jersey,EURO,1,250,2,14
11063,2020-04-23T00:00:00Z,JE,Jersey,EURO,5,255,0,14
11064,2020-04-24T00:00:00Z,JE,Jersey,EURO,0,255,4,18
11065,2020-04-25T00:00:00Z,JE,Jersey,EURO,21,276,1,19
11066,2020-04-26T00:00:00Z,JE,Jersey,EURO,2,278,0,19
11067,2020-04-27T00:00:00Z,JE,Jersey,EURO,2,280,0,19
11068,2020-04-28T00:00:00Z,JE,Jersey,EURO,1,281,0,19
11069,2020-04-29T00:00:00Z,JE,Jersey,EURO,2,283,0,19
11070,2020-04-30T00:00:00Z,JE,Jersey,EURO,1,284,1,20
11071,2020-05-01T00:00:00Z,JE,Jersey,EURO,6,290,0,20
11072,2020-05-02T00:00:00Z,JE,Jersey,EURO,0,290,2,22
11073,2020-05-03T00:00:00Z,JE,Jersey,EURO,0,290,1,23
11074,2020-05-04T00:00:00Z,JE,Jersey,EURO,1,291,1,24
11075,2020-05-05T00:00:00Z,JE,Jersey,EURO,1,292,0,24
11076,2020-05-06T00:00:00Z,JE,Jersey,EURO,1,293,0,24
11077,2020-05-07T00:00:00Z,JE,Jersey,EURO,0,293,0,24
11078,2020-05-08T00:00:00Z,JE,Jersey,EURO,0,293,1,25
11079,2020-05-09T00:00:00Z,JE,Jersey,EURO,0,293,0,25
11080,2020-05-10T00:00:00Z,JE,Jersey,EURO,0,293,0,25
11081,2020-05-11T00:00:00Z,JE,Jersey,EURO,0,293,0,25
11082,2020-05-12T00:00:00Z,JE,Jersey,EURO,1,294,0,25
11083,2020-05-13T00:00:00Z,JE,Jersey,EURO,0,294,0,25
11084,2020-05-14T00:00:00Z,JE,Jersey,EURO,1,295,1,26
11085,2020-05-15T00:00:00Z,JE,Jersey,EURO,0,295,0,26
11086,2020-05-16T00:00:00Z,JE,Jersey,EURO,2,297,1,27
11087,2020-05-17T00:00:00Z,JE,Jersey,EURO,0,297,0,27
11088,2020-05-18T00:00:00Z,JE,Jersey,EURO,0,297,0,27
11089,2020-05-19T00:00:00Z,JE,Jersey,EURO,5,302,0,27
11090,2020-05-20T00:00:00Z,JE,Jersey,EURO,1,303,0,27
11091,2020-05-21T00:00:00Z,JE,Jersey,EURO,0,303,1,28
11092,2020-05-22T00:00:00Z,JE,Jersey,EURO,3,306,1,29
11093,2020-05-23T00:00:00Z,JE,Jersey,EURO,0,306,0,29
11094,2020-05-24T00:00:00Z,JE,Jersey,EURO,0,306,0,29
11095,2020-05-25T00:00:00Z,JE,Jersey,EURO,0,306,0,29
11096,2020-05-26T00:00:00Z,JE,Jersey,EURO,0,306,0,29
11097,2020-05-27T00:00:00Z,JE,Jersey,EURO,1,307,0,29
11098,2020-05-28T00:00:00Z,JE,Jersey,EURO,0,307,0,29
11099,2020-05-29T00:00:00Z,JE,Jersey,EURO,1,308,0,29
11100,2020-05-30T00:00:00Z,JE,Jersey,EURO,0,308,0,29
11101,2020-05-31T00:00:00Z,JE,Jersey,EURO,0,308,0,29
11102,2020-06-01T00:00:00Z,JE,Jersey,EURO,0,308,0,29
11103,2020-06-02T00:00:00Z,JE,Jersey,EURO,0,308,0,29
11104,2020-06-03T00:00:00Z,JE,Jersey,EURO,0,308,0,29
11105,2020-06-04T00:00:00Z,JE,Jersey,EURO,0,308,1,30
11106,2020-06-05T00:00:00Z,JE,Jersey,EURO,1,309,0,30
11107,2020-06-06T00:00:00Z,JE,Jersey,EURO,0,309,0,30
11108,2020-06-07T00:00:00Z,JE,Jersey,EURO,0,309,0,30
11109,2020-06-08T00:00:00Z,JE,Jersey,EURO,2,311,0,30
11110,2020-06-09T00:00:00Z,JE,Jersey,EURO,0,311,0,30
11111,2020-06-10T00:00:00Z,JE,Jersey,EURO,2,313,0,30
11112,2020-06-11T00:00:00Z,JE,Jersey,EURO,0,313,0,30
11113,2020-06-12T00:00:00Z,JE,Jersey,EURO,0,313,0,30
11114,2020-06-13T00:00:00Z,JE,Jersey,EURO,0,313,0,30
11115,2020-06-14T00:00:00Z,JE,Jersey,EURO,0,313,0,30
11116,2020-06-15T00:00:00Z,JE,Jersey,EURO,0,313,0,30
11117,2020-06-16T00:00:00Z,JE,Jersey,EURO,0,313,0,30
11118,2020-06-17T00:00:00Z,JE,Jersey,EURO,3,316,0,30
11119,2020-06-18T00:00:00Z,JE,Jersey,EURO,0,316,0,30
11120,2020-06-19T00:00:00Z,JE,Jersey,EURO,2,318,0,30
11121,2020-06-20T00:00:00Z,JE,Jersey,EURO,0,318,0,30
11233,2020-03-14T00:00:00Z,KZ,Kazakhstan,EURO,6,6,0,0
11234,2020-03-15T00:00:00Z,KZ,Kazakhstan,EURO,0,6,0,0
11235,2020-03-16T00:00:00Z,KZ,Kazakhstan,EURO,0,6,0,0
11236,2020-03-17T00:00:00Z,KZ,Kazakhstan,EURO,27,33,0,0
11237,2020-03-18T00:00:00Z,KZ,Kazakhstan,EURO,3,36,0,0
11238,2020-03-19T00:00:00Z,KZ,Kazakhstan,EURO,10,46,0,0
11239,2020-03-20T00:00:00Z,KZ,Kazakhstan,EURO,7,53,0,0
11240,2020-03-21T00:00:00Z,KZ,Kazakhstan,EURO,3,56,0,0
11241,2020-03-22T00:00:00Z,KZ,Kazakhstan,EURO,0,56,0,0
11242,2020-03-23T00:00:00Z,KZ,Kazakhstan,EURO,4,60,0,0
11243,2020-03-24T00:00:00Z,KZ,Kazakhstan,EURO,3,63,0,0
11244,2020-03-25T00:00:00Z,KZ,Kazakhstan,EURO,16,79,0,0
11245,2020-03-26T00:00:00Z,KZ,Kazakhstan,EURO,18,97,0,0
11246,2020-03-27T00:00:00Z,KZ,Kazakhstan,EURO,28,125,0,0
11247,2020-03-28T00:00:00Z,KZ,Kazakhstan,EURO,79,204,1,1
11248,2020-03-29T00:00:00Z,KZ,Kazakhstan,EURO,61,265,0,1
11249,2020-03-30T00:00:00Z,KZ,Kazakhstan,EURO,29,294,0,1
11250,2020-03-31T00:00:00Z,KZ,Kazakhstan,EURO,18,312,0,1
11251,2020-04-01T00:00:00Z,KZ,Kazakhstan,EURO,36,348,1,2
11252,2020-04-02T00:00:00Z,KZ,Kazakhstan,EURO,38,386,1,3
11253,2020-04-03T00:00:00Z,KZ,Kazakhstan,EURO,49,435,0,3
11254,2020-04-04T00:00:00Z,KZ,Kazakhstan,EURO,25,460,0,3
11255,2020-04-05T00:00:00Z,KZ,Kazakhstan,EURO,71,531,2,5
11256,2020-04-06T00:00:00Z,KZ,Kazakhstan,EURO,73,604,0,5
11257,2020-04-07T00:00:00Z,KZ,Kazakhstan,EURO,66,670,1,6
11258,2020-04-08T00:00:00Z,KZ,Kazakhstan,EURO,39,709,0,6
11259,2020-04-09T00:00:00Z,KZ,Kazakhstan,EURO,18,727,1,7
11260,2020-04-10T00:00:00Z,KZ,Kazakhstan,EURO,75,802,2,9
11261,2020-04-11T00:00:00Z,KZ,Kazakhstan,EURO,57,859,1,10
11262,2020-04-12T00:00:00Z,KZ,Kazakhstan,EURO,38,897,0,10
11263,2020-04-13T00:00:00Z,KZ,Kazakhstan,EURO,82,979,2,12
11264,2020-04-14T00:00:00Z,KZ,Kazakhstan,EURO,112,1091,0,12
11265,2020-04-15T00:00:00Z,KZ,Kazakhstan,EURO,184,1275,0,12
11266,2020-04-16T00:00:00Z,KZ,Kazakhstan,EURO,20,1295,4,16
11267,2020-04-17T00:00:00Z,KZ,Kazakhstan,EURO,185,1480,0,16
11268,2020-04-18T00:00:00Z,KZ,Kazakhstan,EURO,66,1546,1,17
11269,2020-04-19T00:00:00Z,KZ,Kazakhstan,EURO,0,1546,0,17
11270,2020-04-20T00:00:00Z,KZ,Kazakhstan,EURO,0,1546,0,17
11271,2020-04-21T00:00:00Z,KZ,Kazakhstan,EURO,306,1852,2,19
11272,2020-04-22T00:00:00Z,KZ,Kazakhstan,EURO,143,1995,0,19
11273,2020-04-23T00:00:00Z,KZ,Kazakhstan,EURO,30,2025,0,19
11274,2020-04-24T00:00:00Z,KZ,Kazakhstan,EURO,0,2025,0,19
11275,2020-04-25T00:00:00Z,KZ,Kazakhstan,EURO,391,2416,6,25
11276,2020-04-26T00:00:00Z,KZ,Kazakhstan,EURO,185,2601,0,25
11277,2020-04-27T00:00:00Z,KZ,Kazakhstan,EURO,190,2791,0,25
11278,2020-04-28T00:00:00Z,KZ,Kazakhstan,EURO,191,2982,0,25
11279,2020-04-29T00:00:00Z,KZ,Kazakhstan,EURO,96,3078,0,25
11280,2020-04-30T00:00:00Z,KZ,Kazakhstan,EURO,255,3333,0,25
11281,2020-05-01T00:00:00Z,KZ,Kazakhstan,EURO,218,3551,0,25
11282,2020-05-02T00:00:00Z,KZ,Kazakhstan,EURO,234,3785,0,25
11283,2020-05-03T00:00:00Z,KZ,Kazakhstan,EURO,92,3877,1,26
11284,2020-05-04T00:00:00Z,KZ,Kazakhstan,EURO,111,3988,1,27
11285,2020-05-05T00:00:00Z,KZ,Kazakhstan,EURO,172,4160,2,29
11286,2020-05-06T00:00:00Z,KZ,Kazakhstan,EURO,138,4298,0,29
11287,2020-05-07T00:00:00Z,KZ,Kazakhstan,EURO,211,4509,1,30
11288,2020-05-08T00:00:00Z,KZ,Kazakhstan,EURO,69,4578,0,30
11289,2020-05-09T00:00:00Z,KZ,Kazakhstan,EURO,344,4922,1,31
11290,2020-05-10T00:00:00Z,KZ,Kazakhstan,EURO,134,5056,0,31
11291,2020-05-11T00:00:00Z,KZ,Kazakhstan,EURO,82,5138,0,31
11292,2020-05-12T00:00:00Z,KZ,Kazakhstan,EURO,69,5207,1,32
11293,2020-05-13T00:00:00Z,KZ,Kazakhstan,EURO,210,5417,0,32
11294,2020-05-14T00:00:00Z,KZ,Kazakhstan,EURO,154,5571,1,33
11295,2020-05-15T00:00:00Z,KZ,Kazakhstan,EURO,118,5689,1,34
11296,2020-05-16T00:00:00Z,KZ,Kazakhstan,EURO,161,5850,0,34
11297,2020-05-17T00:00:00Z,KZ,Kazakhstan,EURO,307,6157,0,34
11298,2020-05-18T00:00:00Z,KZ,Kazakhstan,EURO,283,6440,0,34
11299,2020-05-19T00:00:00Z,KZ,Kazakhstan,EURO,311,6751,1,35
11300,2020-05-20T00:00:00Z,KZ,Kazakhstan,EURO,218,6969,0,35
11301,2020-05-21T00:00:00Z,KZ,Kazakhstan,EURO,265,7234,0,35
11302,2020-05-22T00:00:00Z,KZ,Kazakhstan,EURO,363,7597,0,35
11303,2020-05-23T00:00:00Z,KZ,Kazakhstan,EURO,322,7919,0,35
11304,2020-05-24T00:00:00Z,KZ,Kazakhstan,EURO,403,8322,0,35
11305,2020-05-25T00:00:00Z,KZ,Kazakhstan,EURO,209,8531,0,35
11306,2020-05-26T00:00:00Z,KZ,Kazakhstan,EURO,438,8969,0,35
11307,2020-05-27T00:00:00Z,KZ,Kazakhstan,EURO,335,9304,2,37
11308,2020-05-28T00:00:00Z,KZ,Kazakhstan,EURO,272,9576,0,37
11309,2020-05-29T00:00:00Z,KZ,Kazakhstan,EURO,356,9932,0,37
11310,2020-05-30T00:00:00Z,KZ,Kazakhstan,EURO,450,10382,0,37
11311,2020-05-31T00:00:00Z,KZ,Kazakhstan,EURO,476,10858,1,38
11312,2020-06-01T00:00:00Z,KZ,Kazakhstan,EURO,450,11308,3,41
11313,2020-06-02T00:00:00Z,KZ,Kazakhstan,EURO,263,11571,0,41
11314,2020-06-03T00:00:00Z,KZ,Kazakhstan,EURO,225,11796,3,44
11315,2020-06-04T00:00:00Z,KZ,Kazakhstan,EURO,271,12067,4,48
11316,2020-06-05T00:00:00Z,KZ,Kazakhstan,EURO,245,12312,0,48
11317,2020-06-06T00:00:00Z,KZ,Kazakhstan,EURO,199,12511,4,52
11318,2020-06-07T00:00:00Z,KZ,Kazakhstan,EURO,183,12694,2,54
11319,2020-06-08T00:00:00Z,KZ,Kazakhstan,EURO,165,12859,2,56
11320,2020-06-09T00:00:00Z,KZ,Kazakhstan,EURO,215,13074,2,58
11321,2020-06-10T00:00:00Z,KZ,Kazakhstan,EURO,245,13319,3,61
11322,2020-06-11T00:00:00Z,KZ,Kazakhstan,EURO,240,13559,6,67
11323,2020-06-12T00:00:00Z,KZ,Kazakhstan,EURO,313,13872,0,67
11324,2020-06-13T00:00:00Z,KZ,Kazakhstan,EURO,366,14238,3,70
11325,2020-06-14T00:00:00Z,KZ,Kazakhstan,EURO,258,14496,3,73
11326,2020-06-15T00:00:00Z,KZ,Kazakhstan,EURO,313,14809,4,77
11327,2020-06-16T00:00:00Z,KZ,Kazakhstan,EURO,383,15192,4,81
11328,2020-06-17T00:00:00Z,KZ,Kazakhstan,EURO,350,15542,7,88
11329,2020-06-18T00:00:00Z,KZ,Kazakhstan,EURO,335,15877,12,100
11330,2020-06-19T00:00:00Z,KZ,Kazakhstan,EURO,474,16351,5,105
11331,2020-06-20T00:00:00Z,KZ,Kazakhstan,EURO,428,16779,8,113
11431,2020-03-13T00:00:00Z,XK,Kosovo[1],EURO,2,2,0,0
11432,2020-03-14T00:00:00Z,XK,Kosovo[1],EURO,3,5,0,0
11433,2020-03-15T00:00:00Z,XK,Kosovo[1],EURO,0,5,0,0
11434,2020-03-16T00:00:00Z,XK,Kosovo[1],EURO,0,5,0,0
11435,2020-03-17T00:00:00Z,XK,Kosovo[1],EURO,8,13,0,0
11436,2020-03-18T00:00:00Z,XK,Kosovo[1],EURO,0,13,0,0
11437,2020-03-19T00:00:00Z,XK,Kosovo[1],EURO,8,21,0,0
11438,2020-03-20T00:00:00Z,XK,Kosovo[1],EURO,3,24,0,0
11439,2020-03-21T00:00:00Z,XK,Kosovo[1],EURO,0,24,0,0
11440,2020-03-22T00:00:00Z,XK,Kosovo[1],EURO,0,24,0,0
11441,2020-03-23T00:00:00Z,XK,Kosovo[1],EURO,11,35,1,1
11442,2020-03-24T00:00:00Z,XK,Kosovo[1],EURO,28,63,0,1
11443,2020-03-25T00:00:00Z,XK,Kosovo[1],EURO,8,71,0,1
11444,2020-03-26T00:00:00Z,XK,Kosovo[1],EURO,8,79,0,1
11445,2020-03-27T00:00:00Z,XK,Kosovo[1],EURO,9,88,0,1
11446,2020-03-28T00:00:00Z,XK,Kosovo[1],EURO,3,91,0,1
11447,2020-03-29T00:00:00Z,XK,Kosovo[1],EURO,0,91,0,1
11448,2020-03-30T00:00:00Z,XK,Kosovo[1],EURO,15,106,0,1
11449,2020-03-31T00:00:00Z,XK,Kosovo[1],EURO,6,112,0,1
11450,2020-04-01T00:00:00Z,XK,Kosovo[1],EURO,13,125,0,1
11451,2020-04-02T00:00:00Z,XK,Kosovo[1],EURO,0,125,0,1
11452,2020-04-03T00:00:00Z,XK,Kosovo[1],EURO,1,126,0,1
11453,2020-04-04T00:00:00Z,XK,Kosovo[1],EURO,6,132,0,1
11454,2020-04-05T00:00:00Z,XK,Kosovo[1],EURO,8,140,0,1
11455,2020-04-06T00:00:00Z,XK,Kosovo[1],EURO,5,145,0,1
11456,2020-04-07T00:00:00Z,XK,Kosovo[1],EURO,20,165,2,3
11457,2020-04-08T00:00:00Z,XK,Kosovo[1],EURO,19,184,3,6
11458,2020-04-09T00:00:00Z,XK,Kosovo[1],EURO,40,224,1,7
11459,2020-04-10T00:00:00Z,XK,Kosovo[1],EURO,3,227,0,7
11460,2020-04-11T00:00:00Z,XK,Kosovo[1],EURO,23,250,0,7
11461,2020-04-12T00:00:00Z,XK,Kosovo[1],EURO,33,283,0,7
11462,2020-04-13T00:00:00Z,XK,Kosovo[1],EURO,79,362,1,8
11463,2020-04-14T00:00:00Z,XK,Kosovo[1],EURO,15,377,1,9
11464,2020-04-15T00:00:00Z,XK,Kosovo[1],EURO,10,387,1,10
11465,2020-04-16T00:00:00Z,XK,Kosovo[1],EURO,10,397,2,12
11466,2020-04-17T00:00:00Z,XK,Kosovo[1],EURO,52,449,1,13
11467,2020-04-18T00:00:00Z,XK,Kosovo[1],EURO,31,480,0,13
11468,2020-04-19T00:00:00Z,XK,Kosovo[1],EURO,30,510,0,13
11469,2020-04-20T00:00:00Z,XK,Kosovo[1],EURO,25,535,0,13
11470,2020-04-21T00:00:00Z,XK,Kosovo[1],EURO,37,572,1,14
11471,2020-04-22T00:00:00Z,XK,Kosovo[1],EURO,32,604,0,14
11472,2020-04-23T00:00:00Z,XK,Kosovo[1],EURO,26,630,1,15
11473,2020-04-24T00:00:00Z,XK,Kosovo[1],EURO,39,669,0,15
11474,2020-04-25T00:00:00Z,XK,Kosovo[1],EURO,34,703,1,16
11475,2020-04-26T00:00:00Z,XK,Kosovo[1],EURO,28,731,0,16
11476,2020-04-27T00:00:00Z,XK,Kosovo[1],EURO,32,763,1,17
11477,2020-04-28T00:00:00Z,XK,Kosovo[1],EURO,17,780,0,17
11478,2020-04-29T00:00:00Z,XK,Kosovo[1],EURO,10,790,0,17
11479,2020-04-30T00:00:00Z,XK,Kosovo[1],EURO,9,799,0,17
11480,2020-05-01T00:00:00Z,XK,Kosovo[1],EURO,0,799,0,17
11481,2020-05-02T00:00:00Z,XK,Kosovo[1],EURO,14,813,0,17
11482,2020-05-03T00:00:00Z,XK,Kosovo[1],EURO,10,823,0,17
11483,2020-05-04T00:00:00Z,XK,Kosovo[1],EURO,28,851,0,17
11484,2020-05-05T00:00:00Z,XK,Kosovo[1],EURO,4,855,0,17
11485,2020-05-06T00:00:00Z,XK,Kosovo[1],EURO,1,856,0,17
11486,2020-05-07T00:00:00Z,XK,Kosovo[1],EURO,4,860,1,18
11487,2020-05-08T00:00:00Z,XK,Kosovo[1],EURO,1,861,1,19
11488,2020-05-09T00:00:00Z,XK,Kosovo[1],EURO,1,862,0,19
11489,2020-05-10T00:00:00Z,XK,Kosovo[1],EURO,8,870,0,19
11490,2020-05-11T00:00:00Z,XK,Kosovo[1],EURO,0,870,0,19
11491,2020-05-12T00:00:00Z,XK,Kosovo[1],EURO,14,884,1,20
11492,2020-05-13T00:00:00Z,XK,Kosovo[1],EURO,35,919,0,20
11493,2020-05-14T00:00:00Z,XK,Kosovo[1],EURO,0,919,0,20
11494,2020-05-15T00:00:00Z,XK,Kosovo[1],EURO,25,944,0,20
11495,2020-05-16T00:00:00Z,XK,Kosovo[1],EURO,0,944,0,20
11496,2020-05-17T00:00:00Z,XK,Kosovo[1],EURO,0,944,0,20
11497,2020-05-18T00:00:00Z,XK,Kosovo[1],EURO,11,955,0,20
11498,2020-05-19T00:00:00Z,XK,Kosovo[1],EURO,0,955,0,20
11499,2020-05-20T00:00:00Z,XK,Kosovo[1],EURO,34,989,0,20
11500,2020-05-21T00:00:00Z,XK,Kosovo[1],EURO,0,989,0,20
11501,2020-05-22T00:00:00Z,XK,Kosovo[1],EURO,14,1003,0,20
11502,2020-05-23T00:00:00Z,XK,Kosovo[1],EURO,1,1004,0,20
11503,2020-05-24T00:00:00Z,XK,Kosovo[1],EURO,21,1025,0,20
11504,2020-05-25T00:00:00Z,XK,Kosovo[1],EURO,7,1032,1,21
11505,2020-05-26T00:00:00Z,XK,Kosovo[1],EURO,6,1038,0,21
11506,2020-05-27T00:00:00Z,XK,Kosovo[1],EURO,0,1038,0,21
11507,2020-05-28T00:00:00Z,XK,Kosovo[1],EURO,9,1047,0,21
11508,2020-05-29T00:00:00Z,XK,Kosovo[1],EURO,1,1048,0,21
11509,2020-05-30T00:00:00Z,XK,Kosovo[1],EURO,0,1048,0,21
11510,2020-05-31T00:00:00Z,XK,Kosovo[1],EURO,16,1064,0,21
11511,2020-06-01T00:00:00Z,XK,Kosovo[1],EURO,0,1064,0,21
11512,2020-06-02T00:00:00Z,XK,Kosovo[1],EURO,3,1067,0,21
11513,2020-06-03T00:00:00Z,XK,Kosovo[1],EURO,13,1080,0,21
11514,2020-06-04T00:00:00Z,XK,Kosovo[1],EURO,62,1142,0,21
11515,2020-06-05T00:00:00Z,XK,Kosovo[1],EURO,0,1142,0,21
11516,2020-06-06T00:00:00Z,XK,Kosovo[1],EURO,0,1142,0,21
11517,2020-06-07T00:00:00Z,XK,Kosovo[1],EURO,9,1151,0,21
11518,2020-06-08T00:00:00Z,XK,Kosovo[1],EURO,40,1191,0,21
11519,2020-06-09T00:00:00Z,XK,Kosovo[1],EURO,72,1263,0,21
11520,2020-06-10T00:00:00Z,XK,Kosovo[1],EURO,0,1263,0,21
11521,2020-06-11T00:00:00Z,XK,Kosovo[1],EURO,35,1298,0,21
11522,2020-06-12T00:00:00Z,XK,Kosovo[1],EURO,28,1326,0,21
11523,2020-06-13T00:00:00Z,XK,Kosovo[1],EURO,0,1326,1,22
11524,2020-06-14T00:00:00Z,XK,Kosovo[1],EURO,111,1437,1,23
11525,2020-06-15T00:00:00Z,XK,Kosovo[1],EURO,6,1443,0,23
11526,2020-06-16T00:00:00Z,XK,Kosovo[1],EURO,129,1572,0,23
11527,2020-06-17T00:00:00Z,XK,Kosovo[1],EURO,141,1713,1,24
11528,2020-06-18T00:00:00Z,XK,Kosovo[1],EURO,77,1790,0,24
11529,2020-06-19T00:00:00Z,XK,Kosovo[1],EURO,83,1873,0,24
11530,2020-06-20T00:00:00Z,XK,Kosovo[1],EURO,82,1955,0,24
11649,2020-03-18T00:00:00Z,KG,Kyrgyzstan,EURO,3,3,0,0
11650,2020-03-19T00:00:00Z,KG,Kyrgyzstan,EURO,0,3,0,0
11651,2020-03-20T00:00:00Z,KG,Kyrgyzstan,EURO,3,6,0,0
11652,2020-03-21T00:00:00Z,KG,Kyrgyzstan,EURO,8,14,0,0
11653,2020-03-22T00:00:00Z,KG,Kyrgyzstan,EURO,0,14,0,0
11654,2020-03-23T00:00:00Z,KG,Kyrgyzstan,EURO,0,14,0,0
11655,2020-03-24T00:00:00Z,KG,Kyrgyzstan,EURO,2,16,0,0
11656,2020-03-25T00:00:00Z,KG,Kyrgyzstan,EURO,26,42,0,0
11657,2020-03-26T00:00:00Z,KG,Kyrgyzstan,EURO,2,44,0,0
11658,2020-03-27T00:00:00Z,KG,Kyrgyzstan,EURO,14,58,0,0
11659,2020-03-28T00:00:00Z,KG,Kyrgyzstan,EURO,0,58,0,0
11660,2020-03-29T00:00:00Z,KG,Kyrgyzstan,EURO,26,84,0,0
11661,2020-03-30T00:00:00Z,KG,Kyrgyzstan,EURO,0,84,0,0
11662,2020-03-31T00:00:00Z,KG,Kyrgyzstan,EURO,23,107,0,0
11663,2020-04-01T00:00:00Z,KG,Kyrgyzstan,EURO,4,111,0,0
11664,2020-04-02T00:00:00Z,KG,Kyrgyzstan,EURO,4,115,0,0
11665,2020-04-03T00:00:00Z,KG,Kyrgyzstan,EURO,15,130,1,1
11666,2020-04-04T00:00:00Z,KG,Kyrgyzstan,EURO,14,144,0,1
11667,2020-04-05T00:00:00Z,KG,Kyrgyzstan,EURO,3,147,0,1
11668,2020-04-06T00:00:00Z,KG,Kyrgyzstan,EURO,69,216,3,4
11669,2020-04-07T00:00:00Z,KG,Kyrgyzstan,EURO,12,228,0,4
11670,2020-04-08T00:00:00Z,KG,Kyrgyzstan,EURO,42,270,0,4
11671,2020-04-09T00:00:00Z,KG,Kyrgyzstan,EURO,10,280,0,4
11672,2020-04-10T00:00:00Z,KG,Kyrgyzstan,EURO,18,298,1,5
11673,2020-04-11T00:00:00Z,KG,Kyrgyzstan,EURO,41,339,0,5
11674,2020-04-12T00:00:00Z,KG,Kyrgyzstan,EURO,38,377,0,5
11675,2020-04-13T00:00:00Z,KG,Kyrgyzstan,EURO,42,419,0,5
11676,2020-04-14T00:00:00Z,KG,Kyrgyzstan,EURO,11,430,0,5
11677,2020-04-15T00:00:00Z,KG,Kyrgyzstan,EURO,19,449,0,5
11678,2020-04-16T00:00:00Z,KG,Kyrgyzstan,EURO,17,466,0,5
11679,2020-04-17T00:00:00Z,KG,Kyrgyzstan,EURO,23,489,0,5
11680,2020-04-18T00:00:00Z,KG,Kyrgyzstan,EURO,17,506,0,5
11681,2020-04-19T00:00:00Z,KG,Kyrgyzstan,EURO,48,554,0,5
11682,2020-04-20T00:00:00Z,KG,Kyrgyzstan,EURO,14,568,2,7
11683,2020-04-21T00:00:00Z,KG,Kyrgyzstan,EURO,22,590,0,7
11684,2020-04-22T00:00:00Z,KG,Kyrgyzstan,EURO,22,612,0,7
11685,2020-04-23T00:00:00Z,KG,Kyrgyzstan,EURO,19,631,1,8
11686,2020-04-24T00:00:00Z,KG,Kyrgyzstan,EURO,25,656,0,8
11687,2020-04-25T00:00:00Z,KG,Kyrgyzstan,EURO,9,665,0,8
11688,2020-04-26T00:00:00Z,KG,Kyrgyzstan,EURO,17,682,0,8
11689,2020-04-27T00:00:00Z,KG,Kyrgyzstan,EURO,13,695,0,8
11690,2020-04-28T00:00:00Z,KG,Kyrgyzstan,EURO,13,708,0,8
11691,2020-04-29T00:00:00Z,KG,Kyrgyzstan,EURO,21,729,0,8
11692,2020-04-30T00:00:00Z,KG,Kyrgyzstan,EURO,17,746,0,8
11693,2020-05-01T00:00:00Z,KG,Kyrgyzstan,EURO,10,756,0,8
11694,2020-05-02T00:00:00Z,KG,Kyrgyzstan,EURO,13,769,0,8
11695,2020-05-03T00:00:00Z,KG,Kyrgyzstan,EURO,26,795,2,10
11696,2020-05-04T00:00:00Z,KG,Kyrgyzstan,EURO,35,830,0,10
11697,2020-05-05T00:00:00Z,KG,Kyrgyzstan,EURO,13,843,0,10
11698,2020-05-06T00:00:00Z,KG,Kyrgyzstan,EURO,28,871,2,12
11699,2020-05-07T00:00:00Z,KG,Kyrgyzstan,EURO,24,895,0,12
11700,2020-05-08T00:00:00Z,KG,Kyrgyzstan,EURO,11,906,0,12
11701,2020-05-09T00:00:00Z,KG,Kyrgyzstan,EURO,25,931,0,12
11702,2020-05-10T00:00:00Z,KG,Kyrgyzstan,EURO,71,1002,0,12
11703,2020-05-11T00:00:00Z,KG,Kyrgyzstan,EURO,14,1016,0,12
11704,2020-05-12T00:00:00Z,KG,Kyrgyzstan,EURO,21,1037,0,12
11705,2020-05-13T00:00:00Z,KG,Kyrgyzstan,EURO,7,1044,0,12
11706,2020-05-14T00:00:00Z,KG,Kyrgyzstan,EURO,38,1082,0,12
11707,2020-05-15T00:00:00Z,KG,Kyrgyzstan,EURO,29,1111,2,14
11708,2020-05-16T00:00:00Z,KG,Kyrgyzstan,EURO,6,1117,0,14
11709,2020-05-17T00:00:00Z,KG,Kyrgyzstan,EURO,21,1138,0,14
11710,2020-05-18T00:00:00Z,KG,Kyrgyzstan,EURO,78,1216,0,14
11711,2020-05-19T00:00:00Z,KG,Kyrgyzstan,EURO,27,1243,0,14
11712,2020-05-20T00:00:00Z,KG,Kyrgyzstan,EURO,27,1270,0,14
11713,2020-05-21T00:00:00Z,KG,Kyrgyzstan,EURO,43,1313,0,14
11714,2020-05-22T00:00:00Z,KG,Kyrgyzstan,EURO,37,1350,0,14
11715,2020-05-23T00:00:00Z,KG,Kyrgyzstan,EURO,15,1365,0,14
11716,2020-05-24T00:00:00Z,KG,Kyrgyzstan,EURO,38,1403,0,14
11717,2020-05-25T00:00:00Z,KG,Kyrgyzstan,EURO,30,1433,2,16
11718,2020-05-26T00:00:00Z,KG,Kyrgyzstan,EURO,35,1468,0,16
11719,2020-05-27T00:00:00Z,KG,Kyrgyzstan,EURO,52,1520,0,16
11720,2020-05-28T00:00:00Z,KG,Kyrgyzstan,EURO,74,1594,0,16
11721,2020-05-29T00:00:00Z,KG,Kyrgyzstan,EURO,68,1662,0,16
11722,2020-05-30T00:00:00Z,KG,Kyrgyzstan,EURO,60,1722,0,16
11723,2020-05-31T00:00:00Z,KG,Kyrgyzstan,EURO,26,1748,0,16
11724,2020-06-01T00:00:00Z,KG,Kyrgyzstan,EURO,69,1817,0,16
11725,2020-06-02T00:00:00Z,KG,Kyrgyzstan,EURO,28,1845,1,17
11726,2020-06-03T00:00:00Z,KG,Kyrgyzstan,EURO,26,1871,3,20
11727,2020-06-04T00:00:00Z,KG,Kyrgyzstan,EURO,28,1899,0,20
11728,2020-06-05T00:00:00Z,KG,Kyrgyzstan,EURO,37,1936,2,22
11729,2020-06-06T00:00:00Z,KG,Kyrgyzstan,EURO,38,1974,0,22
11730,2020-06-07T00:00:00Z,KG,Kyrgyzstan,EURO,33,2007,0,22
11731,2020-06-08T00:00:00Z,KG,Kyrgyzstan,EURO,25,2032,1,23
11732,2020-06-09T00:00:00Z,KG,Kyrgyzstan,EURO,23,2055,1,24
11733,2020-06-10T00:00:00Z,KG,Kyrgyzstan,EURO,38,2093,2,26
11734,2020-06-11T00:00:00Z,KG,Kyrgyzstan,EURO,36,2129,0,26
11735,2020-06-12T00:00:00Z,KG,Kyrgyzstan,EURO,37,2166,0,26
11736,2020-06-13T00:00:00Z,KG,Kyrgyzstan,EURO,41,2207,1,27
11737,2020-06-14T00:00:00Z,KG,Kyrgyzstan,EURO,78,2285,0,27
11738,2020-06-15T00:00:00Z,KG,Kyrgyzstan,EURO,87,2372,0,27
11739,2020-06-16T00:00:00Z,KG,Kyrgyzstan,EURO,100,2472,2,29
11740,2020-06-17T00:00:00Z,KG,Kyrgyzstan,EURO,90,2562,1,30
11741,2020-06-18T00:00:00Z,KG,Kyrgyzstan,EURO,95,2657,1,31
11742,2020-06-19T00:00:00Z,KG,Kyrgyzstan,EURO,132,2789,1,32
11743,2020-06-20T00:00:00Z,KG,Kyrgyzstan,EURO,192,2981,3,35
11833,2020-03-02T00:00:00Z,LV,Latvia,EURO,1,1,0,0
11834,2020-03-03T00:00:00Z,LV,Latvia,EURO,0,1,0,0
11835,2020-03-04T00:00:00Z,LV,Latvia,EURO,0,1,0,0
11836,2020-03-05T00:00:00Z,LV,Latvia,EURO,0,1,0,0
11837,2020-03-06T00:00:00Z,LV,Latvia,EURO,0,1,0,0
11838,2020-03-07T00:00:00Z,LV,Latvia,EURO,0,1,0,0
11839,2020-03-08T00:00:00Z,LV,Latvia,EURO,2,3,0,0
11840,2020-03-09T00:00:00Z,LV,Latvia,EURO,3,6,0,0
11841,2020-03-10T00:00:00Z,LV,Latvia,EURO,2,8,0,0
11842,2020-03-11T00:00:00Z,LV,Latvia,EURO,2,10,0,0
11843,2020-03-12T00:00:00Z,LV,Latvia,EURO,6,16,0,0
11844,2020-03-13T00:00:00Z,LV,Latvia,EURO,3,19,0,0
11845,2020-03-14T00:00:00Z,LV,Latvia,EURO,0,19,0,0
11846,2020-03-15T00:00:00Z,LV,Latvia,EURO,12,31,0,0
11847,2020-03-16T00:00:00Z,LV,Latvia,EURO,5,36,0,0
11848,2020-03-17T00:00:00Z,LV,Latvia,EURO,24,60,0,0
11849,2020-03-18T00:00:00Z,LV,Latvia,EURO,11,71,0,0
11850,2020-03-19T00:00:00Z,LV,Latvia,EURO,15,86,0,0
11851,2020-03-20T00:00:00Z,LV,Latvia,EURO,25,111,0,0
11852,2020-03-21T00:00:00Z,LV,Latvia,EURO,13,124,0,0
11853,2020-03-22T00:00:00Z,LV,Latvia,EURO,0,124,0,0
11854,2020-03-23T00:00:00Z,LV,Latvia,EURO,-61,63,0,0
11855,2020-03-24T00:00:00Z,LV,Latvia,EURO,117,180,0,0
11856,2020-03-25T00:00:00Z,LV,Latvia,EURO,17,197,0,0
11857,2020-03-26T00:00:00Z,LV,Latvia,EURO,24,221,0,0
11858,2020-03-27T00:00:00Z,LV,Latvia,EURO,23,244,0,0
11859,2020-03-28T00:00:00Z,LV,Latvia,EURO,36,280,0,0
11860,2020-03-29T00:00:00Z,LV,Latvia,EURO,25,305,0,0
11861,2020-03-30T00:00:00Z,LV,Latvia,EURO,71,376,0,0
11862,2020-03-31T00:00:00Z,LV,Latvia,EURO,0,376,0,0
11863,2020-04-01T00:00:00Z,LV,Latvia,EURO,22,398,0,0
11864,2020-04-02T00:00:00Z,LV,Latvia,EURO,48,446,0,0
11865,2020-04-03T00:00:00Z,LV,Latvia,EURO,12,458,0,0
11866,2020-04-04T00:00:00Z,LV,Latvia,EURO,35,493,1,1
11867,2020-04-05T00:00:00Z,LV,Latvia,EURO,16,509,0,1
11868,2020-04-06T00:00:00Z,LV,Latvia,EURO,24,533,0,1
11869,2020-04-07T00:00:00Z,LV,Latvia,EURO,9,542,0,1
11870,2020-04-08T00:00:00Z,LV,Latvia,EURO,6,548,1,2
11871,2020-04-09T00:00:00Z,LV,Latvia,EURO,29,577,0,2
11872,2020-04-10T00:00:00Z,LV,Latvia,EURO,12,589,0,2
11873,2020-04-11T00:00:00Z,LV,Latvia,EURO,23,612,0,2
11874,2020-04-12T00:00:00Z,LV,Latvia,EURO,18,630,1,3
11875,2020-04-13T00:00:00Z,LV,Latvia,EURO,21,651,2,5
11876,2020-04-14T00:00:00Z,LV,Latvia,EURO,4,655,0,5
11877,2020-04-15T00:00:00Z,LV,Latvia,EURO,2,657,0,5
11878,2020-04-16T00:00:00Z,LV,Latvia,EURO,9,666,0,5
11879,2020-04-17T00:00:00Z,LV,Latvia,EURO,9,675,0,5
11880,2020-04-18T00:00:00Z,LV,Latvia,EURO,7,682,0,5
11881,2020-04-19T00:00:00Z,LV,Latvia,EURO,30,712,0,5
11882,2020-04-20T00:00:00Z,LV,Latvia,EURO,15,727,0,5
11883,2020-04-21T00:00:00Z,LV,Latvia,EURO,12,739,0,5
11884,2020-04-22T00:00:00Z,LV,Latvia,EURO,9,748,4,9
11885,2020-04-23T00:00:00Z,LV,Latvia,EURO,13,761,2,11
11886,2020-04-24T00:00:00Z,LV,Latvia,EURO,17,778,0,11
11887,2020-04-25T00:00:00Z,LV,Latvia,EURO,6,784,1,12
11888,2020-04-26T00:00:00Z,LV,Latvia,EURO,20,804,0,12
11889,2020-04-27T00:00:00Z,LV,Latvia,EURO,8,812,0,12
11890,2020-04-28T00:00:00Z,LV,Latvia,EURO,6,818,1,13
11891,2020-04-29T00:00:00Z,LV,Latvia,EURO,18,836,0,13
11892,2020-04-30T00:00:00Z,LV,Latvia,EURO,13,849,2,15
11893,2020-05-01T00:00:00Z,LV,Latvia,EURO,9,858,0,15
11894,2020-05-02T00:00:00Z,LV,Latvia,EURO,12,870,1,16
11895,2020-05-03T00:00:00Z,LV,Latvia,EURO,1,871,0,16
11896,2020-05-04T00:00:00Z,LV,Latvia,EURO,8,879,0,16
11897,2020-05-05T00:00:00Z,LV,Latvia,EURO,17,896,0,16
11898,2020-05-06T00:00:00Z,LV,Latvia,EURO,0,896,1,17
11899,2020-05-07T00:00:00Z,LV,Latvia,EURO,4,900,0,17
11900,2020-05-08T00:00:00Z,LV,Latvia,EURO,9,909,1,18
11901,2020-05-09T00:00:00Z,LV,Latvia,EURO,19,928,0,18
11902,2020-05-10T00:00:00Z,LV,Latvia,EURO,2,930,0,18
11903,2020-05-11T00:00:00Z,LV,Latvia,EURO,9,939,0,18
11904,2020-05-12T00:00:00Z,LV,Latvia,EURO,7,946,0,18
11905,2020-05-13T00:00:00Z,LV,Latvia,EURO,4,950,0,18
11906,2020-05-14T00:00:00Z,LV,Latvia,EURO,1,951,1,19
11907,2020-05-15T00:00:00Z,LV,Latvia,EURO,11,962,0,19
11908,2020-05-16T00:00:00Z,LV,Latvia,EURO,8,970,0,19
11909,2020-05-17T00:00:00Z,LV,Latvia,EURO,27,997,0,19
11910,2020-05-18T00:00:00Z,LV,Latvia,EURO,11,1008,0,19
11911,2020-05-19T00:00:00Z,LV,Latvia,EURO,1,1009,0,19
11912,2020-05-20T00:00:00Z,LV,Latvia,EURO,3,1012,2,21
11913,2020-05-21T00:00:00Z,LV,Latvia,EURO,4,1016,0,21
11914,2020-05-22T00:00:00Z,LV,Latvia,EURO,9,1025,1,22
11915,2020-05-23T00:00:00Z,LV,Latvia,EURO,5,1030,0,22
11916,2020-05-24T00:00:00Z,LV,Latvia,EURO,16,1046,0,22
11917,2020-05-25T00:00:00Z,LV,Latvia,EURO,1,1047,0,22
11918,2020-05-26T00:00:00Z,LV,Latvia,EURO,2,1049,0,22
11919,2020-05-27T00:00:00Z,LV,Latvia,EURO,4,1053,0,22
11920,2020-05-28T00:00:00Z,LV,Latvia,EURO,4,1057,1,23
11921,2020-05-29T00:00:00Z,LV,Latvia,EURO,4,1061,1,24
11922,2020-05-30T00:00:00Z,LV,Latvia,EURO,3,1064,0,24
11923,2020-05-31T00:00:00Z,LV,Latvia,EURO,1,1065,0,24
11924,2020-06-01T00:00:00Z,LV,Latvia,EURO,1,1066,0,24
11925,2020-06-02T00:00:00Z,LV,Latvia,EURO,5,1071,0,24
11926,2020-06-03T00:00:00Z,LV,Latvia,EURO,8,1079,0,24
11927,2020-06-04T00:00:00Z,LV,Latvia,EURO,0,1079,0,24
11928,2020-06-05T00:00:00Z,LV,Latvia,EURO,3,1082,1,25
11929,2020-06-06T00:00:00Z,LV,Latvia,EURO,0,1082,0,25
11930,2020-06-07T00:00:00Z,LV,Latvia,EURO,4,1086,0,25
11931,2020-06-08T00:00:00Z,LV,Latvia,EURO,2,1088,0,25
11932,2020-06-09T00:00:00Z,LV,Latvia,EURO,0,1088,1,26
11933,2020-06-10T00:00:00Z,LV,Latvia,EURO,1,1089,0,26
11934,2020-06-11T00:00:00Z,LV,Latvia,EURO,3,1092,0,26
11935,2020-06-12T00:00:00Z,LV,Latvia,EURO,2,1094,0,26
11936,2020-06-13T00:00:00Z,LV,Latvia,EURO,2,1096,1,27
11937,2020-06-14T00:00:00Z,LV,Latvia,EURO,1,1097,1,28
11938,2020-06-15T00:00:00Z,LV,Latvia,EURO,0,1097,0,28
11939,2020-06-16T00:00:00Z,LV,Latvia,EURO,0,1097,0,28
11940,2020-06-17T00:00:00Z,LV,Latvia,EURO,1,1098,0,28
11941,2020-06-18T00:00:00Z,LV,Latvia,EURO,6,1104,2,30
11942,2020-06-19T00:00:00Z,LV,Latvia,EURO,4,1108,0,30
11943,2020-06-20T00:00:00Z,LV,Latvia,EURO,2,1110,0,30
12287,2020-03-05T00:00:00Z,LI,Liechtenstein,EURO,1,1,0,0
12288,2020-03-06T00:00:00Z,LI,Liechtenstein,EURO,0,1,0,0
12289,2020-03-07T00:00:00Z,LI,Liechtenstein,EURO,0,1,0,0
12290,2020-03-08T00:00:00Z,LI,Liechtenstein,EURO,0,1,0,0
12291,2020-03-09T00:00:00Z,LI,Liechtenstein,EURO,0,1,0,0
12292,2020-03-10T00:00:00Z,LI,Liechtenstein,EURO,0,1,0,0
12293,2020-03-11T00:00:00Z,LI,Liechtenstein,EURO,0,1,0,0
12294,2020-03-12T00:00:00Z,LI,Liechtenstein,EURO,3,4,0,0
12295,2020-03-13T00:00:00Z,LI,Liechtenstein,EURO,0,4,0,0
12296,2020-03-14T00:00:00Z,LI,Liechtenstein,EURO,0,4,0,0
12297,2020-03-15T00:00:00Z,LI,Liechtenstein,EURO,0,4,0,0
12298,2020-03-16T00:00:00Z,LI,Liechtenstein,EURO,3,7,0,0
12299,2020-03-17T00:00:00Z,LI,Liechtenstein,EURO,0,7,0,0
12300,2020-03-18T00:00:00Z,LI,Liechtenstein,EURO,18,25,0,0
12301,2020-03-19T00:00:00Z,LI,Liechtenstein,EURO,0,25,0,0
12302,2020-03-20T00:00:00Z,LI,Liechtenstein,EURO,9,34,0,0
12303,2020-03-21T00:00:00Z,LI,Liechtenstein,EURO,2,36,0,0
12304,2020-03-22T00:00:00Z,LI,Liechtenstein,EURO,0,36,0,0
12305,2020-03-23T00:00:00Z,LI,Liechtenstein,EURO,35,71,0,0
12306,2020-03-24T00:00:00Z,LI,Liechtenstein,EURO,0,71,0,0
12307,2020-03-25T00:00:00Z,LI,Liechtenstein,EURO,-24,47,0,0
12308,2020-03-26T00:00:00Z,LI,Liechtenstein,EURO,4,51,0,0
12309,2020-03-27T00:00:00Z,LI,Liechtenstein,EURO,5,56,0,0
12310,2020-03-28T00:00:00Z,LI,Liechtenstein,EURO,4,60,0,0
12311,2020-03-29T00:00:00Z,LI,Liechtenstein,EURO,1,61,0,0
12312,2020-03-30T00:00:00Z,LI,Liechtenstein,EURO,1,62,0,0
12313,2020-03-31T00:00:00Z,LI,Liechtenstein,EURO,2,64,0,0
12314,2020-04-01T00:00:00Z,LI,Liechtenstein,EURO,4,68,0,0
12315,2020-04-02T00:00:00Z,LI,Liechtenstein,EURO,4,72,0,0
12316,2020-04-03T00:00:00Z,LI,Liechtenstein,EURO,3,75,0,0
12317,2020-04-04T00:00:00Z,LI,Liechtenstein,EURO,1,76,0,0
12318,2020-04-05T00:00:00Z,LI,Liechtenstein,EURO,1,77,1,1
12319,2020-04-06T00:00:00Z,LI,Liechtenstein,EURO,1,78,0,1
12320,2020-04-07T00:00:00Z,LI,Liechtenstein,EURO,0,78,0,1
12321,2020-04-08T00:00:00Z,LI,Liechtenstein,EURO,0,78,0,1
12322,2020-04-09T00:00:00Z,LI,Liechtenstein,EURO,1,79,0,1
12323,2020-04-10T00:00:00Z,LI,Liechtenstein,EURO,0,79,0,1
12324,2020-04-11T00:00:00Z,LI,Liechtenstein,EURO,1,80,0,1
12325,2020-04-12T00:00:00Z,LI,Liechtenstein,EURO,0,80,0,1
12326,2020-04-13T00:00:00Z,LI,Liechtenstein,EURO,0,80,0,1
12327,2020-04-14T00:00:00Z,LI,Liechtenstein,EURO,0,80,0,1
12328,2020-04-15T00:00:00Z,LI,Liechtenstein,EURO,1,81,0,1
12329,2020-04-16T00:00:00Z,LI,Liechtenstein,EURO,0,81,0,1
12330,2020-04-17T00:00:00Z,LI,Liechtenstein,EURO,0,81,0,1
12331,2020-04-18T00:00:00Z,LI,Liechtenstein,EURO,0,81,0,1
12332,2020-04-19T00:00:00Z,LI,Liechtenstein,EURO,1,82,0,1
12333,2020-04-20T00:00:00Z,LI,Liechtenstein,EURO,0,82,0,1
12334,2020-04-21T00:00:00Z,LI,Liechtenstein,EURO,0,82,0,1
12335,2020-04-22T00:00:00Z,LI,Liechtenstein,EURO,0,82,0,1
12336,2020-04-23T00:00:00Z,LI,Liechtenstein,EURO,0,82,0,1
12337,2020-04-24T00:00:00Z,LI,Liechtenstein,EURO,0,82,0,1
12338,2020-04-25T00:00:00Z,LI,Liechtenstein,EURO,0,82,0,1
12339,2020-04-26T00:00:00Z,LI,Liechtenstein,EURO,1,83,0,1
12340,2020-04-27T00:00:00Z,LI,Liechtenstein,EURO,0,83,0,1
12341,2020-04-28T00:00:00Z,LI,Liechtenstein,EURO,0,83,0,1
12342,2020-04-29T00:00:00Z,LI,Liechtenstein,EURO,0,83,0,1
12343,2020-04-30T00:00:00Z,LI,Liechtenstein,EURO,0,83,0,1
12344,2020-05-01T00:00:00Z,LI,Liechtenstein,EURO,0,83,0,1
12345,2020-05-02T00:00:00Z,LI,Liechtenstein,EURO,0,83,0,1
12346,2020-05-03T00:00:00Z,LI,Liechtenstein,EURO,0,83,0,1
12347,2020-05-04T00:00:00Z,LI,Liechtenstein,EURO,0,83,0,1
12348,2020-05-05T00:00:00Z,LI,Liechtenstein,EURO,0,83,0,1
12349,2020-05-06T00:00:00Z,LI,Liechtenstein,EURO,0,83,0,1
12350,2020-05-07T00:00:00Z,LI,Liechtenstein,EURO,0,83,0,1
12351,2020-05-08T00:00:00Z,LI,Liechtenstein,EURO,0,83,0,1
12352,2020-05-09T00:00:00Z,LI,Liechtenstein,EURO,0,83,0,1
12353,2020-05-10T00:00:00Z,LI,Liechtenstein,EURO,0,83,0,1
12354,2020-05-11T00:00:00Z,LI,Liechtenstein,EURO,0,83,0,1
12355,2020-05-12T00:00:00Z,LI,Liechtenstein,EURO,0,83,0,1
12356,2020-05-13T00:00:00Z,LI,Liechtenstein,EURO,0,83,0,1
12357,2020-05-14T00:00:00Z,LI,Liechtenstein,EURO,0,83,0,1
12358,2020-05-15T00:00:00Z,LI,Liechtenstein,EURO,0,83,0,1
12359,2020-05-16T00:00:00Z,LI,Liechtenstein,EURO,0,83,0,1
12360,2020-05-17T00:00:00Z,LI,Liechtenstein,EURO,0,83,0,1
12361,2020-05-18T00:00:00Z,LI,Liechtenstein,EURO,0,83,0,1
12362,2020-05-19T00:00:00Z,LI,Liechtenstein,EURO,0,83,0,1
12363,2020-05-20T00:00:00Z,LI,Liechtenstein,EURO,0,83,0,1
12364,2020-05-21T00:00:00Z,LI,Liechtenstein,EURO,0,83,0,1
12365,2020-05-22T00:00:00Z,LI,Liechtenstein,EURO,0,83,0,1
12366,2020-05-23T00:00:00Z,LI,Liechtenstein,EURO,0,83,0,1
12367,2020-05-24T00:00:00Z,LI,Liechtenstein,EURO,0,83,0,1
12368,2020-05-25T00:00:00Z,LI,Liechtenstein,EURO,0,83,0,1
12369,2020-05-26T00:00:00Z,LI,Liechtenstein,EURO,0,83,0,1
12370,2020-05-27T00:00:00Z,LI,Liechtenstein,EURO,0,83,0,1
12371,2020-05-28T00:00:00Z,LI,Liechtenstein,EURO,0,83,0,1
12372,2020-05-29T00:00:00Z,LI,Liechtenstein,EURO,0,83,0,1
12373,2020-05-30T00:00:00Z,LI,Liechtenstein,EURO,0,83,0,1
12374,2020-05-31T00:00:00Z,LI,Liechtenstein,EURO,0,83,0,1
12375,2020-06-01T00:00:00Z,LI,Liechtenstein,EURO,0,83,0,1
12376,2020-06-02T00:00:00Z,LI,Liechtenstein,EURO,0,83,0,1
12377,2020-06-03T00:00:00Z,LI,Liechtenstein,EURO,0,83,0,1
12378,2020-06-04T00:00:00Z,LI,Liechtenstein,EURO,0,83,0,1
12379,2020-06-05T00:00:00Z,LI,Liechtenstein,EURO,0,83,0,1
12380,2020-06-06T00:00:00Z,LI,Liechtenstein,EURO,0,83,0,1
12381,2020-06-07T00:00:00Z,LI,Liechtenstein,EURO,0,83,0,1
12382,2020-06-08T00:00:00Z,LI,Liechtenstein,EURO,0,83,0,1
12383,2020-06-09T00:00:00Z,LI,Liechtenstein,EURO,0,83,0,1
12384,2020-06-10T00:00:00Z,LI,Liechtenstein,EURO,0,83,0,1
12385,2020-06-11T00:00:00Z,LI,Liechtenstein,EURO,0,83,0,1
12386,2020-06-12T00:00:00Z,LI,Liechtenstein,EURO,0,83,0,1
12387,2020-06-13T00:00:00Z,LI,Liechtenstein,EURO,0,83,0,1
12388,2020-06-14T00:00:00Z,LI,Liechtenstein,EURO,0,83,0,1
12389,2020-06-15T00:00:00Z,LI,Liechtenstein,EURO,0,83,0,1
12390,2020-06-16T00:00:00Z,LI,Liechtenstein,EURO,0,83,0,1
12391,2020-06-17T00:00:00Z,LI,Liechtenstein,EURO,0,83,0,1
12392,2020-06-18T00:00:00Z,LI,Liechtenstein,EURO,0,83,0,1
12393,2020-06-19T00:00:00Z,LI,Liechtenstein,EURO,0,83,0,1
12394,2020-06-20T00:00:00Z,LI,Liechtenstein,EURO,0,83,0,1
12395,2020-02-28T00:00:00Z,LT,Lithuania,EURO,1,1,0,0
12396,2020-02-29T00:00:00Z,LT,Lithuania,EURO,0,1,0,0
12397,2020-03-01T00:00:00Z,LT,Lithuania,EURO,0,1,0,0
12398,2020-03-02T00:00:00Z,LT,Lithuania,EURO,0,1,0,0
12399,2020-03-03T00:00:00Z,LT,Lithuania,EURO,0,1,0,0
12400,2020-03-04T00:00:00Z,LT,Lithuania,EURO,0,1,0,0
12401,2020-03-05T00:00:00Z,LT,Lithuania,EURO,0,1,0,0
12402,2020-03-06T00:00:00Z,LT,Lithuania,EURO,0,1,0,0
12403,2020-03-07T00:00:00Z,LT,Lithuania,EURO,0,1,0,0
12404,2020-03-08T00:00:00Z,LT,Lithuania,EURO,0,1,0,0
12405,2020-03-09T00:00:00Z,LT,Lithuania,EURO,0,1,0,0
12406,2020-03-10T00:00:00Z,LT,Lithuania,EURO,0,1,0,0
12407,2020-03-11T00:00:00Z,LT,Lithuania,EURO,2,3,0,0
12408,2020-03-12T00:00:00Z,LT,Lithuania,EURO,0,3,0,0
12409,2020-03-13T00:00:00Z,LT,Lithuania,EURO,3,6,0,0
12410,2020-03-14T00:00:00Z,LT,Lithuania,EURO,2,8,0,0
12411,2020-03-15T00:00:00Z,LT,Lithuania,EURO,1,9,0,0
12412,2020-03-16T00:00:00Z,LT,Lithuania,EURO,8,17,0,0
12413,2020-03-17T00:00:00Z,LT,Lithuania,EURO,8,25,0,0
12414,2020-03-18T00:00:00Z,LT,Lithuania,EURO,1,26,0,0
12415,2020-03-19T00:00:00Z,LT,Lithuania,EURO,10,36,0,0
12416,2020-03-20T00:00:00Z,LT,Lithuania,EURO,33,69,1,1
12417,2020-03-21T00:00:00Z,LT,Lithuania,EURO,36,105,0,1
12418,2020-03-22T00:00:00Z,LT,Lithuania,EURO,0,105,0,1
12419,2020-03-23T00:00:00Z,LT,Lithuania,EURO,-26,79,0,1
12420,2020-03-24T00:00:00Z,LT,Lithuania,EURO,100,179,0,1
12421,2020-03-25T00:00:00Z,LT,Lithuania,EURO,30,209,1,2
12422,2020-03-26T00:00:00Z,LT,Lithuania,EURO,65,274,2,4
12423,2020-03-27T00:00:00Z,LT,Lithuania,EURO,25,299,0,4
12424,2020-03-28T00:00:00Z,LT,Lithuania,EURO,59,358,1,5
12425,2020-03-29T00:00:00Z,LT,Lithuania,EURO,36,394,2,7
12426,2020-03-30T00:00:00Z,LT,Lithuania,EURO,90,484,0,7
12427,2020-03-31T00:00:00Z,LT,Lithuania,EURO,0,484,0,7
12428,2020-04-01T00:00:00Z,LT,Lithuania,EURO,49,533,0,7
12429,2020-04-02T00:00:00Z,LT,Lithuania,EURO,48,581,1,8
12430,2020-04-03T00:00:00Z,LT,Lithuania,EURO,68,649,1,9
12431,2020-04-04T00:00:00Z,LT,Lithuania,EURO,122,771,0,9
12432,2020-04-05T00:00:00Z,LT,Lithuania,EURO,0,771,0,9
12433,2020-04-06T00:00:00Z,LT,Lithuania,EURO,40,811,4,13
12434,2020-04-07T00:00:00Z,LT,Lithuania,EURO,32,843,1,14
12435,2020-04-08T00:00:00Z,LT,Lithuania,EURO,37,880,1,15
12436,2020-04-09T00:00:00Z,LT,Lithuania,EURO,32,912,0,15
12437,2020-04-10T00:00:00Z,LT,Lithuania,EURO,43,955,0,15
12438,2020-04-11T00:00:00Z,LT,Lithuania,EURO,44,999,2,17
12439,2020-04-12T00:00:00Z,LT,Lithuania,EURO,54,1053,6,23
12440,2020-04-13T00:00:00Z,LT,Lithuania,EURO,9,1062,1,24
12441,2020-04-14T00:00:00Z,LT,Lithuania,EURO,8,1070,0,24
12442,2020-04-15T00:00:00Z,LT,Lithuania,EURO,0,1070,0,24
12443,2020-04-16T00:00:00Z,LT,Lithuania,EURO,21,1091,5,29
12444,2020-04-17T00:00:00Z,LT,Lithuania,EURO,58,1149,3,32
12445,2020-04-18T00:00:00Z,LT,Lithuania,EURO,90,1239,1,33
12446,2020-04-19T00:00:00Z,LT,Lithuania,EURO,59,1298,0,33
12447,2020-04-20T00:00:00Z,LT,Lithuania,EURO,28,1326,3,36
12448,2020-04-21T00:00:00Z,LT,Lithuania,EURO,24,1350,1,37
12449,2020-04-22T00:00:00Z,LT,Lithuania,EURO,20,1370,1,38
12450,2020-04-23T00:00:00Z,LT,Lithuania,EURO,28,1398,0,38
12451,2020-04-24T00:00:00Z,LT,Lithuania,EURO,12,1410,2,40
12452,2020-04-25T00:00:00Z,LT,Lithuania,EURO,0,1410,0,40
12453,2020-04-26T00:00:00Z,LT,Lithuania,EURO,16,1426,1,41
12454,2020-04-27T00:00:00Z,LT,Lithuania,EURO,12,1438,0,41
12455,2020-04-28T00:00:00Z,LT,Lithuania,EURO,11,1449,0,41
12456,2020-04-29T00:00:00Z,LT,Lithuania,EURO,-105,1344,3,44
12457,2020-04-30T00:00:00Z,LT,Lithuania,EURO,31,1375,1,45
12458,2020-05-01T00:00:00Z,LT,Lithuania,EURO,10,1385,0,45
12459,2020-05-02T00:00:00Z,LT,Lithuania,EURO,14,1399,0,45
12460,2020-05-03T00:00:00Z,LT,Lithuania,EURO,7,1406,1,46
12461,2020-05-04T00:00:00Z,LT,Lithuania,EURO,4,1410,0,46
12462,2020-05-05T00:00:00Z,LT,Lithuania,EURO,9,1419,0,46
12463,2020-05-06T00:00:00Z,LT,Lithuania,EURO,4,1423,0,46
12464,2020-05-07T00:00:00Z,LT,Lithuania,EURO,5,1428,2,48
12465,2020-05-08T00:00:00Z,LT,Lithuania,EURO,5,1433,1,49
12466,2020-05-09T00:00:00Z,LT,Lithuania,EURO,3,1436,0,49
12467,2020-05-10T00:00:00Z,LT,Lithuania,EURO,8,1444,1,50
12468,2020-05-11T00:00:00Z,LT,Lithuania,EURO,35,1479,0,50
12469,2020-05-12T00:00:00Z,LT,Lithuania,EURO,6,1485,0,50
12470,2020-05-13T00:00:00Z,LT,Lithuania,EURO,6,1491,0,50
12471,2020-05-14T00:00:00Z,LT,Lithuania,EURO,14,1505,4,54
12472,2020-05-15T00:00:00Z,LT,Lithuania,EURO,6,1511,0,54
12473,2020-05-16T00:00:00Z,LT,Lithuania,EURO,12,1523,0,54
12474,2020-05-17T00:00:00Z,LT,Lithuania,EURO,11,1534,1,55
12475,2020-05-18T00:00:00Z,LT,Lithuania,EURO,7,1541,1,56
12476,2020-05-19T00:00:00Z,LT,Lithuania,EURO,6,1547,3,59
12477,2020-05-20T00:00:00Z,LT,Lithuania,EURO,15,1562,1,60
12478,2020-05-21T00:00:00Z,LT,Lithuania,EURO,15,1577,0,60
12479,2020-05-22T00:00:00Z,LT,Lithuania,EURO,17,1594,1,61
12480,2020-05-23T00:00:00Z,LT,Lithuania,EURO,10,1604,0,61
12481,2020-05-24T00:00:00Z,LT,Lithuania,EURO,12,1616,2,63
12482,2020-05-25T00:00:00Z,LT,Lithuania,EURO,7,1623,0,63
12483,2020-05-26T00:00:00Z,LT,Lithuania,EURO,12,1635,0,63
12484,2020-05-27T00:00:00Z,LT,Lithuania,EURO,4,1639,2,65
12485,2020-05-28T00:00:00Z,LT,Lithuania,EURO,8,1647,1,66
12486,2020-05-29T00:00:00Z,LT,Lithuania,EURO,9,1656,2,68
12487,2020-05-30T00:00:00Z,LT,Lithuania,EURO,6,1662,0,68
12488,2020-05-31T00:00:00Z,LT,Lithuania,EURO,8,1670,2,70
12489,2020-06-01T00:00:00Z,LT,Lithuania,EURO,5,1675,0,70
12490,2020-06-02T00:00:00Z,LT,Lithuania,EURO,3,1678,0,70
12491,2020-06-03T00:00:00Z,LT,Lithuania,EURO,4,1682,1,71
12492,2020-06-04T00:00:00Z,LT,Lithuania,EURO,2,1684,0,71
12493,2020-06-05T00:00:00Z,LT,Lithuania,EURO,3,1687,0,71
12494,2020-06-06T00:00:00Z,LT,Lithuania,EURO,7,1694,0,71
12495,2020-06-07T00:00:00Z,LT,Lithuania,EURO,11,1705,0,71
12496,2020-06-08T00:00:00Z,LT,Lithuania,EURO,9,1714,0,71
12497,2020-06-09T00:00:00Z,LT,Lithuania,EURO,6,1720,0,71
12498,2020-06-10T00:00:00Z,LT,Lithuania,EURO,7,1727,1,72
12499,2020-06-11T00:00:00Z,LT,Lithuania,EURO,6,1733,2,74
12500,2020-06-12T00:00:00Z,LT,Lithuania,EURO,19,1752,0,74
12501,2020-06-13T00:00:00Z,LT,Lithuania,EURO,4,1756,0,74
12502,2020-06-14T00:00:00Z,LT,Lithuania,EURO,7,1763,1,75
12503,2020-06-15T00:00:00Z,LT,Lithuania,EURO,5,1768,0,75
12504,2020-06-16T00:00:00Z,LT,Lithuania,EURO,5,1773,1,76
12505,2020-06-17T00:00:00Z,LT,Lithuania,EURO,3,1776,0,76
12506,2020-06-18T00:00:00Z,LT,Lithuania,EURO,2,1778,0,76
12507,2020-06-19T00:00:00Z,LT,Lithuania,EURO,6,1784,0,76
12508,2020-06-20T00:00:00Z,LT,Lithuania,EURO,8,1792,0,76
12509,2020-03-01T00:00:00Z,LU,Luxembourg,EURO,1,1,0,0
12510,2020-03-02T00:00:00Z,LU,Luxembourg,EURO,0,1,0,0
12511,2020-03-03T00:00:00Z,LU,Luxembourg,EURO,0,1,0,0
12512,2020-03-04T00:00:00Z,LU,Luxembourg,EURO,0,1,0,0
12513,2020-03-05T00:00:00Z,LU,Luxembourg,EURO,0,1,0,0
12514,2020-03-06T00:00:00Z,LU,Luxembourg,EURO,1,2,0,0
12515,2020-03-07T00:00:00Z,LU,Luxembourg,EURO,0,2,0,0
12516,2020-03-08T00:00:00Z,LU,Luxembourg,EURO,0,2,0,0
12517,2020-03-09T00:00:00Z,LU,Luxembourg,EURO,3,5,0,0
12518,2020-03-10T00:00:00Z,LU,Luxembourg,EURO,0,5,0,0
12519,2020-03-11T00:00:00Z,LU,Luxembourg,EURO,0,5,0,0
12520,2020-03-12T00:00:00Z,LU,Luxembourg,EURO,12,17,0,0
12521,2020-03-13T00:00:00Z,LU,Luxembourg,EURO,21,38,1,1
12522,2020-03-14T00:00:00Z,LU,Luxembourg,EURO,0,38,0,1
12523,2020-03-15T00:00:00Z,LU,Luxembourg,EURO,0,38,0,1
12524,2020-03-16T00:00:00Z,LU,Luxembourg,EURO,43,81,0,1
12525,2020-03-17T00:00:00Z,LU,Luxembourg,EURO,59,140,0,1
12526,2020-03-18T00:00:00Z,LU,Luxembourg,EURO,70,210,1,2
12527,2020-03-19T00:00:00Z,LU,Luxembourg,EURO,135,345,2,4
12528,2020-03-20T00:00:00Z,LU,Luxembourg,EURO,139,484,1,5
12529,2020-03-21T00:00:00Z,LU,Luxembourg,EURO,186,670,3,8
12530,2020-03-22T00:00:00Z,LU,Luxembourg,EURO,0,670,0,8
12531,2020-03-23T00:00:00Z,LU,Luxembourg,EURO,-582,88,0,8
12532,2020-03-24T00:00:00Z,LU,Luxembourg,EURO,787,875,0,8
12533,2020-03-25T00:00:00Z,LU,Luxembourg,EURO,224,1099,0,8
12534,2020-03-26T00:00:00Z,LU,Luxembourg,EURO,234,1333,0,8
12535,2020-03-27T00:00:00Z,LU,Luxembourg,EURO,120,1453,1,9
12536,2020-03-28T00:00:00Z,LU,Luxembourg,EURO,152,1605,6,15
12537,2020-03-29T00:00:00Z,LU,Luxembourg,EURO,226,1831,3,18
12538,2020-03-30T00:00:00Z,LU,Luxembourg,EURO,119,1950,3,21
12539,2020-03-31T00:00:00Z,LU,Luxembourg,EURO,38,1988,1,22
12540,2020-04-01T00:00:00Z,LU,Luxembourg,EURO,190,2178,1,23
12541,2020-04-02T00:00:00Z,LU,Luxembourg,EURO,141,2319,6,29
12542,2020-04-03T00:00:00Z,LU,Luxembourg,EURO,168,2487,1,30
12543,2020-04-04T00:00:00Z,LU,Luxembourg,EURO,125,2612,1,31
12544,2020-04-05T00:00:00Z,LU,Luxembourg,EURO,117,2729,0,31
12545,2020-04-06T00:00:00Z,LU,Luxembourg,EURO,75,2804,5,36
12546,2020-04-07T00:00:00Z,LU,Luxembourg,EURO,39,2843,5,41
12547,2020-04-08T00:00:00Z,LU,Luxembourg,EURO,127,2970,3,44
12548,2020-04-09T00:00:00Z,LU,Luxembourg,EURO,64,3034,2,46
12549,2020-04-10T00:00:00Z,LU,Luxembourg,EURO,81,3115,6,52
12550,2020-04-11T00:00:00Z,LU,Luxembourg,EURO,108,3223,2,54
12551,2020-04-12T00:00:00Z,LU,Luxembourg,EURO,47,3270,8,62
12552,2020-04-13T00:00:00Z,LU,Luxembourg,EURO,11,3281,4,66
12553,2020-04-14T00:00:00Z,LU,Luxembourg,EURO,11,3292,3,69
12554,2020-04-15T00:00:00Z,LU,Luxembourg,EURO,15,3307,0,69
12555,2020-04-16T00:00:00Z,LU,Luxembourg,EURO,66,3373,0,69
12556,2020-04-17T00:00:00Z,LU,Luxembourg,EURO,71,3444,0,69
12557,2020-04-18T00:00:00Z,LU,Luxembourg,EURO,36,3480,3,72
12558,2020-04-19T00:00:00Z,LU,Luxembourg,EURO,57,3537,0,72
12559,2020-04-20T00:00:00Z,LU,Luxembourg,EURO,13,3550,1,73
12560,2020-04-21T00:00:00Z,LU,Luxembourg,EURO,8,3558,2,75
12561,2020-04-22T00:00:00Z,LU,Luxembourg,EURO,60,3618,3,78
12562,2020-04-23T00:00:00Z,LU,Luxembourg,EURO,36,3654,2,80
12563,2020-04-24T00:00:00Z,LU,Luxembourg,EURO,11,3665,3,83
12564,2020-04-25T00:00:00Z,LU,Luxembourg,EURO,30,3695,2,85
12565,2020-04-26T00:00:00Z,LU,Luxembourg,EURO,16,3711,0,85
12566,2020-04-27T00:00:00Z,LU,Luxembourg,EURO,12,3723,3,88
12567,2020-04-28T00:00:00Z,LU,Luxembourg,EURO,6,3729,0,88
12568,2020-04-29T00:00:00Z,LU,Luxembourg,EURO,12,3741,1,89
12569,2020-04-30T00:00:00Z,LU,Luxembourg,EURO,28,3769,0,89
12570,2020-05-01T00:00:00Z,LU,Luxembourg,EURO,15,3784,1,90
12571,2020-05-02T00:00:00Z,LU,Luxembourg,EURO,18,3802,2,92
12572,2020-05-03T00:00:00Z,LU,Luxembourg,EURO,10,3812,0,92
12573,2020-05-04T00:00:00Z,LU,Luxembourg,EURO,12,3824,4,96
12574,2020-05-05T00:00:00Z,LU,Luxembourg,EURO,4,3828,0,96
12575,2020-05-06T00:00:00Z,LU,Luxembourg,EURO,12,3840,0,96
12576,2020-05-07T00:00:00Z,LU,Luxembourg,EURO,11,3851,2,98
12577,2020-05-08T00:00:00Z,LU,Luxembourg,EURO,8,3859,2,100
12578,2020-05-09T00:00:00Z,LU,Luxembourg,EURO,12,3871,0,100
12579,2020-05-10T00:00:00Z,LU,Luxembourg,EURO,6,3877,1,101
12580,2020-05-11T00:00:00Z,LU,Luxembourg,EURO,9,3886,0,101
12581,2020-05-12T00:00:00Z,LU,Luxembourg,EURO,2,3888,0,101
12582,2020-05-13T00:00:00Z,LU,Luxembourg,EURO,6,3894,1,102
12583,2020-05-14T00:00:00Z,LU,Luxembourg,EURO,10,3904,1,103
12584,2020-05-15T00:00:00Z,LU,Luxembourg,EURO,11,3915,0,103
12585,2020-05-16T00:00:00Z,LU,Luxembourg,EURO,8,3923,1,104
12586,2020-05-17T00:00:00Z,LU,Luxembourg,EURO,7,3930,0,104
12587,2020-05-18T00:00:00Z,LU,Luxembourg,EURO,15,3945,3,107
12588,2020-05-19T00:00:00Z,LU,Luxembourg,EURO,2,3947,0,107
12589,2020-05-20T00:00:00Z,LU,Luxembourg,EURO,11,3958,2,109
12590,2020-05-21T00:00:00Z,LU,Luxembourg,EURO,13,3971,0,109
12591,2020-05-22T00:00:00Z,LU,Luxembourg,EURO,9,3980,0,109
12592,2020-05-23T00:00:00Z,LU,Luxembourg,EURO,1,3981,0,109
12593,2020-05-24T00:00:00Z,LU,Luxembourg,EURO,9,3990,0,109
12594,2020-05-25T00:00:00Z,LU,Luxembourg,EURO,2,3992,1,110
12595,2020-05-26T00:00:00Z,LU,Luxembourg,EURO,1,3993,0,110
12596,2020-05-27T00:00:00Z,LU,Luxembourg,EURO,2,3995,0,110
12597,2020-05-28T00:00:00Z,LU,Luxembourg,EURO,6,4001,0,110
12598,2020-05-29T00:00:00Z,LU,Luxembourg,EURO,7,4008,0,110
12599,2020-05-30T00:00:00Z,LU,Luxembourg,EURO,4,4012,0,110
12600,2020-05-31T00:00:00Z,LU,Luxembourg,EURO,4,4016,0,110
12601,2020-06-01T00:00:00Z,LU,Luxembourg,EURO,2,4018,0,110
12602,2020-06-02T00:00:00Z,LU,Luxembourg,EURO,1,4019,0,110
12603,2020-06-03T00:00:00Z,LU,Luxembourg,EURO,1,4020,0,110
12604,2020-06-04T00:00:00Z,LU,Luxembourg,EURO,0,4020,0,110
12605,2020-06-05T00:00:00Z,LU,Luxembourg,EURO,7,4027,0,110
12606,2020-06-06T00:00:00Z,LU,Luxembourg,EURO,5,4032,0,110
12607,2020-06-07T00:00:00Z,LU,Luxembourg,EURO,3,4035,0,110
12608,2020-06-08T00:00:00Z,LU,Luxembourg,EURO,4,4039,0,110
12609,2020-06-09T00:00:00Z,LU,Luxembourg,EURO,1,4040,0,110
12610,2020-06-10T00:00:00Z,LU,Luxembourg,EURO,6,4046,0,110
12611,2020-06-11T00:00:00Z,LU,Luxembourg,EURO,3,4049,0,110
12612,2020-06-12T00:00:00Z,LU,Luxembourg,EURO,3,4052,0,110
12613,2020-06-13T00:00:00Z,LU,Luxembourg,EURO,3,4055,0,110
12614,2020-06-14T00:00:00Z,LU,Luxembourg,EURO,8,4063,0,110
12615,2020-06-15T00:00:00Z,LU,Luxembourg,EURO,7,4070,0,110
12616,2020-06-16T00:00:00Z,LU,Luxembourg,EURO,2,4072,0,110
12617,2020-06-17T00:00:00Z,LU,Luxembourg,EURO,3,4075,0,110
12618,2020-06-18T00:00:00Z,LU,Luxembourg,EURO,10,4085,0,110
12619,2020-06-19T00:00:00Z,LU,Luxembourg,EURO,6,4091,0,110
12620,2020-06-20T00:00:00Z,LU,Luxembourg,EURO,8,4099,0,110
13133,2020-03-07T00:00:00Z,MT,Malta,EURO,3,3,0,0
13134,2020-03-08T00:00:00Z,MT,Malta,EURO,0,3,0,0
13135,2020-03-09T00:00:00Z,MT,Malta,EURO,0,3,0,0
13136,2020-03-10T00:00:00Z,MT,Malta,EURO,1,4,0,0
13137,2020-03-11T00:00:00Z,MT,Malta,EURO,2,6,0,0
13138,2020-03-12T00:00:00Z,MT,Malta,EURO,3,9,0,0
13139,2020-03-13T00:00:00Z,MT,Malta,EURO,3,12,0,0
13140,2020-03-14T00:00:00Z,MT,Malta,EURO,0,12,0,0
13141,2020-03-15T00:00:00Z,MT,Malta,EURO,9,21,0,0
13142,2020-03-16T00:00:00Z,MT,Malta,EURO,9,30,0,0
13143,2020-03-17T00:00:00Z,MT,Malta,EURO,8,38,0,0
13144,2020-03-18T00:00:00Z,MT,Malta,EURO,10,48,0,0
13145,2020-03-19T00:00:00Z,MT,Malta,EURO,5,53,0,0
13146,2020-03-20T00:00:00Z,MT,Malta,EURO,11,64,0,0
13147,2020-03-21T00:00:00Z,MT,Malta,EURO,9,73,0,0
13148,2020-03-22T00:00:00Z,MT,Malta,EURO,0,73,0,0
13149,2020-03-23T00:00:00Z,MT,Malta,EURO,18,91,0,0
13150,2020-03-24T00:00:00Z,MT,Malta,EURO,16,107,0,0
13151,2020-03-25T00:00:00Z,MT,Malta,EURO,13,120,0,0
13152,2020-03-26T00:00:00Z,MT,Malta,EURO,9,129,0,0
13153,2020-03-27T00:00:00Z,MT,Malta,EURO,5,134,0,0
13154,2020-03-28T00:00:00Z,MT,Malta,EURO,5,139,0,0
13155,2020-03-29T00:00:00Z,MT,Malta,EURO,0,139,0,0
13156,2020-03-30T00:00:00Z,MT,Malta,EURO,12,151,0,0
13157,2020-03-31T00:00:00Z,MT,Malta,EURO,5,156,0,0
13158,2020-04-01T00:00:00Z,MT,Malta,EURO,11,167,0,0
13159,2020-04-02T00:00:00Z,MT,Malta,EURO,21,188,0,0
13160,2020-04-03T00:00:00Z,MT,Malta,EURO,7,195,0,0
13161,2020-04-04T00:00:00Z,MT,Malta,EURO,7,202,0,0
13162,2020-04-05T00:00:00Z,MT,Malta,EURO,11,213,0,0
13163,2020-04-06T00:00:00Z,MT,Malta,EURO,21,234,0,0
13164,2020-04-07T00:00:00Z,MT,Malta,EURO,7,241,0,0
13165,2020-04-08T00:00:00Z,MT,Malta,EURO,52,293,0,0
13166,2020-04-09T00:00:00Z,MT,Malta,EURO,6,299,1,1
13167,2020-04-10T00:00:00Z,MT,Malta,EURO,38,337,1,2
13168,2020-04-11T00:00:00Z,MT,Malta,EURO,13,350,0,2
13169,2020-04-12T00:00:00Z,MT,Malta,EURO,20,370,1,3
13170,2020-04-13T00:00:00Z,MT,Malta,EURO,8,378,0,3
13171,2020-04-14T00:00:00Z,MT,Malta,EURO,6,384,0,3
13172,2020-04-15T00:00:00Z,MT,Malta,EURO,9,393,0,3
13173,2020-04-16T00:00:00Z,MT,Malta,EURO,6,399,0,3
13174,2020-04-17T00:00:00Z,MT,Malta,EURO,13,412,0,3
13175,2020-04-18T00:00:00Z,MT,Malta,EURO,10,422,0,3
13176,2020-04-19T00:00:00Z,MT,Malta,EURO,4,426,0,3
13177,2020-04-20T00:00:00Z,MT,Malta,EURO,1,427,0,3
13178,2020-04-21T00:00:00Z,MT,Malta,EURO,4,431,0,3
13179,2020-04-22T00:00:00Z,MT,Malta,EURO,12,443,0,3
13180,2020-04-23T00:00:00Z,MT,Malta,EURO,1,444,0,3
13181,2020-04-24T00:00:00Z,MT,Malta,EURO,1,445,0,3
13182,2020-04-25T00:00:00Z,MT,Malta,EURO,2,447,0,3
13183,2020-04-26T00:00:00Z,MT,Malta,EURO,1,448,1,4
13184,2020-04-27T00:00:00Z,MT,Malta,EURO,0,448,0,4
13185,2020-04-28T00:00:00Z,MT,Malta,EURO,2,450,0,4
13186,2020-04-29T00:00:00Z,MT,Malta,EURO,0,450,0,4
13187,2020-04-30T00:00:00Z,MT,Malta,EURO,13,463,0,4
13188,2020-05-01T00:00:00Z,MT,Malta,EURO,2,465,0,4
13189,2020-05-02T00:00:00Z,MT,Malta,EURO,2,467,0,4
13190,2020-05-03T00:00:00Z,MT,Malta,EURO,0,467,0,4
13191,2020-05-04T00:00:00Z,MT,Malta,EURO,10,477,0,4
13192,2020-05-05T00:00:00Z,MT,Malta,EURO,3,480,0,4
13193,2020-05-06T00:00:00Z,MT,Malta,EURO,2,482,1,5
13194,2020-05-07T00:00:00Z,MT,Malta,EURO,2,484,0,5
13195,2020-05-08T00:00:00Z,MT,Malta,EURO,2,486,0,5
13196,2020-05-09T00:00:00Z,MT,Malta,EURO,3,489,0,5
13197,2020-05-10T00:00:00Z,MT,Malta,EURO,1,490,0,5
13198,2020-05-11T00:00:00Z,MT,Malta,EURO,6,496,0,5
13199,2020-05-12T00:00:00Z,MT,Malta,EURO,7,503,0,5
13200,2020-05-13T00:00:00Z,MT,Malta,EURO,0,503,0,5
13201,2020-05-14T00:00:00Z,MT,Malta,EURO,5,508,1,6
13202,2020-05-15T00:00:00Z,MT,Malta,EURO,14,522,0,6
13203,2020-05-16T00:00:00Z,MT,Malta,EURO,10,532,0,6
13204,2020-05-17T00:00:00Z,MT,Malta,EURO,14,546,0,6
13205,2020-05-18T00:00:00Z,MT,Malta,EURO,7,553,0,6
13206,2020-05-19T00:00:00Z,MT,Malta,EURO,5,558,0,6
13207,2020-05-20T00:00:00Z,MT,Malta,EURO,2,560,0,6
13208,2020-05-21T00:00:00Z,MT,Malta,EURO,24,584,0,6
13209,2020-05-22T00:00:00Z,MT,Malta,EURO,15,599,0,6
13210,2020-05-23T00:00:00Z,MT,Malta,EURO,1,600,0,6
13211,2020-05-24T00:00:00Z,MT,Malta,EURO,9,609,0,6
13212,2020-05-25T00:00:00Z,MT,Malta,EURO,1,610,0,6
13213,2020-05-26T00:00:00Z,MT,Malta,EURO,1,611,0,6
13214,2020-05-27T00:00:00Z,MT,Malta,EURO,0,611,0,6
13215,2020-05-28T00:00:00Z,MT,Malta,EURO,4,615,1,7
13216,2020-05-29T00:00:00Z,MT,Malta,EURO,1,616,0,7
13217,2020-05-30T00:00:00Z,MT,Malta,EURO,0,616,0,7
13218,2020-05-31T00:00:00Z,MT,Malta,EURO,0,616,0,7
13219,2020-06-01T00:00:00Z,MT,Malta,EURO,0,616,0,7
13220,2020-06-02T00:00:00Z,MT,Malta,EURO,3,619,2,9
13221,2020-06-03T00:00:00Z,MT,Malta,EURO,1,620,0,9
13222,2020-06-04T00:00:00Z,MT,Malta,EURO,2,622,0,9
13223,2020-06-05T00:00:00Z,MT,Malta,EURO,0,622,0,9
13224,2020-06-06T00:00:00Z,MT,Malta,EURO,0,622,0,9
13225,2020-06-07T00:00:00Z,MT,Malta,EURO,0,622,0,9
13226,2020-06-08T00:00:00Z,MT,Malta,EURO,7,629,0,9
13227,2020-06-09T00:00:00Z,MT,Malta,EURO,1,630,0,9
13228,2020-06-10T00:00:00Z,MT,Malta,EURO,2,632,0,9
13229,2020-06-11T00:00:00Z,MT,Malta,EURO,3,635,0,9
13230,2020-06-12T00:00:00Z,MT,Malta,EURO,5,640,0,9
13231,2020-06-13T00:00:00Z,MT,Malta,EURO,5,645,0,9
13232,2020-06-14T00:00:00Z,MT,Malta,EURO,1,646,0,9
13233,2020-06-15T00:00:00Z,MT,Malta,EURO,2,648,0,9
13234,2020-06-16T00:00:00Z,MT,Malta,EURO,2,650,0,9
13235,2020-06-17T00:00:00Z,MT,Malta,EURO,6,656,0,9
13236,2020-06-18T00:00:00Z,MT,Malta,EURO,6,662,0,9
13237,2020-06-19T00:00:00Z,MT,Malta,EURO,1,663,0,9
13238,2020-06-20T00:00:00Z,MT,Malta,EURO,0,663,0,9
13752,2020-02-29T00:00:00Z,MC,Monaco,EURO,1,1,0,0
13753,2020-03-01T00:00:00Z,MC,Monaco,EURO,0,1,0,0
13754,2020-03-02T00:00:00Z,MC,Monaco,EURO,0,1,0,0
13755,2020-03-03T00:00:00Z,MC,Monaco,EURO,0,1,0,0
13756,2020-03-04T00:00:00Z,MC,Monaco,EURO,0,1,0,0
13757,2020-03-05T00:00:00Z,MC,Monaco,EURO,0,1,0,0
13758,2020-03-06T00:00:00Z,MC,Monaco,EURO,0,1,0,0
13759,2020-03-07T00:00:00Z,MC,Monaco,EURO,0,1,0,0
13760,2020-03-08T00:00:00Z,MC,Monaco,EURO,0,1,0,0
13761,2020-03-09T00:00:00Z,MC,Monaco,EURO,0,1,0,0
13762,2020-03-10T00:00:00Z,MC,Monaco,EURO,0,1,0,0
13763,2020-03-11T00:00:00Z,MC,Monaco,EURO,0,1,0,0
13764,2020-03-12T00:00:00Z,MC,Monaco,EURO,0,1,0,0
13765,2020-03-13T00:00:00Z,MC,Monaco,EURO,1,2,0,0
13766,2020-03-14T00:00:00Z,MC,Monaco,EURO,0,2,0,0
13767,2020-03-15T00:00:00Z,MC,Monaco,EURO,0,2,0,0
13768,2020-03-16T00:00:00Z,MC,Monaco,EURO,7,9,0,0
13769,2020-03-17T00:00:00Z,MC,Monaco,EURO,0,9,0,0
13770,2020-03-18T00:00:00Z,MC,Monaco,EURO,0,9,0,0
13771,2020-03-19T00:00:00Z,MC,Monaco,EURO,0,9,0,0
13772,2020-03-20T00:00:00Z,MC,Monaco,EURO,3,12,0,0
13773,2020-03-21T00:00:00Z,MC,Monaco,EURO,6,18,0,0
13774,2020-03-22T00:00:00Z,MC,Monaco,EURO,0,18,0,0
13775,2020-03-23T00:00:00Z,MC,Monaco,EURO,73,91,0,0
13776,2020-03-24T00:00:00Z,MC,Monaco,EURO,0,91,0,0
13777,2020-03-25T00:00:00Z,MC,Monaco,EURO,0,91,0,0
13778,2020-03-26T00:00:00Z,MC,Monaco,EURO,0,91,0,0
13779,2020-03-27T00:00:00Z,MC,Monaco,EURO,0,91,0,0
13780,2020-03-28T00:00:00Z,MC,Monaco,EURO,0,91,0,0
13781,2020-03-29T00:00:00Z,MC,Monaco,EURO,0,91,0,0
13782,2020-03-30T00:00:00Z,MC,Monaco,EURO,-60,31,0,0
13783,2020-03-31T00:00:00Z,MC,Monaco,EURO,3,34,0,0
13784,2020-04-01T00:00:00Z,MC,Monaco,EURO,3,37,0,0
13785,2020-04-02T00:00:00Z,MC,Monaco,EURO,0,37,0,0
13786,2020-04-03T00:00:00Z,MC,Monaco,EURO,0,37,0,0
13787,2020-04-04T00:00:00Z,MC,Monaco,EURO,0,37,0,0
13788,2020-04-05T00:00:00Z,MC,Monaco,EURO,0,37,0,0
13789,2020-04-06T00:00:00Z,MC,Monaco,EURO,0,37,0,0
13790,2020-04-07T00:00:00Z,MC,Monaco,EURO,3,40,0,0
13791,2020-04-08T00:00:00Z,MC,Monaco,EURO,0,40,0,0
13792,2020-04-09T00:00:00Z,MC,Monaco,EURO,14,54,0,0
13793,2020-04-10T00:00:00Z,MC,Monaco,EURO,0,54,0,0
13794,2020-04-11T00:00:00Z,MC,Monaco,EURO,0,54,0,0
13795,2020-04-12T00:00:00Z,MC,Monaco,EURO,0,54,0,0
13796,2020-04-13T00:00:00Z,MC,Monaco,EURO,0,54,0,0
13797,2020-04-14T00:00:00Z,MC,Monaco,EURO,14,68,0,0
13798,2020-04-15T00:00:00Z,MC,Monaco,EURO,0,68,0,0
13799,2020-04-16T00:00:00Z,MC,Monaco,EURO,0,68,0,0
13800,2020-04-17T00:00:00Z,MC,Monaco,EURO,0,68,1,1
13801,2020-04-18T00:00:00Z,MC,Monaco,EURO,0,68,0,1
13802,2020-04-19T00:00:00Z,MC,Monaco,EURO,0,68,0,1
13803,2020-04-20T00:00:00Z,MC,Monaco,EURO,0,68,0,1
13804,2020-04-21T00:00:00Z,MC,Monaco,EURO,0,68,0,1
13805,2020-04-22T00:00:00Z,MC,Monaco,EURO,0,68,0,1
13806,2020-04-23T00:00:00Z,MC,Monaco,EURO,0,68,0,1
13807,2020-04-24T00:00:00Z,MC,Monaco,EURO,0,68,0,1
13808,2020-04-25T00:00:00Z,MC,Monaco,EURO,0,68,0,1
13809,2020-04-26T00:00:00Z,MC,Monaco,EURO,0,68,0,1
13810,2020-04-27T00:00:00Z,MC,Monaco,EURO,0,68,0,1
13811,2020-04-28T00:00:00Z,MC,Monaco,EURO,0,68,0,1
13812,2020-04-29T00:00:00Z,MC,Monaco,EURO,0,68,0,1
13813,2020-04-30T00:00:00Z,MC,Monaco,EURO,0,68,0,1
13814,2020-05-01T00:00:00Z,MC,Monaco,EURO,0,68,0,1
13815,2020-05-02T00:00:00Z,MC,Monaco,EURO,0,68,0,1
13816,2020-05-03T00:00:00Z,MC,Monaco,EURO,0,68,0,1
13817,2020-05-04T00:00:00Z,MC,Monaco,EURO,27,95,0,1
13818,2020-05-05T00:00:00Z,MC,Monaco,EURO,0,95,0,1
13819,2020-05-06T00:00:00Z,MC,Monaco,EURO,0,95,0,1
13820,2020-05-07T00:00:00Z,MC,Monaco,EURO,0,95,0,1
13821,2020-05-08T00:00:00Z,MC,Monaco,EURO,0,95,0,1
13822,2020-05-09T00:00:00Z,MC,Monaco,EURO,0,95,0,1
13823,2020-05-10T00:00:00Z,MC,Monaco,EURO,0,95,0,1
13824,2020-05-11T00:00:00Z,MC,Monaco,EURO,1,96,0,1
13825,2020-05-12T00:00:00Z,MC,Monaco,EURO,0,96,0,1
13826,2020-05-13T00:00:00Z,MC,Monaco,EURO,0,96,0,1
13827,2020-05-14T00:00:00Z,MC,Monaco,EURO,0,96,0,1
13828,2020-05-15T00:00:00Z,MC,Monaco,EURO,0,96,0,1
13829,2020-05-16T00:00:00Z,MC,Monaco,EURO,0,96,0,1
13830,2020-05-17T00:00:00Z,MC,Monaco,EURO,0,96,0,1
13831,2020-05-18T00:00:00Z,MC,Monaco,EURO,0,96,0,1
13832,2020-05-19T00:00:00Z,MC,Monaco,EURO,0,96,0,1
13833,2020-05-20T00:00:00Z,MC,Monaco,EURO,0,96,0,1
13834,2020-05-21T00:00:00Z,MC,Monaco,EURO,0,96,0,1
13835,2020-05-22T00:00:00Z,MC,Monaco,EURO,0,96,0,1
13836,2020-05-23T00:00:00Z,MC,Monaco,EURO,0,96,0,1
13837,2020-05-24T00:00:00Z,MC,Monaco,EURO,2,98,0,1
13838,2020-05-25T00:00:00Z,MC,Monaco,EURO,0,98,0,1
13839,2020-05-26T00:00:00Z,MC,Monaco,EURO,0,98,0,1
13840,2020-05-27T00:00:00Z,MC,Monaco,EURO,0,98,0,1
13841,2020-05-28T00:00:00Z,MC,Monaco,EURO,0,98,0,1
13842,2020-05-29T00:00:00Z,MC,Monaco,EURO,0,98,0,1
13843,2020-05-30T00:00:00Z,MC,Monaco,EURO,0,98,0,1
13844,2020-05-31T00:00:00Z,MC,Monaco,EURO,0,98,0,1
13845,2020-06-01T00:00:00Z,MC,Monaco,EURO,0,98,0,1
13846,2020-06-02T00:00:00Z,MC,Monaco,EURO,0,98,0,1
13847,2020-06-03T00:00:00Z,MC,Monaco,EURO,0,98,0,1
13848,2020-06-04T00:00:00Z,MC,Monaco,EURO,0,98,0,1
13849,2020-06-05T00:00:00Z,MC,Monaco,EURO,0,98,0,1
13850,2020-06-06T00:00:00Z,MC,Monaco,EURO,0,98,0,1
13851,2020-06-07T00:00:00Z,MC,Monaco,EURO,1,99,0,1
13852,2020-06-08T00:00:00Z,MC,Monaco,EURO,0,99,0,1
13853,2020-06-09T00:00:00Z,MC,Monaco,EURO,0,99,0,1
13854,2020-06-10T00:00:00Z,MC,Monaco,EURO,0,99,0,1
13855,2020-06-11T00:00:00Z,MC,Monaco,EURO,0,99,0,1
13856,2020-06-12T00:00:00Z,MC,Monaco,EURO,0,99,0,1
13857,2020-06-13T00:00:00Z,MC,Monaco,EURO,0,99,0,1
13858,2020-06-14T00:00:00Z,MC,Monaco,EURO,0,99,0,1
13859,2020-06-15T00:00:00Z,MC,Monaco,EURO,0,99,0,1
13860,2020-06-16T00:00:00Z,MC,Monaco,EURO,0,99,0,1
13861,2020-06-17T00:00:00Z,MC,Monaco,EURO,0,99,0,1
13862,2020-06-18T00:00:00Z,MC,Monaco,EURO,0,99,0,1
13863,2020-06-19T00:00:00Z,MC,Monaco,EURO,0,99,0,1
13864,2020-06-20T00:00:00Z,MC,Monaco,EURO,0,99,0,1
13968,2020-03-17T00:00:00Z,ME,Montenegro,EURO,2,2,0,0
13969,2020-03-18T00:00:00Z,ME,Montenegro,EURO,0,2,0,0
13970,2020-03-19T00:00:00Z,ME,Montenegro,EURO,8,10,0,0
13971,2020-03-20T00:00:00Z,ME,Montenegro,EURO,4,14,0,0
13972,2020-03-21T00:00:00Z,ME,Montenegro,EURO,0,14,0,0
13973,2020-03-22T00:00:00Z,ME,Montenegro,EURO,0,14,0,0
13974,2020-03-23T00:00:00Z,ME,Montenegro,EURO,77,91,0,0
13975,2020-03-24T00:00:00Z,ME,Montenegro,EURO,-69,22,0,0
13976,2020-03-25T00:00:00Z,ME,Montenegro,EURO,7,29,0,0
13977,2020-03-26T00:00:00Z,ME,Montenegro,EURO,23,52,1,1
13978,2020-03-27T00:00:00Z,ME,Montenegro,EURO,15,67,0,1
13979,2020-03-28T00:00:00Z,ME,Montenegro,EURO,3,70,0,1
13980,2020-03-29T00:00:00Z,ME,Montenegro,EURO,12,82,0,1
13981,2020-03-30T00:00:00Z,ME,Montenegro,EURO,3,85,0,1
13982,2020-03-31T00:00:00Z,ME,Montenegro,EURO,6,91,0,1
13983,2020-04-01T00:00:00Z,ME,Montenegro,EURO,14,105,1,2
13984,2020-04-02T00:00:00Z,ME,Montenegro,EURO,15,120,0,2
13985,2020-04-03T00:00:00Z,ME,Montenegro,EURO,20,140,0,2
13986,2020-04-04T00:00:00Z,ME,Montenegro,EURO,20,160,0,2
13987,2020-04-05T00:00:00Z,ME,Montenegro,EURO,37,197,0,2
13988,2020-04-06T00:00:00Z,ME,Montenegro,EURO,6,203,0,2
13989,2020-04-07T00:00:00Z,ME,Montenegro,EURO,20,223,0,2
13990,2020-04-08T00:00:00Z,ME,Montenegro,EURO,25,248,0,2
13991,2020-04-09T00:00:00Z,ME,Montenegro,EURO,0,248,0,2
13992,2020-04-10T00:00:00Z,ME,Montenegro,EURO,4,252,0,2
13993,2020-04-11T00:00:00Z,ME,Montenegro,EURO,3,255,0,2
13994,2020-04-12T00:00:00Z,ME,Montenegro,EURO,7,262,0,2
13995,2020-04-13T00:00:00Z,ME,Montenegro,EURO,5,267,0,2
13996,2020-04-14T00:00:00Z,ME,Montenegro,EURO,7,274,2,4
13997,2020-04-15T00:00:00Z,ME,Montenegro,EURO,14,288,0,4
13998,2020-04-16T00:00:00Z,ME,Montenegro,EURO,0,288,0,4
13999,2020-04-17T00:00:00Z,ME,Montenegro,EURO,15,303,0,4
14000,2020-04-18T00:00:00Z,ME,Montenegro,EURO,2,305,1,5
14001,2020-04-19T00:00:00Z,ME,Montenegro,EURO,3,308,0,5
14002,2020-04-20T00:00:00Z,ME,Montenegro,EURO,0,308,0,5
14003,2020-04-21T00:00:00Z,ME,Montenegro,EURO,4,312,0,5
14004,2020-04-22T00:00:00Z,ME,Montenegro,EURO,1,313,0,5
14005,2020-04-23T00:00:00Z,ME,Montenegro,EURO,1,314,0,5
14006,2020-04-24T00:00:00Z,ME,Montenegro,EURO,2,316,0,5
14007,2020-04-25T00:00:00Z,ME,Montenegro,EURO,3,319,0,5
14008,2020-04-26T00:00:00Z,ME,Montenegro,EURO,0,319,1,6
14009,2020-04-27T00:00:00Z,ME,Montenegro,EURO,2,321,1,7
14010,2020-04-28T00:00:00Z,ME,Montenegro,EURO,0,321,0,7
14011,2020-04-29T00:00:00Z,ME,Montenegro,EURO,0,321,0,7
14012,2020-04-30T00:00:00Z,ME,Montenegro,EURO,1,322,0,7
14013,2020-05-01T00:00:00Z,ME,Montenegro,EURO,0,322,0,7
14014,2020-05-02T00:00:00Z,ME,Montenegro,EURO,0,322,0,7
14015,2020-05-03T00:00:00Z,ME,Montenegro,EURO,0,322,0,7
14016,2020-05-04T00:00:00Z,ME,Montenegro,EURO,0,322,1,8
14017,2020-05-05T00:00:00Z,ME,Montenegro,EURO,1,323,0,8
14018,2020-05-06T00:00:00Z,ME,Montenegro,EURO,1,324,0,8
14019,2020-05-07T00:00:00Z,ME,Montenegro,EURO,0,324,0,8
14020,2020-05-08T00:00:00Z,ME,Montenegro,EURO,0,324,0,8
14021,2020-05-09T00:00:00Z,ME,Montenegro,EURO,0,324,0,8
14022,2020-05-10T00:00:00Z,ME,Montenegro,EURO,0,324,0,8
14023,2020-05-11T00:00:00Z,ME,Montenegro,EURO,0,324,1,9
14024,2020-05-12T00:00:00Z,ME,Montenegro,EURO,0,324,0,9
14025,2020-05-13T00:00:00Z,ME,Montenegro,EURO,0,324,0,9
14026,2020-05-14T00:00:00Z,ME,Montenegro,EURO,0,324,0,9
14027,2020-05-15T00:00:00Z,ME,Montenegro,EURO,0,324,0,9
14028,2020-05-16T00:00:00Z,ME,Montenegro,EURO,0,324,0,9
14029,2020-05-17T00:00:00Z,ME,Montenegro,EURO,0,324,0,9
14030,2020-05-18T00:00:00Z,ME,Montenegro,EURO,0,324,0,9
14031,2020-05-19T00:00:00Z,ME,Montenegro,EURO,0,324,0,9
14032,2020-05-20T00:00:00Z,ME,Montenegro,EURO,0,324,0,9
14033,2020-05-21T00:00:00Z,ME,Montenegro,EURO,0,324,0,9
14034,2020-05-22T00:00:00Z,ME,Montenegro,EURO,0,324,0,9
14035,2020-05-23T00:00:00Z,ME,Montenegro,EURO,0,324,0,9
14036,2020-05-24T00:00:00Z,ME,Montenegro,EURO,0,324,0,9
14037,2020-05-25T00:00:00Z,ME,Montenegro,EURO,0,324,0,9
14038,2020-05-26T00:00:00Z,ME,Montenegro,EURO,0,324,0,9
14039,2020-05-27T00:00:00Z,ME,Montenegro,EURO,0,324,0,9
14040,2020-05-28T00:00:00Z,ME,Montenegro,EURO,0,324,0,9
14041,2020-05-29T00:00:00Z,ME,Montenegro,EURO,0,324,0,9
14042,2020-05-30T00:00:00Z,ME,Montenegro,EURO,0,324,0,9
14043,2020-05-31T00:00:00Z,ME,Montenegro,EURO,0,324,0,9
14044,2020-06-01T00:00:00Z,ME,Montenegro,EURO,0,324,0,9
14045,2020-06-02T00:00:00Z,ME,Montenegro,EURO,0,324,0,9
14046,2020-06-03T00:00:00Z,ME,Montenegro,EURO,0,324,0,9
14047,2020-06-04T00:00:00Z,ME,Montenegro,EURO,0,324,0,9
14048,2020-06-05T00:00:00Z,ME,Montenegro,EURO,0,324,0,9
14049,2020-06-06T00:00:00Z,ME,Montenegro,EURO,0,324,0,9
14050,2020-06-07T00:00:00Z,ME,Montenegro,EURO,0,324,0,9
14051,2020-06-08T00:00:00Z,ME,Montenegro,EURO,0,324,0,9
14052,2020-06-09T00:00:00Z,ME,Montenegro,EURO,0,324,0,9
14053,2020-06-10T00:00:00Z,ME,Montenegro,EURO,0,324,0,9
14054,2020-06-11T00:00:00Z,ME,Montenegro,EURO,0,324,0,9
14055,2020-06-12T00:00:00Z,ME,Montenegro,EURO,0,324,0,9
14056,2020-06-13T00:00:00Z,ME,Montenegro,EURO,0,324,0,9
14057,2020-06-14T00:00:00Z,ME,Montenegro,EURO,0,324,0,9
14058,2020-06-15T00:00:00Z,ME,Montenegro,EURO,1,325,0,9
14059,2020-06-16T00:00:00Z,ME,Montenegro,EURO,1,326,0,9
14060,2020-06-17T00:00:00Z,ME,Montenegro,EURO,0,326,0,9
14061,2020-06-18T00:00:00Z,ME,Montenegro,EURO,7,333,0,9
14062,2020-06-19T00:00:00Z,ME,Montenegro,EURO,4,337,0,9
14063,2020-06-20T00:00:00Z,ME,Montenegro,EURO,18,355,0,9
14698,2020-02-27T00:00:00Z,NL,Netherlands,EURO,1,1,0,0
14699,2020-02-28T00:00:00Z,NL,Netherlands,EURO,1,2,0,0
14700,2020-02-29T00:00:00Z,NL,Netherlands,EURO,4,6,0,0
14701,2020-03-01T00:00:00Z,NL,Netherlands,EURO,7,13,0,0
14702,2020-03-02T00:00:00Z,NL,Netherlands,EURO,5,18,0,0
14703,2020-03-03T00:00:00Z,NL,Netherlands,EURO,10,28,0,0
14704,2020-03-04T00:00:00Z,NL,Netherlands,EURO,10,38,0,0
14705,2020-03-05T00:00:00Z,NL,Netherlands,EURO,44,82,0,0
14706,2020-03-06T00:00:00Z,NL,Netherlands,EURO,46,128,1,1
14707,2020-03-07T00:00:00Z,NL,Netherlands,EURO,60,188,0,1
14708,2020-03-08T00:00:00Z,NL,Netherlands,EURO,77,265,2,3
14709,2020-03-09T00:00:00Z,NL,Netherlands,EURO,0,265,0,3
14710,2020-03-10T00:00:00Z,NL,Netherlands,EURO,117,382,1,4
14711,2020-03-11T00:00:00Z,NL,Netherlands,EURO,121,503,1,5
14712,2020-03-12T00:00:00Z,NL,Netherlands,EURO,111,614,0,5
14713,2020-03-13T00:00:00Z,NL,Netherlands,EURO,190,804,5,10
14714,2020-03-14T00:00:00Z,NL,Netherlands,EURO,155,959,2,12
14715,2020-03-15T00:00:00Z,NL,Netherlands,EURO,176,1135,8,20
14716,2020-03-16T00:00:00Z,NL,Netherlands,EURO,278,1413,4,24
14717,2020-03-17T00:00:00Z,NL,Netherlands,EURO,638,2051,34,58
14718,2020-03-18T00:00:00Z,NL,Netherlands,EURO,0,2051,0,58
14719,2020-03-19T00:00:00Z,NL,Netherlands,EURO,409,2460,18,76
14720,2020-03-20T00:00:00Z,NL,Netherlands,EURO,534,2994,30,106
14721,2020-03-21T00:00:00Z,NL,Netherlands,EURO,637,3631,30,136
14722,2020-03-22T00:00:00Z,NL,Netherlands,EURO,0,3631,0,136
14723,2020-03-23T00:00:00Z,NL,Netherlands,EURO,-3525,106,43,179
14724,2020-03-24T00:00:00Z,NL,Netherlands,EURO,4643,4749,34,213
14725,2020-03-25T00:00:00Z,NL,Netherlands,EURO,811,5560,63,276
14726,2020-03-26T00:00:00Z,NL,Netherlands,EURO,852,6412,80,356
14727,2020-03-27T00:00:00Z,NL,Netherlands,EURO,1019,7431,78,434
14728,2020-03-28T00:00:00Z,NL,Netherlands,EURO,1172,8603,112,546
14729,2020-03-29T00:00:00Z,NL,Netherlands,EURO,1159,9762,93,639
14730,2020-03-30T00:00:00Z,NL,Netherlands,EURO,1104,10866,132,771
14731,2020-03-31T00:00:00Z,NL,Netherlands,EURO,884,11750,93,864
14732,2020-04-01T00:00:00Z,NL,Netherlands,EURO,845,12595,175,1039
14733,2020-04-02T00:00:00Z,NL,Netherlands,EURO,1019,13614,134,1173
14734,2020-04-03T00:00:00Z,NL,Netherlands,EURO,1083,14697,166,1339
14735,2020-04-04T00:00:00Z,NL,Netherlands,EURO,1026,15723,148,1487
14736,2020-04-05T00:00:00Z,NL,Netherlands,EURO,904,16627,164,1651
14737,2020-04-06T00:00:00Z,NL,Netherlands,EURO,1224,17851,115,1766
14738,2020-04-07T00:00:00Z,NL,Netherlands,EURO,952,18803,101,1867
14739,2020-04-08T00:00:00Z,NL,Netherlands,EURO,777,19580,234,2101
14740,2020-04-09T00:00:00Z,NL,Netherlands,EURO,969,20549,147,2248
14741,2020-04-10T00:00:00Z,NL,Netherlands,EURO,1213,21762,148,2396
14742,2020-04-11T00:00:00Z,NL,Netherlands,EURO,1335,23097,115,2511
14743,2020-04-12T00:00:00Z,NL,Netherlands,EURO,1316,24413,132,2643
14744,2020-04-13T00:00:00Z,NL,Netherlands,EURO,1174,25587,94,2737
14745,2020-04-14T00:00:00Z,NL,Netherlands,EURO,964,26551,86,2823
14746,2020-04-15T00:00:00Z,NL,Netherlands,EURO,868,27419,122,2945
14747,2020-04-16T00:00:00Z,NL,Netherlands,EURO,734,28153,189,3134
14748,2020-04-17T00:00:00Z,NL,Netherlands,EURO,1061,29214,181,3315
14749,2020-04-18T00:00:00Z,NL,Netherlands,EURO,1235,30449,144,3459
14750,2020-04-19T00:00:00Z,NL,Netherlands,EURO,1140,31589,142,3601
14751,2020-04-20T00:00:00Z,NL,Netherlands,EURO,1066,32655,83,3684
14752,2020-04-21T00:00:00Z,NL,Netherlands,EURO,750,33405,67,3751
14753,2020-04-22T00:00:00Z,NL,Netherlands,EURO,729,34134,165,3916
14754,2020-04-23T00:00:00Z,NL,Netherlands,EURO,708,34842,138,4054
14755,2020-04-24T00:00:00Z,NL,Netherlands,EURO,887,35729,123,4177
14756,2020-04-25T00:00:00Z,NL,Netherlands,EURO,806,36535,112,4289
14757,2020-04-26T00:00:00Z,NL,Netherlands,EURO,655,37190,120,4409
14758,2020-04-27T00:00:00Z,NL,Netherlands,EURO,655,37845,66,4475
14759,2020-04-28T00:00:00Z,NL,Netherlands,EURO,400,38245,43,4518
14760,2020-04-29T00:00:00Z,NL,Netherlands,EURO,171,38416,48,4566
14761,2020-04-30T00:00:00Z,NL,Netherlands,EURO,386,38802,145,4711
14762,2020-05-01T00:00:00Z,NL,Netherlands,EURO,514,39316,84,4795
14763,2020-05-02T00:00:00Z,NL,Netherlands,EURO,475,39791,98,4893
14764,2020-05-03T00:00:00Z,NL,Netherlands,EURO,445,40236,94,4987
14765,2020-05-04T00:00:00Z,NL,Netherlands,EURO,335,40571,69,5056
14766,2020-05-05T00:00:00Z,NL,Netherlands,EURO,199,40770,26,5082
14767,2020-05-06T00:00:00Z,NL,Netherlands,EURO,317,41087,86,5168
14768,2020-05-07T00:00:00Z,NL,Netherlands,EURO,232,41319,36,5204
14769,2020-05-08T00:00:00Z,NL,Netherlands,EURO,455,41774,84,5288
14770,2020-05-09T00:00:00Z,NL,Netherlands,EURO,319,42093,71,5359
14771,2020-05-10T00:00:00Z,NL,Netherlands,EURO,289,42382,63,5422
14772,2020-05-11T00:00:00Z,NL,Netherlands,EURO,245,42627,18,5440
14773,2020-05-12T00:00:00Z,NL,Netherlands,EURO,161,42788,16,5456
14774,2020-05-13T00:00:00Z,NL,Netherlands,EURO,196,42984,54,5510
14775,2020-05-14T00:00:00Z,NL,Netherlands,EURO,227,43211,52,5562
14776,2020-05-15T00:00:00Z,NL,Netherlands,EURO,270,43481,28,5590
14777,2020-05-16T00:00:00Z,NL,Netherlands,EURO,200,43681,53,5643
14778,2020-05-17T00:00:00Z,NL,Netherlands,EURO,189,43870,27,5670
14779,2020-05-18T00:00:00Z,NL,Netherlands,EURO,125,43995,10,5680
14780,2020-05-19T00:00:00Z,NL,Netherlands,EURO,146,44141,14,5694
14781,2020-05-20T00:00:00Z,NL,Netherlands,EURO,108,44249,21,5715
14782,2020-05-21T00:00:00Z,NL,Netherlands,EURO,198,44447,33,5748
14783,2020-05-22T00:00:00Z,NL,Netherlands,EURO,253,44700,27,5775
14784,2020-05-23T00:00:00Z,NL,Netherlands,EURO,188,44888,13,5788
14785,2020-05-24T00:00:00Z,NL,Netherlands,EURO,176,45064,23,5811
14786,2020-05-25T00:00:00Z,NL,Netherlands,EURO,172,45236,11,5822
14787,2020-05-26T00:00:00Z,NL,Netherlands,EURO,209,45445,8,5830
14788,2020-05-27T00:00:00Z,NL,Netherlands,EURO,133,45578,26,5856
14789,2020-05-28T00:00:00Z,NL,Netherlands,EURO,190,45768,15,5871
14790,2020-05-29T00:00:00Z,NL,Netherlands,EURO,182,45950,32,5903
14791,2020-05-30T00:00:00Z,NL,Netherlands,EURO,176,46126,28,5931
14792,2020-05-31T00:00:00Z,NL,Netherlands,EURO,131,46257,20,5951
14793,2020-06-01T00:00:00Z,NL,Netherlands,EURO,185,46442,5,5956
14794,2020-06-02T00:00:00Z,NL,Netherlands,EURO,103,46545,6,5962
14795,2020-06-03T00:00:00Z,NL,Netherlands,EURO,102,46647,5,5967
14796,2020-06-04T00:00:00Z,NL,Netherlands,EURO,86,46733,10,5977
14797,2020-06-05T00:00:00Z,NL,Netherlands,EURO,209,46942,13,5990
14798,2020-06-06T00:00:00Z,NL,Netherlands,EURO,210,47152,15,6005
14799,2020-06-07T00:00:00Z,NL,Netherlands,EURO,183,47335,6,6011
14800,2020-06-08T00:00:00Z,NL,Netherlands,EURO,239,47574,2,6013
14801,2020-06-09T00:00:00Z,NL,Netherlands,EURO,165,47739,3,6016
14802,2020-06-10T00:00:00Z,NL,Netherlands,EURO,164,47903,15,6031
14803,2020-06-11T00:00:00Z,NL,Netherlands,EURO,184,48087,11,6042
14804,2020-06-12T00:00:00Z,NL,Netherlands,EURO,164,48251,2,6044
14805,2020-06-13T00:00:00Z,NL,Netherlands,EURO,210,48461,9,6053
14806,2020-06-14T00:00:00Z,NL,Netherlands,EURO,179,48640,4,6057
14807,2020-06-15T00:00:00Z,NL,Netherlands,EURO,143,48783,2,6059
14808,2020-06-16T00:00:00Z,NL,Netherlands,EURO,0,48783,0,6059
14809,2020-06-17T00:00:00Z,NL,Netherlands,EURO,304,49087,11,6070
14810,2020-06-18T00:00:00Z,NL,Netherlands,EURO,117,49204,4,6074
14811,2020-06-19T00:00:00Z,NL,Netherlands,EURO,115,49319,4,6078
14812,2020-06-20T00:00:00Z,NL,Netherlands,EURO,107,49426,3,6081
15323,2020-02-26T00:00:00Z,MK,North Macedonia,EURO,1,1,0,0
15324,2020-02-27T00:00:00Z,MK,North Macedonia,EURO,0,1,0,0
15325,2020-02-28T00:00:00Z,MK,North Macedonia,EURO,0,1,0,0
15326,2020-02-29T00:00:00Z,MK,North Macedonia,EURO,0,1,0,0
15327,2020-03-01T00:00:00Z,MK,North Macedonia,EURO,0,1,0,0
15328,2020-03-02T00:00:00Z,MK,North Macedonia,EURO,0,1,0,0
15329,2020-03-03T00:00:00Z,MK,North Macedonia,EURO,0,1,0,0
15330,2020-03-04T00:00:00Z,MK,North Macedonia,EURO,0,1,0,0
15331,2020-03-05T00:00:00Z,MK,North Macedonia,EURO,0,1,0,0
15332,2020-03-06T00:00:00Z,MK,North Macedonia,EURO,2,3,0,0
15333,2020-03-07T00:00:00Z,MK,North Macedonia,EURO,0,3,0,0
15334,2020-03-08T00:00:00Z,MK,North Macedonia,EURO,0,3,0,0
15335,2020-03-09T00:00:00Z,MK,North Macedonia,EURO,1,4,0,0
15336,2020-03-10T00:00:00Z,MK,North Macedonia,EURO,3,7,0,0
15337,2020-03-11T00:00:00Z,MK,North Macedonia,EURO,0,7,0,0
15338,2020-03-12T00:00:00Z,MK,North Macedonia,EURO,0,7,0,0
15339,2020-03-13T00:00:00Z,MK,North Macedonia,EURO,2,9,0,0
15340,2020-03-14T00:00:00Z,MK,North Macedonia,EURO,4,13,0,0
15341,2020-03-15T00:00:00Z,MK,North Macedonia,EURO,0,13,0,0
15342,2020-03-16T00:00:00Z,MK,North Macedonia,EURO,6,19,0,0
15343,2020-03-17T00:00:00Z,MK,North Macedonia,EURO,12,31,0,0
15344,2020-03-18T00:00:00Z,MK,North Macedonia,EURO,0,31,0,0
15345,2020-03-19T00:00:00Z,MK,North Macedonia,EURO,17,48,0,0
15346,2020-03-20T00:00:00Z,MK,North Macedonia,EURO,22,70,0,0
15347,2020-03-21T00:00:00Z,MK,North Macedonia,EURO,15,85,0,0
15348,2020-03-22T00:00:00Z,MK,North Macedonia,EURO,0,85,0,0
15349,2020-03-23T00:00:00Z,MK,North Macedonia,EURO,27,112,1,1
15350,2020-03-24T00:00:00Z,MK,North Macedonia,EURO,24,136,1,2
15351,2020-03-25T00:00:00Z,MK,North Macedonia,EURO,12,148,0,2
15352,2020-03-26T00:00:00Z,MK,North Macedonia,EURO,29,177,0,2
15353,2020-03-27T00:00:00Z,MK,North Macedonia,EURO,24,201,1,3
15354,2020-03-28T00:00:00Z,MK,North Macedonia,EURO,18,219,0,3
15355,2020-03-29T00:00:00Z,MK,North Macedonia,EURO,22,241,1,4
15356,2020-03-30T00:00:00Z,MK,North Macedonia,EURO,18,259,2,6
15357,2020-03-31T00:00:00Z,MK,North Macedonia,EURO,26,285,1,7
15358,2020-04-01T00:00:00Z,MK,North Macedonia,EURO,44,329,2,9
15359,2020-04-02T00:00:00Z,MK,North Macedonia,EURO,25,354,2,11
15360,2020-04-03T00:00:00Z,MK,North Macedonia,EURO,30,384,0,11
15361,2020-04-04T00:00:00Z,MK,North Macedonia,EURO,46,430,1,12
15362,2020-04-05T00:00:00Z,MK,North Macedonia,EURO,53,483,5,17
15363,2020-04-06T00:00:00Z,MK,North Macedonia,EURO,72,555,1,18
15364,2020-04-07T00:00:00Z,MK,North Macedonia,EURO,15,570,3,21
15365,2020-04-08T00:00:00Z,MK,North Macedonia,EURO,29,599,6,27
15366,2020-04-09T00:00:00Z,MK,North Macedonia,EURO,18,617,3,30
15367,2020-04-10T00:00:00Z,MK,North Macedonia,EURO,46,663,0,30
15368,2020-04-11T00:00:00Z,MK,North Macedonia,EURO,48,711,2,32
15369,2020-04-12T00:00:00Z,MK,North Macedonia,EURO,117,828,2,34
15370,2020-04-13T00:00:00Z,MK,North Macedonia,EURO,0,828,0,34
15371,2020-04-14T00:00:00Z,MK,North Macedonia,EURO,26,854,4,38
15372,2020-04-15T00:00:00Z,MK,North Macedonia,EURO,54,908,6,44
15373,2020-04-16T00:00:00Z,MK,North Macedonia,EURO,66,974,1,45
15374,2020-04-17T00:00:00Z,MK,North Macedonia,EURO,107,1081,1,46
15375,2020-04-18T00:00:00Z,MK,North Macedonia,EURO,36,1117,3,49
15376,2020-04-19T00:00:00Z,MK,North Macedonia,EURO,53,1170,0,49
15377,2020-04-20T00:00:00Z,MK,North Macedonia,EURO,37,1207,2,51
15378,2020-04-21T00:00:00Z,MK,North Macedonia,EURO,18,1225,3,54
15379,2020-04-22T00:00:00Z,MK,North Macedonia,EURO,6,1231,1,55
15380,2020-04-23T00:00:00Z,MK,North Macedonia,EURO,28,1259,1,56
15381,2020-04-24T00:00:00Z,MK,North Macedonia,EURO,41,1300,0,56
15382,2020-04-25T00:00:00Z,MK,North Macedonia,EURO,26,1326,1,57
15383,2020-04-26T00:00:00Z,MK,North Macedonia,EURO,41,1367,2,59
15384,2020-04-27T00:00:00Z,MK,North Macedonia,EURO,19,1386,2,61
15385,2020-04-28T00:00:00Z,MK,North Macedonia,EURO,13,1399,4,65
15386,2020-04-29T00:00:00Z,MK,North Macedonia,EURO,22,1421,6,71
15387,2020-04-30T00:00:00Z,MK,North Macedonia,EURO,21,1442,2,73
15388,2020-05-01T00:00:00Z,MK,North Macedonia,EURO,23,1465,4,77
15389,2020-05-02T00:00:00Z,MK,North Macedonia,EURO,29,1494,4,81
15390,2020-05-03T00:00:00Z,MK,North Macedonia,EURO,12,1506,1,82
15391,2020-05-04T00:00:00Z,MK,North Macedonia,EURO,5,1511,2,84
15392,2020-05-05T00:00:00Z,MK,North Macedonia,EURO,7,1518,1,85
15393,2020-05-06T00:00:00Z,MK,North Macedonia,EURO,8,1526,1,86
15394,2020-05-07T00:00:00Z,MK,North Macedonia,EURO,13,1539,2,88
15395,2020-05-08T00:00:00Z,MK,North Macedonia,EURO,33,1572,1,89
15396,2020-05-09T00:00:00Z,MK,North Macedonia,EURO,14,1586,1,90
15397,2020-05-10T00:00:00Z,MK,North Macedonia,EURO,36,1622,1,91
15398,2020-05-11T00:00:00Z,MK,North Macedonia,EURO,20,1642,0,91
15399,2020-05-12T00:00:00Z,MK,North Macedonia,EURO,22,1664,0,91
15400,2020-05-13T00:00:00Z,MK,North Macedonia,EURO,10,1674,1,92
15401,2020-05-14T00:00:00Z,MK,North Macedonia,EURO,20,1694,3,95
15402,2020-05-15T00:00:00Z,MK,North Macedonia,EURO,29,1723,0,95
15403,2020-05-16T00:00:00Z,MK,North Macedonia,EURO,17,1740,2,97
15404,2020-05-17T00:00:00Z,MK,North Macedonia,EURO,22,1762,1,98
15405,2020-05-18T00:00:00Z,MK,North Macedonia,EURO,30,1792,3,101
15406,2020-05-19T00:00:00Z,MK,North Macedonia,EURO,25,1817,3,104
15407,2020-05-20T00:00:00Z,MK,North Macedonia,EURO,22,1839,2,106
15408,2020-05-21T00:00:00Z,MK,North Macedonia,EURO,19,1858,4,110
15409,2020-05-22T00:00:00Z,MK,North Macedonia,EURO,40,1898,1,111
15410,2020-05-23T00:00:00Z,MK,North Macedonia,EURO,23,1921,1,112
15411,2020-05-24T00:00:00Z,MK,North Macedonia,EURO,20,1941,1,113
15412,2020-05-25T00:00:00Z,MK,North Macedonia,EURO,37,1978,0,113
15413,2020-05-26T00:00:00Z,MK,North Macedonia,EURO,21,1999,0,113
15414,2020-05-27T00:00:00Z,MK,North Macedonia,EURO,16,2015,3,116
15415,2020-05-28T00:00:00Z,MK,North Macedonia,EURO,25,2040,3,119
15416,2020-05-29T00:00:00Z,MK,North Macedonia,EURO,38,2078,3,122
15417,2020-05-30T00:00:00Z,MK,North Macedonia,EURO,52,2130,4,126
15418,2020-05-31T00:00:00Z,MK,North Macedonia,EURO,34,2164,5,131
15419,2020-06-01T00:00:00Z,MK,North Macedonia,EURO,62,2226,2,133
15420,2020-06-02T00:00:00Z,MK,North Macedonia,EURO,89,2315,7,140
15421,2020-06-03T00:00:00Z,MK,North Macedonia,EURO,76,2391,1,141
15422,2020-06-04T00:00:00Z,MK,North Macedonia,EURO,101,2492,4,145
15423,2020-06-05T00:00:00Z,MK,North Macedonia,EURO,120,2612,2,147
15424,2020-06-06T00:00:00Z,MK,North Macedonia,EURO,180,2792,2,149
15425,2020-06-07T00:00:00Z,MK,North Macedonia,EURO,123,2915,2,151
15426,2020-06-08T00:00:00Z,MK,North Macedonia,EURO,113,3028,2,153
15427,2020-06-09T00:00:00Z,MK,North Macedonia,EURO,127,3155,3,156
15428,2020-06-10T00:00:00Z,MK,North Macedonia,EURO,87,3242,1,157
15429,2020-06-11T00:00:00Z,MK,North Macedonia,EURO,125,3367,7,164
15430,2020-06-12T00:00:00Z,MK,North Macedonia,EURO,175,3542,5,169
15431,2020-06-13T00:00:00Z,MK,North Macedonia,EURO,164,3706,2,171
15432,2020-06-14T00:00:00Z,MK,North Macedonia,EURO,196,3902,8,179
15433,2020-06-15T00:00:00Z,MK,North Macedonia,EURO,155,4057,9,188
15434,2020-06-16T00:00:00Z,MK,North Macedonia,EURO,100,4157,5,193
15435,2020-06-17T00:00:00Z,MK,North Macedonia,EURO,132,4289,8,201
15436,2020-06-18T00:00:00Z,MK,North Macedonia,EURO,193,4482,9,210
15437,2020-06-19T00:00:00Z,MK,North Macedonia,EURO,182,4664,6,216
15438,2020-06-20T00:00:00Z,MK,North Macedonia,EURO,156,4820,6,222
15523,2020-02-26T00:00:00Z,NO,Norway,EURO,1,1,0,0
15524,2020-02-27T00:00:00Z,NO,Norway,EURO,3,4,0,0
15525,2020-02-28T00:00:00Z,NO,Norway,EURO,2,6,0,0
15526,2020-02-29T00:00:00Z,NO,Norway,EURO,1,7,0,0
15527,2020-03-01T00:00:00Z,NO,Norway,EURO,12,19,0,0
15528,2020-03-02T00:00:00Z,NO,Norway,EURO,6,25,0,0
15529,2020-03-03T00:00:00Z,NO,Norway,EURO,8,33,0,0
15530,2020-03-04T00:00:00Z,NO,Norway,EURO,0,33,0,0
15531,2020-03-05T00:00:00Z,NO,Norway,EURO,23,56,0,0
15532,2020-03-06T00:00:00Z,NO,Norway,EURO,57,113,0,0
15533,2020-03-07T00:00:00Z,NO,Norway,EURO,34,147,0,0
15534,2020-03-08T00:00:00Z,NO,Norway,EURO,22,169,0,0
15535,2020-03-09T00:00:00Z,NO,Norway,EURO,23,192,0,0
15536,2020-03-10T00:00:00Z,NO,Norway,EURO,85,277,0,0
15537,2020-03-11T00:00:00Z,NO,Norway,EURO,0,277,0,0
15538,2020-03-12T00:00:00Z,NO,Norway,EURO,0,277,0,0
15539,2020-03-13T00:00:00Z,NO,Norway,EURO,473,750,1,1
15540,2020-03-14T00:00:00Z,NO,Norway,EURO,157,907,0,1
15541,2020-03-15T00:00:00Z,NO,Norway,EURO,170,1077,0,1
15542,2020-03-16T00:00:00Z,NO,Norway,EURO,92,1169,2,3
15543,2020-03-17T00:00:00Z,NO,Norway,EURO,139,1308,0,3
15544,2020-03-18T00:00:00Z,NO,Norway,EURO,115,1423,0,3
15545,2020-03-19T00:00:00Z,NO,Norway,EURO,129,1552,3,6
15546,2020-03-20T00:00:00Z,NO,Norway,EURO,190,1742,1,7
15547,2020-03-21T00:00:00Z,NO,Norway,EURO,184,1926,0,7
15548,2020-03-22T00:00:00Z,NO,Norway,EURO,0,1926,0,7
15549,2020-03-23T00:00:00Z,NO,Norway,EURO,-1801,125,0,7
15550,2020-03-24T00:00:00Z,NO,Norway,EURO,2246,2371,1,8
15551,2020-03-25T00:00:00Z,NO,Norway,EURO,195,2566,2,10
15552,2020-03-26T00:00:00Z,NO,Norway,EURO,350,2916,2,12
15553,2020-03-27T00:00:00Z,NO,Norway,EURO,240,3156,2,14
15554,2020-03-28T00:00:00Z,NO,Norway,EURO,425,3581,2,16
15555,2020-03-29T00:00:00Z,NO,Norway,EURO,264,3845,4,20
15556,2020-03-30T00:00:00Z,NO,Norway,EURO,257,4102,2,22
15557,2020-03-31T00:00:00Z,NO,Norway,EURO,124,4226,4,26
15558,2020-04-01T00:00:00Z,NO,Norway,EURO,221,4447,2,28
15559,2020-04-02T00:00:00Z,NO,Norway,EURO,218,4665,4,32
15560,2020-04-03T00:00:00Z,NO,Norway,EURO,270,4935,10,42
15561,2020-04-04T00:00:00Z,NO,Norway,EURO,273,5208,2,44
15562,2020-04-05T00:00:00Z,NO,Norway,EURO,302,5510,6,50
15563,2020-04-06T00:00:00Z,NO,Norway,EURO,130,5640,8,58
15564,2020-04-07T00:00:00Z,NO,Norway,EURO,115,5755,1,59
15565,2020-04-08T00:00:00Z,NO,Norway,EURO,108,5863,10,69
15566,2020-04-09T00:00:00Z,NO,Norway,EURO,147,6010,11,80
15567,2020-04-10T00:00:00Z,NO,Norway,EURO,150,6160,8,88
15568,2020-04-11T00:00:00Z,NO,Norway,EURO,84,6244,4,92
15569,2020-04-12T00:00:00Z,NO,Norway,EURO,76,6320,6,98
15570,2020-04-13T00:00:00Z,NO,Norway,EURO,95,6415,5,103
15571,2020-04-14T00:00:00Z,NO,Norway,EURO,73,6488,11,114
15572,2020-04-15T00:00:00Z,NO,Norway,EURO,78,6566,13,127
15573,2020-04-16T00:00:00Z,NO,Norway,EURO,111,6677,3,130
15574,2020-04-17T00:00:00Z,NO,Norway,EURO,114,6791,6,136
15575,2020-04-18T00:00:00Z,NO,Norway,EURO,0,6791,0,136
15576,2020-04-19T00:00:00Z,NO,Norway,EURO,193,6984,12,148
15577,2020-04-20T00:00:00Z,NO,Norway,EURO,84,7068,6,154
15578,2020-04-21T00:00:00Z,NO,Norway,EURO,45,7113,0,154
15579,2020-04-22T00:00:00Z,NO,Norway,EURO,53,7166,9,163
15580,2020-04-23T00:00:00Z,NO,Norway,EURO,84,7250,6,169
15581,2020-04-24T00:00:00Z,NO,Norway,EURO,95,7345,11,180
15582,2020-04-25T00:00:00Z,NO,Norway,EURO,63,7408,11,191
15583,2020-04-26T00:00:00Z,NO,Norway,EURO,59,7467,2,193
15584,2020-04-27T00:00:00Z,NO,Norway,EURO,38,7505,0,193
15585,2020-04-28T00:00:00Z,NO,Norway,EURO,28,7533,0,193
15586,2020-04-29T00:00:00Z,NO,Norway,EURO,72,7605,2,195
15587,2020-04-30T00:00:00Z,NO,Norway,EURO,62,7667,7,202
15588,2020-05-01T00:00:00Z,NO,Norway,EURO,43,7710,2,204
15589,2020-05-02T00:00:00Z,NO,Norway,EURO,49,7759,0,204
15590,2020-05-03T00:00:00Z,NO,Norway,EURO,0,7759,0,204
15591,2020-05-04T00:00:00Z,NO,Norway,EURO,50,7809,4,208
15592,2020-05-05T00:00:00Z,NO,Norway,EURO,38,7847,0,208
15593,2020-05-06T00:00:00Z,NO,Norway,EURO,56,7903,1,209
15594,2020-05-07T00:00:00Z,NO,Norway,EURO,50,7953,0,209
15595,2020-05-08T00:00:00Z,NO,Norway,EURO,42,7995,0,209
15596,2020-05-09T00:00:00Z,NO,Norway,EURO,39,8034,4,213
15597,2020-05-10T00:00:00Z,NO,Norway,EURO,35,8069,0,213
15598,2020-05-11T00:00:00Z,NO,Norway,EURO,30,8099,4,217
15599,2020-05-12T00:00:00Z,NO,Norway,EURO,7,8106,7,224
15600,2020-05-13T00:00:00Z,NO,Norway,EURO,29,8135,4,228
15601,2020-05-14T00:00:00Z,NO,Norway,EURO,23,8158,1,229
15602,2020-05-15T00:00:00Z,NO,Norway,EURO,17,8175,3,232
15603,2020-05-16T00:00:00Z,NO,Norway,EURO,22,8197,0,232
15604,2020-05-17T00:00:00Z,NO,Norway,EURO,0,8197,0,232
15605,2020-05-18T00:00:00Z,NO,Norway,EURO,0,8197,0,232
15606,2020-05-19T00:00:00Z,NO,Norway,EURO,52,8249,1,233
15607,2020-05-20T00:00:00Z,NO,Norway,EURO,8,8257,0,233
15608,2020-05-21T00:00:00Z,NO,Norway,EURO,11,8268,1,234
15609,2020-05-22T00:00:00Z,NO,Norway,EURO,0,8268,0,234
15610,2020-05-23T00:00:00Z,NO,Norway,EURO,41,8309,1,235
15611,2020-05-24T00:00:00Z,NO,Norway,EURO,0,8309,0,235
15612,2020-05-25T00:00:00Z,NO,Norway,EURO,0,8309,0,235
15613,2020-05-26T00:00:00Z,NO,Norway,EURO,43,8352,0,235
15614,2020-05-27T00:00:00Z,NO,Norway,EURO,12,8364,0,235
15615,2020-05-28T00:00:00Z,NO,Norway,EURO,19,8383,0,235
15616,2020-05-29T00:00:00Z,NO,Norway,EURO,18,8401,1,236
15617,2020-05-30T00:00:00Z,NO,Norway,EURO,10,8411,0,236
15618,2020-05-31T00:00:00Z,NO,Norway,EURO,0,8411,0,236
15619,2020-06-01T00:00:00Z,NO,Norway,EURO,0,8411,0,236
15620,2020-06-02T00:00:00Z,NO,Norway,EURO,0,8411,0,236
15621,2020-06-03T00:00:00Z,NO,Norway,EURO,35,8446,1,237
15622,2020-06-04T00:00:00Z,NO,Norway,EURO,0,8446,0,237
15623,2020-06-05T00:00:00Z,NO,Norway,EURO,31,8477,1,238
15624,2020-06-06T00:00:00Z,NO,Norway,EURO,27,8504,0,238
15625,2020-06-07T00:00:00Z,NO,Norway,EURO,0,8504,0,238
15626,2020-06-08T00:00:00Z,NO,Norway,EURO,0,8504,0,238
15627,2020-06-09T00:00:00Z,NO,Norway,EURO,43,8547,1,239
15628,2020-06-10T00:00:00Z,NO,Norway,EURO,16,8563,0,239
15629,2020-06-11T00:00:00Z,NO,Norway,EURO,13,8576,0,239
15630,2020-06-12T00:00:00Z,NO,Norway,EURO,18,8594,3,242
15631,2020-06-13T00:00:00Z,NO,Norway,EURO,12,8606,0,242
15632,2020-06-14T00:00:00Z,NO,Norway,EURO,0,8606,0,242
15633,2020-06-15T00:00:00Z,NO,Norway,EURO,0,8606,0,242
15634,2020-06-16T00:00:00Z,NO,Norway,EURO,25,8631,0,242
15635,2020-06-17T00:00:00Z,NO,Norway,EURO,0,8631,0,242
15636,2020-06-18T00:00:00Z,NO,Norway,EURO,29,8660,1,243
15637,2020-06-19T00:00:00Z,NO,Norway,EURO,32,8692,1,244
15638,2020-06-20T00:00:00Z,NO,Norway,EURO,0,8692,0,244
16668,2020-03-05T00:00:00Z,PL,Poland,EURO,1,1,0,0
16669,2020-03-06T00:00:00Z,PL,Poland,EURO,4,5,0,0
16670,2020-03-07T00:00:00Z,PL,Poland,EURO,1,6,0,0
16671,2020-03-08T00:00:00Z,PL,Poland,EURO,5,11,0,0
16672,2020-03-09T00:00:00Z,PL,Poland,EURO,5,16,0,0
16673,2020-03-10T00:00:00Z,PL,Poland,EURO,6,22,0,0
16674,2020-03-11T00:00:00Z,PL,Poland,EURO,5,27,0,0
16675,2020-03-12T00:00:00Z,PL,Poland,EURO,24,51,1,1
16676,2020-03-13T00:00:00Z,PL,Poland,EURO,13,64,0,1
16677,2020-03-14T00:00:00Z,PL,Poland,EURO,0,64,0,1
16678,2020-03-15T00:00:00Z,PL,Poland,EURO,47,111,2,3
16679,2020-03-16T00:00:00Z,PL,Poland,EURO,39,150,0,3
16680,2020-03-17T00:00:00Z,PL,Poland,EURO,96,246,2,5
16681,2020-03-18T00:00:00Z,PL,Poland,EURO,41,287,0,5
16682,2020-03-19T00:00:00Z,PL,Poland,EURO,38,325,0,5
16683,2020-03-20T00:00:00Z,PL,Poland,EURO,100,425,0,5
16684,2020-03-21T00:00:00Z,PL,Poland,EURO,111,536,0,5
16685,2020-03-22T00:00:00Z,PL,Poland,EURO,0,536,0,5
16686,2020-03-23T00:00:00Z,PL,Poland,EURO,98,634,2,7
16687,2020-03-24T00:00:00Z,PL,Poland,EURO,115,749,1,8
16688,2020-03-25T00:00:00Z,PL,Poland,EURO,152,901,2,10
16689,2020-03-26T00:00:00Z,PL,Poland,EURO,150,1051,4,14
16690,2020-03-27T00:00:00Z,PL,Poland,EURO,170,1221,2,16
16691,2020-03-28T00:00:00Z,PL,Poland,EURO,168,1389,0,16
16692,2020-03-29T00:00:00Z,PL,Poland,EURO,249,1638,2,18
16693,2020-03-30T00:00:00Z,PL,Poland,EURO,224,1862,4,22
16694,2020-03-31T00:00:00Z,PL,Poland,EURO,193,2055,9,31
16695,2020-04-01T00:00:00Z,PL,Poland,EURO,256,2311,2,33
16696,2020-04-02T00:00:00Z,PL,Poland,EURO,243,2554,10,43
16697,2020-04-03T00:00:00Z,PL,Poland,EURO,392,2946,14,57
16698,2020-04-04T00:00:00Z,PL,Poland,EURO,437,3383,14,71
16699,2020-04-05T00:00:00Z,PL,Poland,EURO,244,3627,8,79
16700,2020-04-06T00:00:00Z,PL,Poland,EURO,475,4102,15,94
16701,2020-04-07T00:00:00Z,PL,Poland,EURO,311,4413,13,107
16702,2020-04-08T00:00:00Z,PL,Poland,EURO,435,4848,22,129
16703,2020-04-09T00:00:00Z,PL,Poland,EURO,357,5205,30,159
16704,2020-04-10T00:00:00Z,PL,Poland,EURO,370,5575,15,174
16705,2020-04-11T00:00:00Z,PL,Poland,EURO,380,5955,7,181
16706,2020-04-12T00:00:00Z,PL,Poland,EURO,401,6356,27,208
16707,2020-04-13T00:00:00Z,PL,Poland,EURO,318,6674,24,232
16708,2020-04-14T00:00:00Z,PL,Poland,EURO,260,6934,13,245
16709,2020-04-15T00:00:00Z,PL,Poland,EURO,268,7202,18,263
16710,2020-04-16T00:00:00Z,PL,Poland,EURO,380,7582,23,286
16711,2020-04-17T00:00:00Z,PL,Poland,EURO,336,7918,28,314
16712,2020-04-18T00:00:00Z,PL,Poland,EURO,461,8379,18,332
16713,2020-04-19T00:00:00Z,PL,Poland,EURO,363,8742,15,347
16714,2020-04-20T00:00:00Z,PL,Poland,EURO,545,9287,13,360
16715,2020-04-21T00:00:00Z,PL,Poland,EURO,306,9593,20,380
16716,2020-04-22T00:00:00Z,PL,Poland,EURO,263,9856,21,401
16717,2020-04-23T00:00:00Z,PL,Poland,EURO,313,10169,25,426
16718,2020-04-24T00:00:00Z,PL,Poland,EURO,342,10511,28,454
16719,2020-04-25T00:00:00Z,PL,Poland,EURO,381,10892,40,494
16720,2020-04-26T00:00:00Z,PL,Poland,EURO,381,11273,30,524
16721,2020-04-27T00:00:00Z,PL,Poland,EURO,344,11617,11,535
16722,2020-04-28T00:00:00Z,PL,Poland,EURO,285,11902,27,562
16723,2020-04-29T00:00:00Z,PL,Poland,EURO,316,12218,34,596
16724,2020-04-30T00:00:00Z,PL,Poland,EURO,422,12640,28,624
16725,2020-05-01T00:00:00Z,PL,Poland,EURO,237,12877,20,644
16726,2020-05-02T00:00:00Z,PL,Poland,EURO,228,13105,7,651
16727,2020-05-03T00:00:00Z,PL,Poland,EURO,270,13375,13,664
16728,2020-05-04T00:00:00Z,PL,Poland,EURO,318,13693,14,678
16729,2020-05-05T00:00:00Z,PL,Poland,EURO,313,14006,20,698
16730,2020-05-06T00:00:00Z,PL,Poland,EURO,425,14431,18,716
16731,2020-05-07T00:00:00Z,PL,Poland,EURO,309,14740,17,733
16732,2020-05-08T00:00:00Z,PL,Poland,EURO,307,15047,22,755
16733,2020-05-09T00:00:00Z,PL,Poland,EURO,319,15366,21,776
16734,2020-05-10T00:00:00Z,PL,Poland,EURO,285,15651,9,785
16735,2020-05-11T00:00:00Z,PL,Poland,EURO,345,15996,15,800
16736,2020-05-12T00:00:00Z,PL,Poland,EURO,330,16326,11,811
16737,2020-05-13T00:00:00Z,PL,Poland,EURO,595,16921,28,839
16738,2020-05-14T00:00:00Z,PL,Poland,EURO,283,17204,22,861
16739,2020-05-15T00:00:00Z,PL,Poland,EURO,411,17615,22,883
16740,2020-05-16T00:00:00Z,PL,Poland,EURO,401,18016,24,907
16741,2020-05-17T00:00:00Z,PL,Poland,EURO,241,18257,8,915
16742,2020-05-18T00:00:00Z,PL,Poland,EURO,272,18529,10,925
16743,2020-05-19T00:00:00Z,PL,Poland,EURO,356,18885,11,936
16744,2020-05-20T00:00:00Z,PL,Poland,EURO,383,19268,12,948
16745,2020-05-21T00:00:00Z,PL,Poland,EURO,471,19739,14,962
16746,2020-05-22T00:00:00Z,PL,Poland,EURO,404,20143,10,972
16747,2020-05-23T00:00:00Z,PL,Poland,EURO,476,20619,10,982
16748,2020-05-24T00:00:00Z,PL,Poland,EURO,312,20931,11,993
16749,2020-05-25T00:00:00Z,PL,Poland,EURO,395,21326,3,996
16750,2020-05-26T00:00:00Z,PL,Poland,EURO,305,21631,11,1007
16751,2020-05-27T00:00:00Z,PL,Poland,EURO,443,22074,17,1024
16752,2020-05-28T00:00:00Z,PL,Poland,EURO,399,22473,4,1028
16753,2020-05-29T00:00:00Z,PL,Poland,EURO,352,22825,10,1038
16754,2020-05-30T00:00:00Z,PL,Poland,EURO,330,23155,13,1051
16755,2020-05-31T00:00:00Z,PL,Poland,EURO,416,23571,10,1061
16756,2020-06-01T00:00:00Z,PL,Poland,EURO,215,23786,3,1064
16757,2020-06-02T00:00:00Z,PL,Poland,EURO,379,24165,10,1074
16758,2020-06-03T00:00:00Z,PL,Poland,EURO,230,24395,18,1092
16759,2020-06-04T00:00:00Z,PL,Poland,EURO,0,24395,0,1092
16760,2020-06-05T00:00:00Z,PL,Poland,EURO,653,25048,25,1117
16761,2020-06-06T00:00:00Z,PL,Poland,EURO,371,25419,20,1137
16762,2020-06-07T00:00:00Z,PL,Poland,EURO,567,25986,16,1153
16763,2020-06-08T00:00:00Z,PL,Poland,EURO,575,26561,4,1157
16764,2020-06-09T00:00:00Z,PL,Poland,EURO,599,27160,9,1166
16765,2020-06-10T00:00:00Z,PL,Poland,EURO,400,27560,17,1183
16766,2020-06-11T00:00:00Z,PL,Poland,EURO,197,27757,23,1206
16767,2020-06-12T00:00:00Z,PL,Poland,EURO,444,28201,9,1215
16768,2020-06-13T00:00:00Z,PL,Poland,EURO,376,28577,7,1222
16769,2020-06-14T00:00:00Z,PL,Poland,EURO,440,29017,15,1237
16770,2020-06-15T00:00:00Z,PL,Poland,EURO,375,29392,10,1247
16771,2020-06-16T00:00:00Z,PL,Poland,EURO,396,29788,9,1256
16772,2020-06-17T00:00:00Z,PL,Poland,EURO,407,30195,16,1272
16773,2020-06-18T00:00:00Z,PL,Poland,EURO,506,30701,14,1286
16774,2020-06-19T00:00:00Z,PL,Poland,EURO,314,31015,30,1316
16775,2020-06-20T00:00:00Z,PL,Poland,EURO,301,31316,18,1334
16776,2020-03-02T00:00:00Z,PT,Portugal,EURO,2,2,0,0
16777,2020-03-03T00:00:00Z,PT,Portugal,EURO,0,2,0,0
16778,2020-03-04T00:00:00Z,PT,Portugal,EURO,4,6,0,0
16779,2020-03-05T00:00:00Z,PT,Portugal,EURO,3,9,0,0
16780,2020-03-06T00:00:00Z,PT,Portugal,EURO,4,13,0,0
16781,2020-03-07T00:00:00Z,PT,Portugal,EURO,0,13,0,0
16782,2020-03-08T00:00:00Z,PT,Portugal,EURO,17,30,0,0
16783,2020-03-09T00:00:00Z,PT,Portugal,EURO,0,30,0,0
16784,2020-03-10T00:00:00Z,PT,Portugal,EURO,11,41,0,0
16785,2020-03-11T00:00:00Z,PT,Portugal,EURO,0,41,0,0
16786,2020-03-12T00:00:00Z,PT,Portugal,EURO,0,41,0,0
16787,2020-03-13T00:00:00Z,PT,Portugal,EURO,71,112,0,0
16788,2020-03-14T00:00:00Z,PT,Portugal,EURO,0,112,0,0
16789,2020-03-15T00:00:00Z,PT,Portugal,EURO,133,245,0,0
16790,2020-03-16T00:00:00Z,PT,Portugal,EURO,86,331,0,0
16791,2020-03-17T00:00:00Z,PT,Portugal,EURO,117,448,1,1
16792,2020-03-18T00:00:00Z,PT,Portugal,EURO,194,642,1,2
16793,2020-03-19T00:00:00Z,PT,Portugal,EURO,143,785,1,3
16794,2020-03-20T00:00:00Z,PT,Portugal,EURO,235,1020,3,6
16795,2020-03-21T00:00:00Z,PT,Portugal,EURO,260,1280,6,12
16796,2020-03-22T00:00:00Z,PT,Portugal,EURO,0,1280,0,12
16797,2020-03-23T00:00:00Z,PT,Portugal,EURO,320,1600,2,14
16798,2020-03-24T00:00:00Z,PT,Portugal,EURO,460,2060,9,23
16799,2020-03-25T00:00:00Z,PT,Portugal,EURO,302,2362,10,33
16800,2020-03-26T00:00:00Z,PT,Portugal,EURO,633,2995,10,43
16801,2020-03-27T00:00:00Z,PT,Portugal,EURO,549,3544,17,60
16802,2020-03-28T00:00:00Z,PT,Portugal,EURO,724,4268,16,76
16803,2020-03-29T00:00:00Z,PT,Portugal,EURO,902,5170,24,100
16804,2020-03-30T00:00:00Z,PT,Portugal,EURO,792,5962,19,119
16805,2020-03-31T00:00:00Z,PT,Portugal,EURO,446,6408,21,140
16806,2020-04-01T00:00:00Z,PT,Portugal,EURO,1035,7443,20,160
16807,2020-04-02T00:00:00Z,PT,Portugal,EURO,808,8251,27,187
16808,2020-04-03T00:00:00Z,PT,Portugal,EURO,783,9034,22,209
16809,2020-04-04T00:00:00Z,PT,Portugal,EURO,852,9886,37,246
16810,2020-04-05T00:00:00Z,PT,Portugal,EURO,638,10524,20,266
16811,2020-04-06T00:00:00Z,PT,Portugal,EURO,754,11278,29,295
16812,2020-04-07T00:00:00Z,PT,Portugal,EURO,452,11730,16,311
16813,2020-04-08T00:00:00Z,PT,Portugal,EURO,712,12442,34,345
16814,2020-04-09T00:00:00Z,PT,Portugal,EURO,699,13141,35,380
16815,2020-04-10T00:00:00Z,PT,Portugal,EURO,815,13956,29,409
16816,2020-04-11T00:00:00Z,PT,Portugal,EURO,1516,15472,26,435
16817,2020-04-12T00:00:00Z,PT,Portugal,EURO,515,15987,35,470
16818,2020-04-13T00:00:00Z,PT,Portugal,EURO,598,16585,34,504
16819,2020-04-14T00:00:00Z,PT,Portugal,EURO,349,16934,31,535
16820,2020-04-15T00:00:00Z,PT,Portugal,EURO,514,17448,32,567
16821,2020-04-16T00:00:00Z,PT,Portugal,EURO,643,18091,32,599
16822,2020-04-17T00:00:00Z,PT,Portugal,EURO,750,18841,30,629
16823,2020-04-18T00:00:00Z,PT,Portugal,EURO,181,19022,28,657
16824,2020-04-19T00:00:00Z,PT,Portugal,EURO,663,19685,30,687
16825,2020-04-20T00:00:00Z,PT,Portugal,EURO,521,20206,27,714
16826,2020-04-21T00:00:00Z,PT,Portugal,EURO,657,20863,21,735
16827,2020-04-22T00:00:00Z,PT,Portugal,EURO,516,21379,27,762
16828,2020-04-23T00:00:00Z,PT,Portugal,EURO,603,21982,23,785
16829,2020-04-24T00:00:00Z,PT,Portugal,EURO,371,22353,35,820
16830,2020-04-25T00:00:00Z,PT,Portugal,EURO,444,22797,34,854
16831,2020-04-26T00:00:00Z,PT,Portugal,EURO,595,23392,26,880
16832,2020-04-27T00:00:00Z,PT,Portugal,EURO,472,23864,23,903
16833,2020-04-28T00:00:00Z,PT,Portugal,EURO,163,24027,25,928
16834,2020-04-29T00:00:00Z,PT,Portugal,EURO,295,24322,20,948
16835,2020-04-30T00:00:00Z,PT,Portugal,EURO,183,24505,25,973
16836,2020-05-01T00:00:00Z,PT,Portugal,EURO,551,25056,16,989
16837,2020-05-02T00:00:00Z,PT,Portugal,EURO,295,25351,18,1007
16838,2020-05-03T00:00:00Z,PT,Portugal,EURO,-161,25190,16,1023
16839,2020-05-04T00:00:00Z,PT,Portugal,EURO,92,25282,20,1043
16840,2020-05-05T00:00:00Z,PT,Portugal,EURO,242,25524,20,1063
16841,2020-05-06T00:00:00Z,PT,Portugal,EURO,178,25702,11,1074
16842,2020-05-07T00:00:00Z,PT,Portugal,EURO,480,26182,15,1089
16843,2020-05-08T00:00:00Z,PT,Portugal,EURO,533,26715,16,1105
16844,2020-05-09T00:00:00Z,PT,Portugal,EURO,553,27268,9,1114
16845,2020-05-10T00:00:00Z,PT,Portugal,EURO,138,27406,12,1126
16846,2020-05-11T00:00:00Z,PT,Portugal,EURO,175,27581,9,1135
16847,2020-05-12T00:00:00Z,PT,Portugal,EURO,98,27679,9,1144
16848,2020-05-13T00:00:00Z,PT,Portugal,EURO,234,27913,19,1163
16849,2020-05-14T00:00:00Z,PT,Portugal,EURO,219,28132,12,1175
16850,2020-05-15T00:00:00Z,PT,Portugal,EURO,187,28319,9,1184
16851,2020-05-16T00:00:00Z,PT,Portugal,EURO,264,28583,6,1190
16852,2020-05-17T00:00:00Z,PT,Portugal,EURO,227,28810,13,1203
16853,2020-05-18T00:00:00Z,PT,Portugal,EURO,226,29036,15,1218
16854,2020-05-19T00:00:00Z,PT,Portugal,EURO,173,29209,13,1231
16855,2020-05-20T00:00:00Z,PT,Portugal,EURO,223,29432,16,1247
16856,2020-05-21T00:00:00Z,PT,Portugal,EURO,228,29660,16,1263
16857,2020-05-22T00:00:00Z,PT,Portugal,EURO,252,29912,14,1277
16858,2020-05-23T00:00:00Z,PT,Portugal,EURO,288,30200,12,1289
16859,2020-05-24T00:00:00Z,PT,Portugal,EURO,271,30471,13,1302
16860,2020-05-25T00:00:00Z,PT,Portugal,EURO,152,30623,14,1316
16861,2020-05-26T00:00:00Z,PT,Portugal,EURO,165,30788,14,1330
16862,2020-05-27T00:00:00Z,PT,Portugal,EURO,219,31007,12,1342
16863,2020-05-28T00:00:00Z,PT,Portugal,EURO,285,31292,14,1356
16864,2020-05-29T00:00:00Z,PT,Portugal,EURO,304,31596,13,1369
16865,2020-05-30T00:00:00Z,PT,Portugal,EURO,350,31946,14,1383
16866,2020-05-31T00:00:00Z,PT,Portugal,EURO,257,32203,13,1396
16867,2020-06-01T00:00:00Z,PT,Portugal,EURO,297,32500,14,1410
16868,2020-06-02T00:00:00Z,PT,Portugal,EURO,200,32700,14,1424
16869,2020-06-03T00:00:00Z,PT,Portugal,EURO,195,32895,12,1436
16870,2020-06-04T00:00:00Z,PT,Portugal,EURO,366,33261,11,1447
16871,2020-06-05T00:00:00Z,PT,Portugal,EURO,331,33592,8,1455
16872,2020-06-06T00:00:00Z,PT,Portugal,EURO,377,33969,10,1465
16873,2020-06-07T00:00:00Z,PT,Portugal,EURO,382,34351,9,1474
16874,2020-06-08T00:00:00Z,PT,Portugal,EURO,142,34493,5,1479
16875,2020-06-09T00:00:00Z,PT,Portugal,EURO,392,34885,6,1485
16876,2020-06-10T00:00:00Z,PT,Portugal,EURO,421,35306,7,1492
16877,2020-06-11T00:00:00Z,PT,Portugal,EURO,294,35600,3,1495
16878,2020-06-12T00:00:00Z,PT,Portugal,EURO,310,35910,9,1504
16879,2020-06-13T00:00:00Z,PT,Portugal,EURO,270,36180,1,1505
16880,2020-06-14T00:00:00Z,PT,Portugal,EURO,283,36463,7,1512
16881,2020-06-15T00:00:00Z,PT,Portugal,EURO,227,36690,5,1517
16882,2020-06-16T00:00:00Z,PT,Portugal,EURO,346,37036,3,1520
16883,2020-06-17T00:00:00Z,PT,Portugal,EURO,300,37336,2,1522
16884,2020-06-18T00:00:00Z,PT,Portugal,EURO,336,37672,1,1523
16885,2020-06-19T00:00:00Z,PT,Portugal,EURO,417,38089,1,1524
16886,2020-06-20T00:00:00Z,PT,Portugal,EURO,375,38464,3,1527
17253,2020-03-07T00:00:00Z,MD,Republic of Moldova,EURO,1,1,0,0
17254,2020-03-08T00:00:00Z,MD,Republic of Moldova,EURO,0,1,0,0
17255,2020-03-09T00:00:00Z,MD,Republic of Moldova,EURO,0,1,0,0
17256,2020-03-10T00:00:00Z,MD,Republic of Moldova,EURO,2,3,0,0
17257,2020-03-11T00:00:00Z,MD,Republic of Moldova,EURO,0,3,0,0
17258,2020-03-12T00:00:00Z,MD,Republic of Moldova,EURO,1,4,0,0
17259,2020-03-13T00:00:00Z,MD,Republic of Moldova,EURO,4,8,0,0
17260,2020-03-14T00:00:00Z,MD,Republic of Moldova,EURO,4,12,0,0
17261,2020-03-15T00:00:00Z,MD,Republic of Moldova,EURO,11,23,0,0
17262,2020-03-16T00:00:00Z,MD,Republic of Moldova,EURO,6,29,0,0
17263,2020-03-17T00:00:00Z,MD,Republic of Moldova,EURO,1,30,0,0
17264,2020-03-18T00:00:00Z,MD,Republic of Moldova,EURO,6,36,0,0
17265,2020-03-19T00:00:00Z,MD,Republic of Moldova,EURO,13,49,0,0
17266,2020-03-20T00:00:00Z,MD,Republic of Moldova,EURO,17,66,1,1
17267,2020-03-21T00:00:00Z,MD,Republic of Moldova,EURO,14,80,0,1
17268,2020-03-22T00:00:00Z,MD,Republic of Moldova,EURO,0,80,0,1
17269,2020-03-23T00:00:00Z,MD,Republic of Moldova,EURO,14,94,0,1
17270,2020-03-24T00:00:00Z,MD,Republic of Moldova,EURO,15,109,0,1
17271,2020-03-25T00:00:00Z,MD,Republic of Moldova,EURO,16,125,0,1
17272,2020-03-26T00:00:00Z,MD,Republic of Moldova,EURO,24,149,0,1
17273,2020-03-27T00:00:00Z,MD,Republic of Moldova,EURO,28,177,1,2
17274,2020-03-28T00:00:00Z,MD,Republic of Moldova,EURO,22,199,0,2
17275,2020-03-29T00:00:00Z,MD,Republic of Moldova,EURO,32,231,0,2
17276,2020-03-30T00:00:00Z,MD,Republic of Moldova,EURO,32,263,0,2
17277,2020-03-31T00:00:00Z,MD,Republic of Moldova,EURO,35,298,0,2
17278,2020-04-01T00:00:00Z,MD,Republic of Moldova,EURO,55,353,1,3
17279,2020-04-02T00:00:00Z,MD,Republic of Moldova,EURO,70,423,2,5
17280,2020-04-03T00:00:00Z,MD,Republic of Moldova,EURO,168,591,3,8
17281,2020-04-04T00:00:00Z,MD,Republic of Moldova,EURO,0,591,1,9
17282,2020-04-05T00:00:00Z,MD,Republic of Moldova,EURO,161,752,3,12
17283,2020-04-06T00:00:00Z,MD,Republic of Moldova,EURO,112,864,3,15
17284,2020-04-07T00:00:00Z,MD,Republic of Moldova,EURO,101,965,4,19
17285,2020-04-08T00:00:00Z,MD,Republic of Moldova,EURO,91,1056,3,22
17286,2020-04-09T00:00:00Z,MD,Republic of Moldova,EURO,118,1174,6,28
17287,2020-04-10T00:00:00Z,MD,Republic of Moldova,EURO,115,1289,1,29
17288,2020-04-11T00:00:00Z,MD,Republic of Moldova,EURO,149,1438,0,29
17289,2020-04-12T00:00:00Z,MD,Republic of Moldova,EURO,122,1560,1,30
17290,2020-04-13T00:00:00Z,MD,Republic of Moldova,EURO,102,1662,3,33
17291,2020-04-14T00:00:00Z,MD,Republic of Moldova,EURO,50,1712,3,36
17292,2020-04-15T00:00:00Z,MD,Republic of Moldova,EURO,222,1934,5,41
17293,2020-04-16T00:00:00Z,MD,Republic of Moldova,EURO,115,2049,5,46
17294,2020-04-17T00:00:00Z,MD,Republic of Moldova,EURO,105,2154,8,54
17295,2020-04-18T00:00:00Z,MD,Republic of Moldova,EURO,110,2264,2,56
17296,2020-04-19T00:00:00Z,MD,Republic of Moldova,EURO,87,2351,4,60
17297,2020-04-20T00:00:00Z,MD,Republic of Moldova,EURO,121,2472,7,67
17298,2020-04-21T00:00:00Z,MD,Republic of Moldova,EURO,76,2548,3,70
17299,2020-04-22T00:00:00Z,MD,Republic of Moldova,EURO,93,2641,3,73
17300,2020-04-23T00:00:00Z,MD,Republic of Moldova,EURO,137,2778,3,76
17301,2020-04-24T00:00:00Z,MD,Republic of Moldova,EURO,148,2926,4,80
17302,2020-04-25T00:00:00Z,MD,Republic of Moldova,EURO,184,3110,7,87
17303,2020-04-26T00:00:00Z,MD,Republic of Moldova,EURO,194,3304,7,94
17304,2020-04-27T00:00:00Z,MD,Republic of Moldova,EURO,104,3408,2,96
17305,2020-04-28T00:00:00Z,MD,Republic of Moldova,EURO,73,3481,7,103
17306,2020-04-29T00:00:00Z,MD,Republic of Moldova,EURO,157,3638,6,109
17307,2020-04-30T00:00:00Z,MD,Republic of Moldova,EURO,133,3771,7,116
17308,2020-05-01T00:00:00Z,MD,Republic of Moldova,EURO,126,3897,3,119
17309,2020-05-02T00:00:00Z,MD,Republic of Moldova,EURO,83,3980,3,122
17310,2020-05-03T00:00:00Z,MD,Republic of Moldova,EURO,72,4052,2,124
17311,2020-05-04T00:00:00Z,MD,Republic of Moldova,EURO,69,4121,4,128
17312,2020-05-05T00:00:00Z,MD,Republic of Moldova,EURO,127,4248,5,133
17313,2020-05-06T00:00:00Z,MD,Republic of Moldova,EURO,115,4363,7,140
17314,2020-05-07T00:00:00Z,MD,Republic of Moldova,EURO,113,4476,3,143
17315,2020-05-08T00:00:00Z,MD,Republic of Moldova,EURO,129,4605,2,145
17316,2020-05-09T00:00:00Z,MD,Republic of Moldova,EURO,123,4728,14,159
17317,2020-05-10T00:00:00Z,MD,Republic of Moldova,EURO,139,4867,6,165
17318,2020-05-11T00:00:00Z,MD,Republic of Moldova,EURO,60,4927,6,171
17319,2020-05-12T00:00:00Z,MD,Republic of Moldova,EURO,68,4995,8,179
17320,2020-05-13T00:00:00Z,MD,Republic of Moldova,EURO,159,5154,3,182
17321,2020-05-14T00:00:00Z,MD,Republic of Moldova,EURO,252,5406,8,190
17322,2020-05-15T00:00:00Z,MD,Republic of Moldova,EURO,147,5553,6,196
17323,2020-05-16T00:00:00Z,MD,Republic of Moldova,EURO,192,5745,8,204
17324,2020-05-17T00:00:00Z,MD,Republic of Moldova,EURO,189,5934,5,209
17325,2020-05-18T00:00:00Z,MD,Republic of Moldova,EURO,126,6060,2,211
17326,2020-05-19T00:00:00Z,MD,Republic of Moldova,EURO,78,6138,8,219
17327,2020-05-20T00:00:00Z,MD,Republic of Moldova,EURO,202,6340,5,224
17328,2020-05-21T00:00:00Z,MD,Republic of Moldova,EURO,213,6553,8,232
17329,2020-05-22T00:00:00Z,MD,Republic of Moldova,EURO,151,6704,1,233
17330,2020-05-23T00:00:00Z,MD,Republic of Moldova,EURO,143,6847,5,238
17331,2020-05-24T00:00:00Z,MD,Republic of Moldova,EURO,147,6994,12,250
17332,2020-05-25T00:00:00Z,MD,Republic of Moldova,EURO,99,7093,6,256
17333,2020-05-26T00:00:00Z,MD,Republic of Moldova,EURO,56,7149,9,265
17334,2020-05-27T00:00:00Z,MD,Republic of Moldova,EURO,156,7305,8,273
17335,2020-05-28T00:00:00Z,MD,Republic of Moldova,EURO,232,7537,3,276
17336,2020-05-29T00:00:00Z,MD,Republic of Moldova,EURO,188,7725,6,282
17337,2020-05-30T00:00:00Z,MD,Republic of Moldova,EURO,171,7896,7,289
17338,2020-05-31T00:00:00Z,MD,Republic of Moldova,EURO,202,8098,5,294
17339,2020-06-01T00:00:00Z,MD,Republic of Moldova,EURO,153,8251,1,295
17340,2020-06-02T00:00:00Z,MD,Republic of Moldova,EURO,109,8360,12,307
17341,2020-06-03T00:00:00Z,MD,Republic of Moldova,EURO,188,8548,2,309
17342,2020-06-04T00:00:00Z,MD,Republic of Moldova,EURO,247,8795,5,314
17343,2020-06-05T00:00:00Z,MD,Republic of Moldova,EURO,223,9018,1,315
17344,2020-06-06T00:00:00Z,MD,Republic of Moldova,EURO,229,9247,8,323
17345,2020-06-07T00:00:00Z,MD,Republic of Moldova,EURO,264,9511,12,335
17346,2020-06-08T00:00:00Z,MD,Republic of Moldova,EURO,189,9700,11,346
17347,2020-06-09T00:00:00Z,MD,Republic of Moldova,EURO,107,9807,13,359
17348,2020-06-10T00:00:00Z,MD,Republic of Moldova,EURO,218,10025,8,367
17349,2020-06-11T00:00:00Z,MD,Republic of Moldova,EURO,296,10321,4,371
17350,2020-06-12T00:00:00Z,MD,Republic of Moldova,EURO,406,10727,4,375
17351,2020-06-13T00:00:00Z,MD,Republic of Moldova,EURO,366,11093,20,395
17352,2020-06-14T00:00:00Z,MD,Republic of Moldova,EURO,366,11459,4,399
17353,2020-06-15T00:00:00Z,MD,Republic of Moldova,EURO,281,11740,7,406
17354,2020-06-16T00:00:00Z,MD,Republic of Moldova,EURO,139,11879,11,417
17355,2020-06-17T00:00:00Z,MD,Republic of Moldova,EURO,375,12254,10,427
17356,2020-06-18T00:00:00Z,MD,Republic of Moldova,EURO,478,12732,6,433
17357,2020-06-19T00:00:00Z,MD,Republic of Moldova,EURO,374,13106,16,449
17358,2020-06-20T00:00:00Z,MD,Republic of Moldova,EURO,450,13556,9,458
17459,2020-02-26T00:00:00Z,RO,Romania,EURO,1,1,0,0
17460,2020-02-27T00:00:00Z,RO,Romania,EURO,0,1,0,0
17461,2020-02-28T00:00:00Z,RO,Romania,EURO,2,3,0,0
17462,2020-02-29T00:00:00Z,RO,Romania,EURO,0,3,0,0
17463,2020-03-01T00:00:00Z,RO,Romania,EURO,0,3,0,0
17464,2020-03-02T00:00:00Z,RO,Romania,EURO,0,3,0,0
17465,2020-03-03T00:00:00Z,RO,Romania,EURO,1,4,0,0
17466,2020-03-04T00:00:00Z,RO,Romania,EURO,0,4,0,0
17467,2020-03-05T00:00:00Z,RO,Romania,EURO,2,6,0,0
17468,2020-03-06T00:00:00Z,RO,Romania,EURO,1,7,0,0
17469,2020-03-07T00:00:00Z,RO,Romania,EURO,2,9,0,0
17470,2020-03-08T00:00:00Z,RO,Romania,EURO,6,15,0,0
17471,2020-03-09T00:00:00Z,RO,Romania,EURO,0,15,0,0
17472,2020-03-10T00:00:00Z,RO,Romania,EURO,2,17,0,0
17473,2020-03-11T00:00:00Z,RO,Romania,EURO,14,31,0,0
17474,2020-03-12T00:00:00Z,RO,Romania,EURO,18,49,0,0
17475,2020-03-13T00:00:00Z,RO,Romania,EURO,15,64,0,0
17476,2020-03-14T00:00:00Z,RO,Romania,EURO,49,113,0,0
17477,2020-03-15T00:00:00Z,RO,Romania,EURO,10,123,0,0
17478,2020-03-16T00:00:00Z,RO,Romania,EURO,35,158,0,0
17479,2020-03-17T00:00:00Z,RO,Romania,EURO,26,184,0,0
17480,2020-03-18T00:00:00Z,RO,Romania,EURO,62,246,0,0
17481,2020-03-19T00:00:00Z,RO,Romania,EURO,14,260,0,0
17482,2020-03-20T00:00:00Z,RO,Romania,EURO,48,308,0,0
17483,2020-03-21T00:00:00Z,RO,Romania,EURO,59,367,0,0
17484,2020-03-22T00:00:00Z,RO,Romania,EURO,0,367,0,0
17485,2020-03-23T00:00:00Z,RO,Romania,EURO,66,433,2,2
17486,2020-03-24T00:00:00Z,RO,Romania,EURO,143,576,5,7
17487,2020-03-25T00:00:00Z,RO,Romania,EURO,186,762,4,11
17488,2020-03-26T00:00:00Z,RO,Romania,EURO,144,906,2,13
17489,2020-03-27T00:00:00Z,RO,Romania,EURO,123,1029,4,17
17490,2020-03-28T00:00:00Z,RO,Romania,EURO,263,1292,7,24
17491,2020-03-29T00:00:00Z,RO,Romania,EURO,160,1452,5,29
17492,2020-03-30T00:00:00Z,RO,Romania,EURO,308,1760,11,40
17493,2020-03-31T00:00:00Z,RO,Romania,EURO,192,1952,4,44
17494,2020-04-01T00:00:00Z,RO,Romania,EURO,293,2245,25,69
17495,2020-04-02T00:00:00Z,RO,Romania,EURO,215,2460,16,85
17496,2020-04-03T00:00:00Z,RO,Romania,EURO,278,2738,9,94
17497,2020-04-04T00:00:00Z,RO,Romania,EURO,445,3183,39,133
17498,2020-04-05T00:00:00Z,RO,Romania,EURO,430,3613,8,141
17499,2020-04-06T00:00:00Z,RO,Romania,EURO,251,3864,7,148
17500,2020-04-07T00:00:00Z,RO,Romania,EURO,193,4057,9,157
17501,2020-04-08T00:00:00Z,RO,Romania,EURO,360,4417,25,182
17502,2020-04-09T00:00:00Z,RO,Romania,EURO,344,4761,27,209
17503,2020-04-10T00:00:00Z,RO,Romania,EURO,441,5202,20,229
17504,2020-04-11T00:00:00Z,RO,Romania,EURO,265,5467,28,257
17505,2020-04-12T00:00:00Z,RO,Romania,EURO,523,5990,25,282
17506,2020-04-13T00:00:00Z,RO,Romania,EURO,310,6300,24,306
17507,2020-04-14T00:00:00Z,RO,Romania,EURO,333,6633,12,318
17508,2020-04-15T00:00:00Z,RO,Romania,EURO,246,6879,26,344
17509,2020-04-16T00:00:00Z,RO,Romania,EURO,337,7216,28,372
17510,2020-04-17T00:00:00Z,RO,Romania,EURO,491,7707,15,387
17511,2020-04-18T00:00:00Z,RO,Romania,EURO,360,8067,13,400
17512,2020-04-19T00:00:00Z,RO,Romania,EURO,351,8418,17,417
17513,2020-04-20T00:00:00Z,RO,Romania,EURO,328,8746,17,434
17514,2020-04-21T00:00:00Z,RO,Romania,EURO,190,8936,17,451
17515,2020-04-22T00:00:00Z,RO,Romania,EURO,306,9242,32,483
17516,2020-04-23T00:00:00Z,RO,Romania,EURO,468,9710,25,508
17517,2020-04-24T00:00:00Z,RO,Romania,EURO,386,10096,19,527
17518,2020-04-25T00:00:00Z,RO,Romania,EURO,321,10417,25,552
17519,2020-04-26T00:00:00Z,RO,Romania,EURO,218,10635,23,575
17520,2020-04-27T00:00:00Z,RO,Romania,EURO,401,11036,33,608
17521,2020-04-28T00:00:00Z,RO,Romania,EURO,303,11339,23,631
17522,2020-04-29T00:00:00Z,RO,Romania,EURO,277,11616,19,650
17523,2020-04-30T00:00:00Z,RO,Romania,EURO,362,11978,25,675
17524,2020-05-01T00:00:00Z,RO,Romania,EURO,262,12240,42,717
17525,2020-05-02T00:00:00Z,RO,Romania,EURO,327,12567,27,744
17526,2020-05-03T00:00:00Z,RO,Romania,EURO,165,12732,27,771
17527,2020-05-04T00:00:00Z,RO,Romania,EURO,431,13163,9,780
17528,2020-05-05T00:00:00Z,RO,Romania,EURO,349,13512,23,803
17529,2020-05-06T00:00:00Z,RO,Romania,EURO,325,13837,24,827
17530,2020-05-07T00:00:00Z,RO,Romania,EURO,270,14107,31,858
17531,2020-05-08T00:00:00Z,RO,Romania,EURO,392,14499,18,876
17532,2020-05-09T00:00:00Z,RO,Romania,EURO,312,14811,22,898
17533,2020-05-10T00:00:00Z,RO,Romania,EURO,320,15131,28,926
17534,2020-05-11T00:00:00Z,RO,Romania,EURO,231,15362,26,952
17535,2020-05-12T00:00:00Z,RO,Romania,EURO,226,15588,20,972
17536,2020-05-13T00:00:00Z,RO,Romania,EURO,190,15778,30,1002
17537,2020-05-14T00:00:00Z,RO,Romania,EURO,224,16002,14,1016
17538,2020-05-15T00:00:00Z,RO,Romania,EURO,245,16247,30,1046
17539,2020-05-16T00:00:00Z,RO,Romania,EURO,190,16437,10,1056
17540,2020-05-17T00:00:00Z,RO,Romania,EURO,267,16704,25,1081
17541,2020-05-18T00:00:00Z,RO,Romania,EURO,167,16871,16,1097
17542,2020-05-19T00:00:00Z,RO,Romania,EURO,165,17036,10,1107
17543,2020-05-20T00:00:00Z,RO,Romania,EURO,155,17191,19,1126
17544,2020-05-21T00:00:00Z,RO,Romania,EURO,196,17387,15,1141
17545,2020-05-22T00:00:00Z,RO,Romania,EURO,198,17585,10,1151
17546,2020-05-23T00:00:00Z,RO,Romania,EURO,127,17712,8,1159
17547,2020-05-24T00:00:00Z,RO,Romania,EURO,145,17857,11,1170
17548,2020-05-25T00:00:00Z,RO,Romania,EURO,213,18070,9,1179
17549,2020-05-26T00:00:00Z,RO,Romania,EURO,213,18283,18,1197
17550,2020-05-27T00:00:00Z,RO,Romania,EURO,146,18429,13,1210
17551,2020-05-28T00:00:00Z,RO,Romania,EURO,165,18594,9,1219
17552,2020-05-29T00:00:00Z,RO,Romania,EURO,197,18791,10,1229
17553,2020-05-30T00:00:00Z,RO,Romania,EURO,191,18982,11,1240
17554,2020-05-31T00:00:00Z,RO,Romania,EURO,151,19133,13,1253
17555,2020-06-01T00:00:00Z,RO,Romania,EURO,124,19257,9,1262
17556,2020-06-02T00:00:00Z,RO,Romania,EURO,141,19398,17,1279
17557,2020-06-03T00:00:00Z,RO,Romania,EURO,119,19517,0,1279
17558,2020-06-04T00:00:00Z,RO,Romania,EURO,152,19669,9,1288
17559,2020-06-05T00:00:00Z,RO,Romania,EURO,238,19907,11,1299
17560,2020-06-06T00:00:00Z,RO,Romania,EURO,196,20103,9,1308
17561,2020-06-07T00:00:00Z,RO,Romania,EURO,187,20290,10,1318
17562,2020-06-08T00:00:00Z,RO,Romania,EURO,189,20479,8,1326
17563,2020-06-09T00:00:00Z,RO,Romania,EURO,125,20604,8,1334
17564,2020-06-10T00:00:00Z,RO,Romania,EURO,145,20749,11,1345
17565,2020-06-11T00:00:00Z,RO,Romania,EURO,196,20945,15,1360
17566,2020-06-12T00:00:00Z,RO,Romania,EURO,237,21182,9,1369
17567,2020-06-13T00:00:00Z,RO,Romania,EURO,222,21404,11,1380
17568,2020-06-14T00:00:00Z,RO,Romania,EURO,275,21679,11,1391
17569,2020-06-15T00:00:00Z,RO,Romania,EURO,320,21999,19,1410
17570,2020-06-16T00:00:00Z,RO,Romania,EURO,166,22165,17,1427
17571,2020-06-17T00:00:00Z,RO,Romania,EURO,250,22415,10,1437
17572,2020-06-18T00:00:00Z,RO,Romania,EURO,345,22760,14,1451
17573,2020-06-19T00:00:00Z,RO,Romania,EURO,320,23080,22,1473
17574,2020-06-20T00:00:00Z,RO,Romania,EURO,320,23400,11,1484
17575,2020-01-31T00:00:00Z,RU,Russian Federation,EURO,2,2,0,0
17576,2020-02-01T00:00:00Z,RU,Russian Federation,EURO,0,2,0,0
17577,2020-02-02T00:00:00Z,RU,Russian Federation,EURO,0,2,0,0
17578,2020-02-03T00:00:00Z,RU,Russian Federation,EURO,0,2,0,0
17579,2020-02-04T00:00:00Z,RU,Russian Federation,EURO,0,2,0,0
17580,2020-02-05T00:00:00Z,RU,Russian Federation,EURO,0,2,0,0
17581,2020-02-06T00:00:00Z,RU,Russian Federation,EURO,0,2,0,0
17582,2020-02-07T00:00:00Z,RU,Russian Federation,EURO,0,2,0,0
17583,2020-02-08T00:00:00Z,RU,Russian Federation,EURO,0,2,0,0
17584,2020-02-09T00:00:00Z,RU,Russian Federation,EURO,0,2,0,0
17585,2020-02-10T00:00:00Z,RU,Russian Federation,EURO,0,2,0,0
17586,2020-02-11T00:00:00Z,RU,Russian Federation,EURO,0,2,0,0
17587,2020-02-12T00:00:00Z,RU,Russian Federation,EURO,0,2,0,0
17588,2020-02-13T00:00:00Z,RU,Russian Federation,EURO,0,2,0,0
17589,2020-02-14T00:00:00Z,RU,Russian Federation,EURO,0,2,0,0
17590,2020-02-15T00:00:00Z,RU,Russian Federation,EURO,0,2,0,0
17591,2020-02-16T00:00:00Z,RU,Russian Federation,EURO,0,2,0,0
17592,2020-02-17T00:00:00Z,RU,Russian Federation,EURO,0,2,0,0
17593,2020-02-18T00:00:00Z,RU,Russian Federation,EURO,0,2,0,0
17594,2020-02-19T00:00:00Z,RU,Russian Federation,EURO,0,2,0,0
17595,2020-02-20T00:00:00Z,RU,Russian Federation,EURO,0,2,0,0
17596,2020-02-21T00:00:00Z,RU,Russian Federation,EURO,0,2,0,0
17597,2020-02-22T00:00:00Z,RU,Russian Federation,EURO,0,2,0,0
17598,2020-02-23T00:00:00Z,RU,Russian Federation,EURO,0,2,0,0
17599,2020-02-24T00:00:00Z,RU,Russian Federation,EURO,0,2,0,0
17600,2020-02-25T00:00:00Z,RU,Russian Federation,EURO,0,2,0,0
17601,2020-02-26T00:00:00Z,RU,Russian Federation,EURO,0,2,0,0
17602,2020-02-27T00:00:00Z,RU,Russian Federation,EURO,0,2,0,0
17603,2020-02-28T00:00:00Z,RU,Russian Federation,EURO,0,2,0,0
17604,2020-02-29T00:00:00Z,RU,Russian Federation,EURO,0,2,0,0
17605,2020-03-01T00:00:00Z,RU,Russian Federation,EURO,0,2,0,0
17606,2020-03-02T00:00:00Z,RU,Russian Federation,EURO,1,3,0,0
17607,2020-03-03T00:00:00Z,RU,Russian Federation,EURO,0,3,0,0
17608,2020-03-04T00:00:00Z,RU,Russian Federation,EURO,0,3,0,0
17609,2020-03-05T00:00:00Z,RU,Russian Federation,EURO,1,4,0,0
17610,2020-03-06T00:00:00Z,RU,Russian Federation,EURO,3,7,0,0
17611,2020-03-07T00:00:00Z,RU,Russian Federation,EURO,0,7,0,0
17612,2020-03-08T00:00:00Z,RU,Russian Federation,EURO,0,7,0,0
17613,2020-03-09T00:00:00Z,RU,Russian Federation,EURO,0,7,0,0
17614,2020-03-10T00:00:00Z,RU,Russian Federation,EURO,0,7,0,0
17615,2020-03-11T00:00:00Z,RU,Russian Federation,EURO,0,7,0,0
17616,2020-03-12T00:00:00Z,RU,Russian Federation,EURO,27,34,0,0
17617,2020-03-13T00:00:00Z,RU,Russian Federation,EURO,0,34,0,0
17618,2020-03-14T00:00:00Z,RU,Russian Federation,EURO,0,34,0,0
17619,2020-03-15T00:00:00Z,RU,Russian Federation,EURO,0,34,0,0
17620,2020-03-16T00:00:00Z,RU,Russian Federation,EURO,59,93,0,0
17621,2020-03-17T00:00:00Z,RU,Russian Federation,EURO,0,93,0,0
17622,2020-03-18T00:00:00Z,RU,Russian Federation,EURO,54,147,0,0
17623,2020-03-19T00:00:00Z,RU,Russian Federation,EURO,52,199,0,0
17624,2020-03-20T00:00:00Z,RU,Russian Federation,EURO,54,253,0,0
17625,2020-03-21T00:00:00Z,RU,Russian Federation,EURO,53,306,0,0
17626,2020-03-22T00:00:00Z,RU,Russian Federation,EURO,0,306,0,0
17627,2020-03-23T00:00:00Z,RU,Russian Federation,EURO,132,438,0,0
17628,2020-03-24T00:00:00Z,RU,Russian Federation,EURO,0,438,0,0
17629,2020-03-25T00:00:00Z,RU,Russian Federation,EURO,220,658,0,0
17630,2020-03-26T00:00:00Z,RU,Russian Federation,EURO,182,840,2,2
17631,2020-03-27T00:00:00Z,RU,Russian Federation,EURO,196,1036,1,3
17632,2020-03-28T00:00:00Z,RU,Russian Federation,EURO,228,1264,1,4
17633,2020-03-29T00:00:00Z,RU,Russian Federation,EURO,270,1534,4,8
17634,2020-03-30T00:00:00Z,RU,Russian Federation,EURO,0,1534,1,9
17635,2020-03-31T00:00:00Z,RU,Russian Federation,EURO,303,1837,0,9
17636,2020-04-01T00:00:00Z,RU,Russian Federation,EURO,500,2337,8,17
17637,2020-04-02T00:00:00Z,RU,Russian Federation,EURO,440,2777,7,24
17638,2020-04-03T00:00:00Z,RU,Russian Federation,EURO,771,3548,6,30
17639,2020-04-04T00:00:00Z,RU,Russian Federation,EURO,601,4149,4,34
17640,2020-04-05T00:00:00Z,RU,Russian Federation,EURO,582,4731,9,43
17641,2020-04-06T00:00:00Z,RU,Russian Federation,EURO,658,5389,2,45
17642,2020-04-07T00:00:00Z,RU,Russian Federation,EURO,954,6343,2,47
17643,2020-04-08T00:00:00Z,RU,Russian Federation,EURO,1154,7497,11,58
17644,2020-04-09T00:00:00Z,RU,Russian Federation,EURO,2634,10131,18,76
17645,2020-04-10T00:00:00Z,RU,Russian Federation,EURO,1786,11917,18,94
17646,2020-04-11T00:00:00Z,RU,Russian Federation,EURO,1667,13584,12,106
17647,2020-04-12T00:00:00Z,RU,Russian Federation,EURO,2186,15770,24,130
17648,2020-04-13T00:00:00Z,RU,Russian Federation,EURO,2558,18328,18,148
17649,2020-04-14T00:00:00Z,RU,Russian Federation,EURO,2774,21102,22,170
17650,2020-04-15T00:00:00Z,RU,Russian Federation,EURO,3388,24490,28,198
17651,2020-04-16T00:00:00Z,RU,Russian Federation,EURO,3448,27938,34,232
17652,2020-04-17T00:00:00Z,RU,Russian Federation,EURO,4070,32008,41,273
17653,2020-04-18T00:00:00Z,RU,Russian Federation,EURO,4785,36793,40,313
17654,2020-04-19T00:00:00Z,RU,Russian Federation,EURO,6060,42853,48,361
17655,2020-04-20T00:00:00Z,RU,Russian Federation,EURO,0,42853,0,361
17656,2020-04-21T00:00:00Z,RU,Russian Federation,EURO,9910,52763,95,456
17657,2020-04-22T00:00:00Z,RU,Russian Federation,EURO,5236,57999,57,513
17658,2020-04-23T00:00:00Z,RU,Russian Federation,EURO,4774,62773,42,555
17659,2020-04-24T00:00:00Z,RU,Russian Federation,EURO,5849,68622,60,615
17660,2020-04-25T00:00:00Z,RU,Russian Federation,EURO,0,68622,0,615
17661,2020-04-26T00:00:00Z,RU,Russian Federation,EURO,5966,74588,66,681
17662,2020-04-27T00:00:00Z,RU,Russian Federation,EURO,12559,87147,113,794
17663,2020-04-28T00:00:00Z,RU,Russian Federation,EURO,6411,93558,73,867
17664,2020-04-29T00:00:00Z,RU,Russian Federation,EURO,5841,99399,105,972
17665,2020-04-30T00:00:00Z,RU,Russian Federation,EURO,7099,106498,101,1073
17666,2020-05-01T00:00:00Z,RU,Russian Federation,EURO,7933,114431,96,1169
17667,2020-05-02T00:00:00Z,RU,Russian Federation,EURO,9623,124054,53,1222
17668,2020-05-03T00:00:00Z,RU,Russian Federation,EURO,10633,134687,58,1280
17669,2020-05-04T00:00:00Z,RU,Russian Federation,EURO,10581,145268,76,1356
17670,2020-05-05T00:00:00Z,RU,Russian Federation,EURO,10102,155370,95,1451
17671,2020-05-06T00:00:00Z,RU,Russian Federation,EURO,10559,165929,86,1537
17672,2020-05-07T00:00:00Z,RU,Russian Federation,EURO,11231,177160,88,1625
17673,2020-05-08T00:00:00Z,RU,Russian Federation,EURO,10699,187859,98,1723
17674,2020-05-09T00:00:00Z,RU,Russian Federation,EURO,10817,198676,104,1827
17675,2020-05-10T00:00:00Z,RU,Russian Federation,EURO,11012,209688,88,1915
17676,2020-05-11T00:00:00Z,RU,Russian Federation,EURO,11656,221344,94,2009
17677,2020-05-12T00:00:00Z,RU,Russian Federation,EURO,10899,232243,107,2116
17678,2020-05-13T00:00:00Z,RU,Russian Federation,EURO,10028,242271,96,2212
17679,2020-05-14T00:00:00Z,RU,Russian Federation,EURO,9974,252245,93,2305
17680,2020-05-15T00:00:00Z,RU,Russian Federation,EURO,10598,262843,113,2418
17681,2020-05-16T00:00:00Z,RU,Russian Federation,EURO,9200,272043,119,2537
17682,2020-05-17T00:00:00Z,RU,Russian Federation,EURO,9709,281752,94,2631
17683,2020-05-18T00:00:00Z,RU,Russian Federation,EURO,8926,290678,91,2722
17684,2020-05-19T00:00:00Z,RU,Russian Federation,EURO,9263,299941,115,2837
17685,2020-05-20T00:00:00Z,RU,Russian Federation,EURO,8764,308705,135,2972
17686,2020-05-21T00:00:00Z,RU,Russian Federation,EURO,8849,317554,127,3099
17687,2020-05-22T00:00:00Z,RU,Russian Federation,EURO,8894,326448,150,3249
17688,2020-05-23T00:00:00Z,RU,Russian Federation,EURO,9434,335882,139,3388
17689,2020-05-24T00:00:00Z,RU,Russian Federation,EURO,8599,344481,153,3541
17690,2020-05-25T00:00:00Z,RU,Russian Federation,EURO,8946,353427,92,3633
17691,2020-05-26T00:00:00Z,RU,Russian Federation,EURO,8915,362342,174,3807
17692,2020-05-27T00:00:00Z,RU,Russian Federation,EURO,8338,370680,161,3968
17693,2020-05-28T00:00:00Z,RU,Russian Federation,EURO,8371,379051,174,4142
17694,2020-05-29T00:00:00Z,RU,Russian Federation,EURO,8572,387623,232,4374
17695,2020-05-30T00:00:00Z,RU,Russian Federation,EURO,8952,396575,181,4555
17696,2020-05-31T00:00:00Z,RU,Russian Federation,EURO,9268,405843,138,4693
17697,2020-06-01T00:00:00Z,RU,Russian Federation,EURO,9035,414878,162,4855
17698,2020-06-02T00:00:00Z,RU,Russian Federation,EURO,8863,423741,182,5037
17699,2020-06-03T00:00:00Z,RU,Russian Federation,EURO,8536,432277,178,5215
17700,2020-06-04T00:00:00Z,RU,Russian Federation,EURO,8831,441108,169,5384
17701,2020-06-05T00:00:00Z,RU,Russian Federation,EURO,8726,449834,144,5528
17702,2020-06-06T00:00:00Z,RU,Russian Federation,EURO,8855,458689,197,5725
17703,2020-06-07T00:00:00Z,RU,Russian Federation,EURO,8984,467673,134,5859
17704,2020-06-08T00:00:00Z,RU,Russian Federation,EURO,8985,476658,112,5971
17705,2020-06-09T00:00:00Z,RU,Russian Federation,EURO,8595,485253,171,6142
17706,2020-06-10T00:00:00Z,RU,Russian Federation,EURO,8404,493657,216,6358
17707,2020-06-11T00:00:00Z,RU,Russian Federation,EURO,8779,502436,174,6532
17708,2020-06-12T00:00:00Z,RU,Russian Federation,EURO,8987,511423,183,6715
17709,2020-06-13T00:00:00Z,RU,Russian Federation,EURO,8706,520129,114,6829
17710,2020-06-14T00:00:00Z,RU,Russian Federation,EURO,8835,528964,119,6948
17711,2020-06-15T00:00:00Z,RU,Russian Federation,EURO,8246,537210,143,7091
17712,2020-06-16T00:00:00Z,RU,Russian Federation,EURO,8248,545458,193,7284
17713,2020-06-17T00:00:00Z,RU,Russian Federation,EURO,7843,553301,194,7478
17714,2020-06-18T00:00:00Z,RU,Russian Federation,EURO,7790,561091,182,7660
17715,2020-06-19T00:00:00Z,RU,Russian Federation,EURO,7972,569063,181,7841
17716,2020-06-20T00:00:00Z,RU,Russian Federation,EURO,7889,576952,161,8002
18396,2020-02-28T00:00:00Z,SM,San Marino,EURO,1,1,0,0
18397,2020-02-29T00:00:00Z,SM,San Marino,EURO,0,1,0,0
18398,2020-03-01T00:00:00Z,SM,San Marino,EURO,0,1,0,0
18399,2020-03-02T00:00:00Z,SM,San Marino,EURO,7,8,0,0
18400,2020-03-03T00:00:00Z,SM,San Marino,EURO,0,8,0,0
18401,2020-03-04T00:00:00Z,SM,San Marino,EURO,8,16,0,0
18402,2020-03-05T00:00:00Z,SM,San Marino,EURO,5,21,0,0
18403,2020-03-06T00:00:00Z,SM,San Marino,EURO,3,24,0,0
18404,2020-03-07T00:00:00Z,SM,San Marino,EURO,3,27,1,1
18405,2020-03-08T00:00:00Z,SM,San Marino,EURO,10,37,0,1
18406,2020-03-09T00:00:00Z,SM,San Marino,EURO,12,49,1,2
18407,2020-03-10T00:00:00Z,SM,San Marino,EURO,14,63,0,2
18408,2020-03-11T00:00:00Z,SM,San Marino,EURO,6,69,1,3
18409,2020-03-12T00:00:00Z,SM,San Marino,EURO,8,77,2,5
18410,2020-03-13T00:00:00Z,SM,San Marino,EURO,6,83,0,5
18411,2020-03-14T00:00:00Z,SM,San Marino,EURO,0,83,0,5
18412,2020-03-15T00:00:00Z,SM,San Marino,EURO,9,92,0,5
18413,2020-03-16T00:00:00Z,SM,San Marino,EURO,10,102,4,9
18414,2020-03-17T00:00:00Z,SM,San Marino,EURO,2,104,2,11
18415,2020-03-18T00:00:00Z,SM,San Marino,EURO,5,109,3,14
18416,2020-03-19T00:00:00Z,SM,San Marino,EURO,17,126,0,14
18417,2020-03-20T00:00:00Z,SM,San Marino,EURO,25,151,0,14
18418,2020-03-21T00:00:00Z,SM,San Marino,EURO,0,151,6,20
18419,2020-03-22T00:00:00Z,SM,San Marino,EURO,0,151,0,20
18420,2020-03-23T00:00:00Z,SM,San Marino,EURO,0,151,0,20
18421,2020-03-24T00:00:00Z,SM,San Marino,EURO,36,187,0,20
18422,2020-03-25T00:00:00Z,SM,San Marino,EURO,0,187,1,21
18423,2020-03-26T00:00:00Z,SM,San Marino,EURO,21,208,0,21
18424,2020-03-27T00:00:00Z,SM,San Marino,EURO,10,218,0,21
18425,2020-03-28T00:00:00Z,SM,San Marino,EURO,10,228,0,21
18426,2020-03-29T00:00:00Z,SM,San Marino,EURO,0,228,1,22
18427,2020-03-30T00:00:00Z,SM,San Marino,EURO,1,229,2,24
18428,2020-03-31T00:00:00Z,SM,San Marino,EURO,1,230,1,25
18429,2020-04-01T00:00:00Z,SM,San Marino,EURO,6,236,1,26
18430,2020-04-02T00:00:00Z,SM,San Marino,EURO,0,236,2,28
18431,2020-04-03T00:00:00Z,SM,San Marino,EURO,9,245,2,30
18432,2020-04-04T00:00:00Z,SM,San Marino,EURO,7,252,2,32
18433,2020-04-05T00:00:00Z,SM,San Marino,EURO,7,259,0,32
18434,2020-04-06T00:00:00Z,SM,San Marino,EURO,7,266,0,32
18435,2020-04-07T00:00:00Z,SM,San Marino,EURO,11,277,0,32
18436,2020-04-08T00:00:00Z,SM,San Marino,EURO,2,279,2,34
18437,2020-04-09T00:00:00Z,SM,San Marino,EURO,29,308,0,34
18438,2020-04-10T00:00:00Z,SM,San Marino,EURO,36,344,0,34
18439,2020-04-11T00:00:00Z,SM,San Marino,EURO,0,344,0,34
18440,2020-04-12T00:00:00Z,SM,San Marino,EURO,12,356,1,35
18441,2020-04-13T00:00:00Z,SM,San Marino,EURO,0,356,0,35
18442,2020-04-14T00:00:00Z,SM,San Marino,EURO,15,371,1,36
18443,2020-04-15T00:00:00Z,SM,San Marino,EURO,1,372,0,36
18444,2020-04-16T00:00:00Z,SM,San Marino,EURO,21,393,0,36
18445,2020-04-17T00:00:00Z,SM,San Marino,EURO,33,426,2,38
18446,2020-04-18T00:00:00Z,SM,San Marino,EURO,0,426,0,38
18447,2020-04-19T00:00:00Z,SM,San Marino,EURO,29,455,1,39
18448,2020-04-20T00:00:00Z,SM,San Marino,EURO,6,461,0,39
18449,2020-04-21T00:00:00Z,SM,San Marino,EURO,1,462,0,39
18450,2020-04-22T00:00:00Z,SM,San Marino,EURO,14,476,1,40
18451,2020-04-23T00:00:00Z,SM,San Marino,EURO,12,488,0,40
18452,2020-04-24T00:00:00Z,SM,San Marino,EURO,13,501,0,40
18453,2020-04-25T00:00:00Z,SM,San Marino,EURO,12,513,0,40
18454,2020-04-26T00:00:00Z,SM,San Marino,EURO,0,513,0,40
18455,2020-04-27T00:00:00Z,SM,San Marino,EURO,25,538,1,41
18456,2020-04-28T00:00:00Z,SM,San Marino,EURO,0,538,0,41
18457,2020-04-29T00:00:00Z,SM,San Marino,EURO,15,553,0,41
18458,2020-04-30T00:00:00Z,SM,San Marino,EURO,10,563,0,41
18459,2020-05-01T00:00:00Z,SM,San Marino,EURO,6,569,0,41
18460,2020-05-02T00:00:00Z,SM,San Marino,EURO,11,580,0,41
18461,2020-05-03T00:00:00Z,SM,San Marino,EURO,0,580,0,41
18462,2020-05-04T00:00:00Z,SM,San Marino,EURO,2,582,0,41
18463,2020-05-05T00:00:00Z,SM,San Marino,EURO,0,582,0,41
18464,2020-05-06T00:00:00Z,SM,San Marino,EURO,7,589,0,41
18465,2020-05-07T00:00:00Z,SM,San Marino,EURO,19,608,0,41
18466,2020-05-08T00:00:00Z,SM,San Marino,EURO,24,632,0,41
18467,2020-05-09T00:00:00Z,SM,San Marino,EURO,0,632,0,41
18468,2020-05-10T00:00:00Z,SM,San Marino,EURO,0,632,0,41
18469,2020-05-11T00:00:00Z,SM,San Marino,EURO,5,637,0,41
18470,2020-05-12T00:00:00Z,SM,San Marino,EURO,10,647,0,41
18471,2020-05-13T00:00:00Z,SM,San Marino,EURO,0,647,0,41
18472,2020-05-14T00:00:00Z,SM,San Marino,EURO,0,647,0,41
18473,2020-05-15T00:00:00Z,SM,San Marino,EURO,0,647,0,41
18474,2020-05-16T00:00:00Z,SM,San Marino,EURO,5,652,0,41
18475,2020-05-17T00:00:00Z,SM,San Marino,EURO,0,652,0,41
18476,2020-05-18T00:00:00Z,SM,San Marino,EURO,16,668,0,41
18477,2020-05-19T00:00:00Z,SM,San Marino,EURO,0,668,0,41
18478,2020-05-20T00:00:00Z,SM,San Marino,EURO,0,668,0,41
18479,2020-05-21T00:00:00Z,SM,San Marino,EURO,2,670,0,41
18480,2020-05-22T00:00:00Z,SM,San Marino,EURO,2,672,0,41
18481,2020-05-23T00:00:00Z,SM,San Marino,EURO,0,672,0,41
18482,2020-05-24T00:00:00Z,SM,San Marino,EURO,0,672,1,42
18483,2020-05-25T00:00:00Z,SM,San Marino,EURO,0,672,0,42
18484,2020-05-26T00:00:00Z,SM,San Marino,EURO,0,672,0,42
18485,2020-05-27T00:00:00Z,SM,San Marino,EURO,0,672,0,42
18486,2020-05-28T00:00:00Z,SM,San Marino,EURO,0,672,0,42
18487,2020-05-29T00:00:00Z,SM,San Marino,EURO,15,687,0,42
18488,2020-05-30T00:00:00Z,SM,San Marino,EURO,0,687,0,42
18489,2020-05-31T00:00:00Z,SM,San Marino,EURO,0,687,0,42
18490,2020-06-01T00:00:00Z,SM,San Marino,EURO,0,687,0,42
18491,2020-06-02T00:00:00Z,SM,San Marino,EURO,0,687,0,42
18492,2020-06-03T00:00:00Z,SM,San Marino,EURO,0,687,0,42
18493,2020-06-04T00:00:00Z,SM,San Marino,EURO,0,687,0,42
18494,2020-06-05T00:00:00Z,SM,San Marino,EURO,8,695,0,42
18495,2020-06-06T00:00:00Z,SM,San Marino,EURO,0,695,0,42
18496,2020-06-07T00:00:00Z,SM,San Marino,EURO,0,695,0,42
18497,2020-06-08T00:00:00Z,SM,San Marino,EURO,0,695,0,42
18498,2020-06-09T00:00:00Z,SM,San Marino,EURO,0,695,0,42
18499,2020-06-10T00:00:00Z,SM,San Marino,EURO,0,695,0,42
18500,2020-06-11T00:00:00Z,SM,San Marino,EURO,0,695,0,42
18501,2020-06-12T00:00:00Z,SM,San Marino,EURO,0,695,0,42
18502,2020-06-13T00:00:00Z,SM,San Marino,EURO,0,695,0,42
18503,2020-06-14T00:00:00Z,SM,San Marino,EURO,0,695,0,42
18504,2020-06-15T00:00:00Z,SM,San Marino,EURO,0,695,0,42
18505,2020-06-16T00:00:00Z,SM,San Marino,EURO,0,695,0,42
18506,2020-06-17T00:00:00Z,SM,San Marino,EURO,0,695,0,42
18507,2020-06-18T00:00:00Z,SM,San Marino,EURO,14,709,0,42
18508,2020-06-19T00:00:00Z,SM,San Marino,EURO,0,709,0,42
18509,2020-06-20T00:00:00Z,SM,San Marino,EURO,4,713,0,42
18808,2020-03-06T00:00:00Z,RS,Serbia,EURO,1,1,0,0
18809,2020-03-07T00:00:00Z,RS,Serbia,EURO,0,1,0,0
18810,2020-03-08T00:00:00Z,RS,Serbia,EURO,0,1,0,0
18811,2020-03-09T00:00:00Z,RS,Serbia,EURO,0,1,0,0
18812,2020-03-10T00:00:00Z,RS,Serbia,EURO,4,5,0,0
18813,2020-03-11T00:00:00Z,RS,Serbia,EURO,7,12,0,0
18814,2020-03-12T00:00:00Z,RS,Serbia,EURO,7,19,0,0
18815,2020-03-13T00:00:00Z,RS,Serbia,EURO,12,31,0,0
18816,2020-03-14T00:00:00Z,RS,Serbia,EURO,10,41,0,0
18817,2020-03-15T00:00:00Z,RS,Serbia,EURO,0,41,0,0
18818,2020-03-16T00:00:00Z,RS,Serbia,EURO,16,57,0,0
18819,2020-03-17T00:00:00Z,RS,Serbia,EURO,15,72,0,0
18820,2020-03-18T00:00:00Z,RS,Serbia,EURO,10,82,0,0
18821,2020-03-19T00:00:00Z,RS,Serbia,EURO,41,123,0,0
18822,2020-03-20T00:00:00Z,RS,Serbia,EURO,12,135,1,1
18823,2020-03-21T00:00:00Z,RS,Serbia,EURO,38,173,0,1
18824,2020-03-22T00:00:00Z,RS,Serbia,EURO,0,173,0,1
18825,2020-03-23T00:00:00Z,RS,Serbia,EURO,46,219,0,1
18826,2020-03-24T00:00:00Z,RS,Serbia,EURO,30,249,1,2
18827,2020-03-25T00:00:00Z,RS,Serbia,EURO,54,303,1,3
18828,2020-03-26T00:00:00Z,RS,Serbia,EURO,81,384,1,4
18829,2020-03-27T00:00:00Z,RS,Serbia,EURO,73,457,3,7
18830,2020-03-28T00:00:00Z,RS,Serbia,EURO,71,528,0,7
18831,2020-03-29T00:00:00Z,RS,Serbia,EURO,131,659,3,10
18832,2020-03-30T00:00:00Z,RS,Serbia,EURO,82,741,3,13
18833,2020-03-31T00:00:00Z,RS,Serbia,EURO,44,785,0,13
18834,2020-04-01T00:00:00Z,RS,Serbia,EURO,115,900,0,13
18835,2020-04-02T00:00:00Z,RS,Serbia,EURO,160,1060,0,13
18836,2020-04-03T00:00:00Z,RS,Serbia,EURO,111,1171,0,13
18837,2020-04-04T00:00:00Z,RS,Serbia,EURO,305,1476,26,39
18838,2020-04-05T00:00:00Z,RS,Serbia,EURO,148,1624,0,39
18839,2020-04-06T00:00:00Z,RS,Serbia,EURO,284,1908,12,51
18840,2020-04-07T00:00:00Z,RS,Serbia,EURO,292,2200,7,58
18841,2020-04-08T00:00:00Z,RS,Serbia,EURO,247,2447,3,61
18842,2020-04-09T00:00:00Z,RS,Serbia,EURO,219,2666,4,65
18843,2020-04-10T00:00:00Z,RS,Serbia,EURO,201,2867,0,65
18844,2020-04-11T00:00:00Z,RS,Serbia,EURO,238,3105,6,71
18845,2020-04-12T00:00:00Z,RS,Serbia,EURO,275,3380,3,74
18846,2020-04-13T00:00:00Z,RS,Serbia,EURO,250,3630,6,80
18847,2020-04-14T00:00:00Z,RS,Serbia,EURO,424,4054,5,85
18848,2020-04-15T00:00:00Z,RS,Serbia,EURO,411,4465,9,94
18849,2020-04-16T00:00:00Z,RS,Serbia,EURO,408,4873,5,99
18850,2020-04-17T00:00:00Z,RS,Serbia,EURO,445,5318,4,103
18851,2020-04-18T00:00:00Z,RS,Serbia,EURO,372,5690,7,110
18852,2020-04-19T00:00:00Z,RS,Serbia,EURO,304,5994,7,117
18853,2020-04-20T00:00:00Z,RS,Serbia,EURO,324,6318,5,122
18854,2020-04-21T00:00:00Z,RS,Serbia,EURO,312,6630,3,125
18855,2020-04-22T00:00:00Z,RS,Serbia,EURO,260,6890,5,130
18856,2020-04-23T00:00:00Z,RS,Serbia,EURO,224,7114,4,134
18857,2020-04-24T00:00:00Z,RS,Serbia,EURO,162,7276,5,139
18858,2020-04-25T00:00:00Z,RS,Serbia,EURO,207,7483,5,144
18859,2020-04-26T00:00:00Z,RS,Serbia,EURO,296,7779,7,151
18860,2020-04-27T00:00:00Z,RS,Serbia,EURO,263,8042,5,156
18861,2020-04-28T00:00:00Z,RS,Serbia,EURO,233,8275,6,162
18862,2020-04-29T00:00:00Z,RS,Serbia,EURO,222,8497,6,168
18863,2020-04-30T00:00:00Z,RS,Serbia,EURO,227,8724,5,173
18864,2020-05-01T00:00:00Z,RS,Serbia,EURO,285,9009,6,179
18865,2020-05-02T00:00:00Z,RS,Serbia,EURO,196,9205,6,185
18866,2020-05-03T00:00:00Z,RS,Serbia,EURO,157,9362,4,189
18867,2020-05-04T00:00:00Z,RS,Serbia,EURO,102,9464,4,193
18868,2020-05-05T00:00:00Z,RS,Serbia,EURO,93,9557,4,197
18869,2020-05-06T00:00:00Z,RS,Serbia,EURO,120,9677,3,200
18870,2020-05-07T00:00:00Z,RS,Serbia,EURO,114,9791,3,203
18871,2020-05-08T00:00:00Z,RS,Serbia,EURO,57,9848,3,206
18872,2020-05-09T00:00:00Z,RS,Serbia,EURO,95,9943,3,209
18873,2020-05-10T00:00:00Z,RS,Serbia,EURO,89,10032,4,213
18874,2020-05-11T00:00:00Z,RS,Serbia,EURO,82,10114,2,215
18875,2020-05-12T00:00:00Z,RS,Serbia,EURO,62,10176,3,218
18876,2020-05-13T00:00:00Z,RS,Serbia,EURO,67,10243,2,220
18877,2020-05-14T00:00:00Z,RS,Serbia,EURO,52,10295,2,222
18878,2020-05-15T00:00:00Z,RS,Serbia,EURO,79,10374,2,224
18879,2020-05-16T00:00:00Z,RS,Serbia,EURO,64,10438,1,225
18880,2020-05-17T00:00:00Z,RS,Serbia,EURO,58,10496,3,228
18881,2020-05-18T00:00:00Z,RS,Serbia,EURO,114,10610,2,230
18882,2020-05-19T00:00:00Z,RS,Serbia,EURO,89,10699,1,231
18883,2020-05-20T00:00:00Z,RS,Serbia,EURO,34,10733,3,234
18884,2020-05-21T00:00:00Z,RS,Serbia,EURO,100,10833,1,235
18885,2020-05-22T00:00:00Z,RS,Serbia,EURO,86,10919,2,237
18886,2020-05-23T00:00:00Z,RS,Serbia,EURO,105,11024,0,237
18887,2020-05-24T00:00:00Z,RS,Serbia,EURO,68,11092,1,238
18888,2020-05-25T00:00:00Z,RS,Serbia,EURO,67,11159,0,238
18889,2020-05-26T00:00:00Z,RS,Serbia,EURO,34,11193,1,239
18890,2020-05-27T00:00:00Z,RS,Serbia,EURO,34,11227,0,239
18891,2020-05-28T00:00:00Z,RS,Serbia,EURO,48,11275,1,240
18892,2020-05-29T00:00:00Z,RS,Serbia,EURO,25,11300,1,241
18893,2020-05-30T00:00:00Z,RS,Serbia,EURO,54,11354,1,242
18894,2020-05-31T00:00:00Z,RS,Serbia,EURO,27,11381,0,242
18895,2020-06-01T00:00:00Z,RS,Serbia,EURO,31,11412,1,243
18896,2020-06-02T00:00:00Z,RS,Serbia,EURO,18,11430,1,244
18897,2020-06-03T00:00:00Z,RS,Serbia,EURO,24,11454,1,245
18898,2020-06-04T00:00:00Z,RS,Serbia,EURO,69,11523,0,245
18899,2020-06-05T00:00:00Z,RS,Serbia,EURO,48,11571,1,246
18900,2020-06-06T00:00:00Z,RS,Serbia,EURO,96,11667,1,247
18901,2020-06-07T00:00:00Z,RS,Serbia,EURO,74,11741,1,248
18902,2020-06-08T00:00:00Z,RS,Serbia,EURO,82,11823,1,249
18903,2020-06-09T00:00:00Z,RS,Serbia,EURO,73,11896,1,250
18904,2020-06-10T00:00:00Z,RS,Serbia,EURO,69,11965,0,250
18905,2020-06-11T00:00:00Z,RS,Serbia,EURO,66,12031,1,251
18906,2020-06-12T00:00:00Z,RS,Serbia,EURO,71,12102,1,252
18907,2020-06-13T00:00:00Z,RS,Serbia,EURO,73,12175,0,252
18908,2020-06-14T00:00:00Z,RS,Serbia,EURO,76,12251,1,253
18909,2020-06-15T00:00:00Z,RS,Serbia,EURO,59,12310,1,254
18910,2020-06-16T00:00:00Z,RS,Serbia,EURO,57,12367,1,255
18911,2020-06-17T00:00:00Z,RS,Serbia,EURO,59,12426,1,256
18912,2020-06-18T00:00:00Z,RS,Serbia,EURO,96,12522,1,257
18913,2020-06-19T00:00:00Z,RS,Serbia,EURO,94,12616,1,258
18914,2020-06-20T00:00:00Z,RS,Serbia,EURO,93,12709,1,259
19339,2020-03-06T00:00:00Z,SK,Slovakia,EURO,1,1,0,0
19340,2020-03-07T00:00:00Z,SK,Slovakia,EURO,2,3,0,0
19341,2020-03-08T00:00:00Z,SK,Slovakia,EURO,2,5,0,0
19342,2020-03-09T00:00:00Z,SK,Slovakia,EURO,0,5,0,0
19343,2020-03-10T00:00:00Z,SK,Slovakia,EURO,2,7,0,0
19344,2020-03-11T00:00:00Z,SK,Slovakia,EURO,3,10,0,0
19345,2020-03-12T00:00:00Z,SK,Slovakia,EURO,11,21,0,0
19346,2020-03-13T00:00:00Z,SK,Slovakia,EURO,11,32,0,0
19347,2020-03-14T00:00:00Z,SK,Slovakia,EURO,12,44,0,0
19348,2020-03-15T00:00:00Z,SK,Slovakia,EURO,17,61,0,0
19349,2020-03-16T00:00:00Z,SK,Slovakia,EURO,11,72,0,0
19350,2020-03-17T00:00:00Z,SK,Slovakia,EURO,25,97,0,0
19351,2020-03-18T00:00:00Z,SK,Slovakia,EURO,10,107,0,0
19352,2020-03-19T00:00:00Z,SK,Slovakia,EURO,16,123,0,0
19353,2020-03-20T00:00:00Z,SK,Slovakia,EURO,14,137,0,0
19354,2020-03-21T00:00:00Z,SK,Slovakia,EURO,41,178,0,0
19355,2020-03-22T00:00:00Z,SK,Slovakia,EURO,0,178,0,0
19356,2020-03-23T00:00:00Z,SK,Slovakia,EURO,7,185,0,0
19357,2020-03-24T00:00:00Z,SK,Slovakia,EURO,6,191,0,0
19358,2020-03-25T00:00:00Z,SK,Slovakia,EURO,13,204,0,0
19359,2020-03-26T00:00:00Z,SK,Slovakia,EURO,12,216,0,0
19360,2020-03-27T00:00:00Z,SK,Slovakia,EURO,10,226,0,0
19361,2020-03-28T00:00:00Z,SK,Slovakia,EURO,69,295,0,0
19362,2020-03-29T00:00:00Z,SK,Slovakia,EURO,0,295,0,0
19363,2020-03-30T00:00:00Z,SK,Slovakia,EURO,41,336,0,0
19364,2020-03-31T00:00:00Z,SK,Slovakia,EURO,0,336,0,0
19365,2020-04-01T00:00:00Z,SK,Slovakia,EURO,27,363,0,0
19366,2020-04-02T00:00:00Z,SK,Slovakia,EURO,37,400,0,0
19367,2020-04-03T00:00:00Z,SK,Slovakia,EURO,26,426,0,0
19368,2020-04-04T00:00:00Z,SK,Slovakia,EURO,24,450,0,0
19369,2020-04-05T00:00:00Z,SK,Slovakia,EURO,21,471,0,0
19370,2020-04-06T00:00:00Z,SK,Slovakia,EURO,14,485,0,0
19371,2020-04-07T00:00:00Z,SK,Slovakia,EURO,49,534,2,2
19372,2020-04-08T00:00:00Z,SK,Slovakia,EURO,64,598,0,2
19373,2020-04-09T00:00:00Z,SK,Slovakia,EURO,84,682,0,2
19374,2020-04-10T00:00:00Z,SK,Slovakia,EURO,19,701,0,2
19375,2020-04-11T00:00:00Z,SK,Slovakia,EURO,14,715,0,2
19376,2020-04-12T00:00:00Z,SK,Slovakia,EURO,13,728,0,2
19377,2020-04-13T00:00:00Z,SK,Slovakia,EURO,14,742,0,2
19378,2020-04-14T00:00:00Z,SK,Slovakia,EURO,27,769,0,2
19379,2020-04-15T00:00:00Z,SK,Slovakia,EURO,66,835,0,2
19380,2020-04-16T00:00:00Z,SK,Slovakia,EURO,28,863,4,6
19381,2020-04-17T00:00:00Z,SK,Slovakia,EURO,114,977,2,8
19382,2020-04-18T00:00:00Z,SK,Slovakia,EURO,72,1049,1,9
19383,2020-04-19T00:00:00Z,SK,Slovakia,EURO,40,1089,2,11
19384,2020-04-20T00:00:00Z,SK,Slovakia,EURO,72,1161,1,12
19385,2020-04-21T00:00:00Z,SK,Slovakia,EURO,12,1173,1,13
19386,2020-04-22T00:00:00Z,SK,Slovakia,EURO,26,1199,1,14
19387,2020-04-23T00:00:00Z,SK,Slovakia,EURO,45,1244,0,14
19388,2020-04-24T00:00:00Z,SK,Slovakia,EURO,81,1325,1,15
19389,2020-04-25T00:00:00Z,SK,Slovakia,EURO,35,1360,2,17
19390,2020-04-26T00:00:00Z,SK,Slovakia,EURO,13,1373,0,17
19391,2020-04-27T00:00:00Z,SK,Slovakia,EURO,6,1379,1,18
19392,2020-04-28T00:00:00Z,SK,Slovakia,EURO,2,1381,0,18
19393,2020-04-29T00:00:00Z,SK,Slovakia,EURO,3,1384,2,20
19394,2020-04-30T00:00:00Z,SK,Slovakia,EURO,7,1391,2,22
19395,2020-05-01T00:00:00Z,SK,Slovakia,EURO,5,1396,1,23
19396,2020-05-02T00:00:00Z,SK,Slovakia,EURO,7,1403,0,23
19397,2020-05-03T00:00:00Z,SK,Slovakia,EURO,4,1407,1,24
19398,2020-05-04T00:00:00Z,SK,Slovakia,EURO,1,1408,0,24
19399,2020-05-05T00:00:00Z,SK,Slovakia,EURO,5,1413,1,25
19400,2020-05-06T00:00:00Z,SK,Slovakia,EURO,8,1421,0,25
19401,2020-05-07T00:00:00Z,SK,Slovakia,EURO,8,1429,0,25
19402,2020-05-08T00:00:00Z,SK,Slovakia,EURO,16,1445,1,26
19403,2020-05-09T00:00:00Z,SK,Slovakia,EURO,10,1455,0,26
19404,2020-05-10T00:00:00Z,SK,Slovakia,EURO,0,1455,0,26
19405,2020-05-11T00:00:00Z,SK,Slovakia,EURO,2,1457,0,26
19406,2020-05-12T00:00:00Z,SK,Slovakia,EURO,0,1457,0,26
19407,2020-05-13T00:00:00Z,SK,Slovakia,EURO,8,1465,1,27
19408,2020-05-14T00:00:00Z,SK,Slovakia,EURO,4,1469,0,27
19409,2020-05-15T00:00:00Z,SK,Slovakia,EURO,8,1477,0,27
19410,2020-05-16T00:00:00Z,SK,Slovakia,EURO,3,1480,0,27
19411,2020-05-17T00:00:00Z,SK,Slovakia,EURO,13,1493,1,28
19412,2020-05-18T00:00:00Z,SK,Slovakia,EURO,1,1494,0,28
19413,2020-05-19T00:00:00Z,SK,Slovakia,EURO,1,1495,0,28
19414,2020-05-20T00:00:00Z,SK,Slovakia,EURO,0,1495,0,28
19415,2020-05-21T00:00:00Z,SK,Slovakia,EURO,1,1496,0,28
19416,2020-05-22T00:00:00Z,SK,Slovakia,EURO,6,1502,0,28
19417,2020-05-23T00:00:00Z,SK,Slovakia,EURO,1,1503,0,28
19418,2020-05-24T00:00:00Z,SK,Slovakia,EURO,1,1504,0,28
19419,2020-05-25T00:00:00Z,SK,Slovakia,EURO,5,1509,0,28
19420,2020-05-26T00:00:00Z,SK,Slovakia,EURO,2,1511,0,28
19421,2020-05-27T00:00:00Z,SK,Slovakia,EURO,2,1513,0,28
19422,2020-05-28T00:00:00Z,SK,Slovakia,EURO,2,1515,0,28
19423,2020-05-29T00:00:00Z,SK,Slovakia,EURO,5,1520,0,28
19424,2020-05-30T00:00:00Z,SK,Slovakia,EURO,0,1520,0,28
19425,2020-05-31T00:00:00Z,SK,Slovakia,EURO,1,1521,0,28
19426,2020-06-01T00:00:00Z,SK,Slovakia,EURO,1,1522,0,28
19427,2020-06-02T00:00:00Z,SK,Slovakia,EURO,0,1522,0,28
19428,2020-06-03T00:00:00Z,SK,Slovakia,EURO,0,1522,0,28
19429,2020-06-04T00:00:00Z,SK,Slovakia,EURO,3,1525,0,28
19430,2020-06-05T00:00:00Z,SK,Slovakia,EURO,1,1526,0,28
19431,2020-06-06T00:00:00Z,SK,Slovakia,EURO,0,1526,0,28
19432,2020-06-07T00:00:00Z,SK,Slovakia,EURO,2,1528,0,28
19433,2020-06-08T00:00:00Z,SK,Slovakia,EURO,0,1528,0,28
19434,2020-06-09T00:00:00Z,SK,Slovakia,EURO,2,1530,0,28
19435,2020-06-10T00:00:00Z,SK,Slovakia,EURO,1,1531,0,28
19436,2020-06-11T00:00:00Z,SK,Slovakia,EURO,2,1533,0,28
19437,2020-06-12T00:00:00Z,SK,Slovakia,EURO,8,1541,0,28
19438,2020-06-13T00:00:00Z,SK,Slovakia,EURO,1,1542,0,28
19439,2020-06-14T00:00:00Z,SK,Slovakia,EURO,3,1545,0,28
19440,2020-06-15T00:00:00Z,SK,Slovakia,EURO,3,1548,0,28
19441,2020-06-16T00:00:00Z,SK,Slovakia,EURO,4,1552,0,28
19442,2020-06-17T00:00:00Z,SK,Slovakia,EURO,0,1552,0,28
19443,2020-06-18T00:00:00Z,SK,Slovakia,EURO,9,1561,0,28
19444,2020-06-19T00:00:00Z,SK,Slovakia,EURO,1,1562,0,28
19445,2020-06-20T00:00:00Z,SK,Slovakia,EURO,14,1576,0,28
19446,2020-03-04T00:00:00Z,SI,Slovenia,EURO,1,1,0,0
19447,2020-03-05T00:00:00Z,SI,Slovenia,EURO,4,5,0,0
19448,2020-03-06T00:00:00Z,SI,Slovenia,EURO,4,9,0,0
19449,2020-03-07T00:00:00Z,SI,Slovenia,EURO,3,12,0,0
19450,2020-03-08T00:00:00Z,SI,Slovenia,EURO,4,16,0,0
19451,2020-03-09T00:00:00Z,SI,Slovenia,EURO,0,16,0,0
19452,2020-03-10T00:00:00Z,SI,Slovenia,EURO,7,23,0,0
19453,2020-03-11T00:00:00Z,SI,Slovenia,EURO,34,57,0,0
19454,2020-03-12T00:00:00Z,SI,Slovenia,EURO,0,57,0,0
19455,2020-03-13T00:00:00Z,SI,Slovenia,EURO,84,141,0,0
19456,2020-03-14T00:00:00Z,SI,Slovenia,EURO,0,141,0,0
19457,2020-03-15T00:00:00Z,SI,Slovenia,EURO,78,219,0,0
19458,2020-03-16T00:00:00Z,SI,Slovenia,EURO,34,253,0,0
19459,2020-03-17T00:00:00Z,SI,Slovenia,EURO,22,275,1,1
19460,2020-03-18T00:00:00Z,SI,Slovenia,EURO,11,286,0,1
19461,2020-03-19T00:00:00Z,SI,Slovenia,EURO,33,319,0,1
19462,2020-03-20T00:00:00Z,SI,Slovenia,EURO,22,341,0,1
19463,2020-03-21T00:00:00Z,SI,Slovenia,EURO,42,383,0,1
19464,2020-03-22T00:00:00Z,SI,Slovenia,EURO,0,383,0,1
19465,2020-03-23T00:00:00Z,SI,Slovenia,EURO,31,414,0,1
19466,2020-03-24T00:00:00Z,SI,Slovenia,EURO,28,442,0,1
19467,2020-03-25T00:00:00Z,SI,Slovenia,EURO,38,480,2,3
19468,2020-03-26T00:00:00Z,SI,Slovenia,EURO,48,528,1,4
19469,2020-03-27T00:00:00Z,SI,Slovenia,EURO,49,577,1,5
19470,2020-03-28T00:00:00Z,SI,Slovenia,EURO,55,632,4,9
19471,2020-03-29T00:00:00Z,SI,Slovenia,EURO,59,691,0,9
19472,2020-03-30T00:00:00Z,SI,Slovenia,EURO,39,730,2,11
19473,2020-03-31T00:00:00Z,SI,Slovenia,EURO,33,763,0,11
19474,2020-04-01T00:00:00Z,SI,Slovenia,EURO,51,814,2,13
19475,2020-04-02T00:00:00Z,SI,Slovenia,EURO,27,841,2,15
19476,2020-04-03T00:00:00Z,SI,Slovenia,EURO,56,897,1,16
19477,2020-04-04T00:00:00Z,SI,Slovenia,EURO,37,934,4,20
19478,2020-04-05T00:00:00Z,SI,Slovenia,EURO,43,977,2,22
19479,2020-04-06T00:00:00Z,SI,Slovenia,EURO,20,997,6,28
19480,2020-04-07T00:00:00Z,SI,Slovenia,EURO,24,1021,2,30
19481,2020-04-08T00:00:00Z,SI,Slovenia,EURO,34,1055,6,36
19482,2020-04-09T00:00:00Z,SI,Slovenia,EURO,36,1091,4,40
19483,2020-04-10T00:00:00Z,SI,Slovenia,EURO,33,1124,3,43
19484,2020-04-11T00:00:00Z,SI,Slovenia,EURO,36,1160,2,45
19485,2020-04-12T00:00:00Z,SI,Slovenia,EURO,28,1188,5,50
19486,2020-04-13T00:00:00Z,SI,Slovenia,EURO,17,1205,3,53
19487,2020-04-14T00:00:00Z,SI,Slovenia,EURO,7,1212,2,55
19488,2020-04-15T00:00:00Z,SI,Slovenia,EURO,8,1220,1,56
19489,2020-04-16T00:00:00Z,SI,Slovenia,EURO,28,1248,5,61
19490,2020-04-17T00:00:00Z,SI,Slovenia,EURO,20,1268,0,61
19491,2020-04-18T00:00:00Z,SI,Slovenia,EURO,36,1304,5,66
19492,2020-04-19T00:00:00Z,SI,Slovenia,EURO,13,1317,4,70
19493,2020-04-20T00:00:00Z,SI,Slovenia,EURO,13,1330,4,74
19494,2020-04-21T00:00:00Z,SI,Slovenia,EURO,5,1335,0,74
19495,2020-04-22T00:00:00Z,SI,Slovenia,EURO,5,1340,3,77
19496,2020-04-23T00:00:00Z,SI,Slovenia,EURO,13,1353,2,79
19497,2020-04-24T00:00:00Z,SI,Slovenia,EURO,13,1366,0,79
19498,2020-04-25T00:00:00Z,SI,Slovenia,EURO,7,1373,1,80
19499,2020-04-26T00:00:00Z,SI,Slovenia,EURO,15,1388,1,81
19500,2020-04-27T00:00:00Z,SI,Slovenia,EURO,19,1407,1,82
19501,2020-04-28T00:00:00Z,SI,Slovenia,EURO,0,1407,1,83
19502,2020-04-29T00:00:00Z,SI,Slovenia,EURO,1,1408,3,86
19503,2020-04-30T00:00:00Z,SI,Slovenia,EURO,10,1418,3,89
19504,2020-05-01T00:00:00Z,SI,Slovenia,EURO,11,1429,2,91
19505,2020-05-02T00:00:00Z,SI,Slovenia,EURO,5,1434,2,93
19506,2020-05-03T00:00:00Z,SI,Slovenia,EURO,5,1439,1,94
19507,2020-05-04T00:00:00Z,SI,Slovenia,EURO,0,1439,2,96
19508,2020-05-05T00:00:00Z,SI,Slovenia,EURO,6,1445,1,97
19509,2020-05-06T00:00:00Z,SI,Slovenia,EURO,3,1448,1,98
19510,2020-05-07T00:00:00Z,SI,Slovenia,EURO,1,1449,1,99
19511,2020-05-08T00:00:00Z,SI,Slovenia,EURO,1,1450,0,99
19512,2020-05-09T00:00:00Z,SI,Slovenia,EURO,4,1454,1,100
19513,2020-05-10T00:00:00Z,SI,Slovenia,EURO,3,1457,1,101
19514,2020-05-11T00:00:00Z,SI,Slovenia,EURO,3,1460,1,102
19515,2020-05-12T00:00:00Z,SI,Slovenia,EURO,1,1461,0,102
19516,2020-05-13T00:00:00Z,SI,Slovenia,EURO,2,1463,0,102
19517,2020-05-14T00:00:00Z,SI,Slovenia,EURO,1,1464,1,103
19518,2020-05-15T00:00:00Z,SI,Slovenia,EURO,1,1465,0,103
19519,2020-05-16T00:00:00Z,SI,Slovenia,EURO,0,1465,0,103
19520,2020-05-17T00:00:00Z,SI,Slovenia,EURO,1,1466,0,103
19521,2020-05-18T00:00:00Z,SI,Slovenia,EURO,0,1466,1,104
19522,2020-05-19T00:00:00Z,SI,Slovenia,EURO,1,1467,0,104
19523,2020-05-20T00:00:00Z,SI,Slovenia,EURO,1,1468,0,104
19524,2020-05-21T00:00:00Z,SI,Slovenia,EURO,0,1468,2,106
19525,2020-05-22T00:00:00Z,SI,Slovenia,EURO,0,1468,0,106
19526,2020-05-23T00:00:00Z,SI,Slovenia,EURO,0,1468,0,106
19527,2020-05-24T00:00:00Z,SI,Slovenia,EURO,0,1468,0,106
19528,2020-05-25T00:00:00Z,SI,Slovenia,EURO,1,1469,0,106
19529,2020-05-26T00:00:00Z,SI,Slovenia,EURO,0,1469,0,106
19530,2020-05-27T00:00:00Z,SI,Slovenia,EURO,0,1469,0,106
19531,2020-05-28T00:00:00Z,SI,Slovenia,EURO,2,1471,1,107
19532,2020-05-29T00:00:00Z,SI,Slovenia,EURO,2,1473,1,108
19533,2020-05-30T00:00:00Z,SI,Slovenia,EURO,0,1473,0,108
19534,2020-05-31T00:00:00Z,SI,Slovenia,EURO,0,1473,0,108
19535,2020-06-01T00:00:00Z,SI,Slovenia,EURO,0,1473,0,108
19536,2020-06-02T00:00:00Z,SI,Slovenia,EURO,2,1475,0,108
19537,2020-06-03T00:00:00Z,SI,Slovenia,EURO,0,1475,0,108
19538,2020-06-04T00:00:00Z,SI,Slovenia,EURO,2,1477,0,108
19539,2020-06-05T00:00:00Z,SI,Slovenia,EURO,2,1479,0,108
19540,2020-06-06T00:00:00Z,SI,Slovenia,EURO,5,1484,0,108
19541,2020-06-07T00:00:00Z,SI,Slovenia,EURO,1,1485,0,108
19542,2020-06-08T00:00:00Z,SI,Slovenia,EURO,0,1485,0,108
19543,2020-06-09T00:00:00Z,SI,Slovenia,EURO,0,1485,0,108
19544,2020-06-10T00:00:00Z,SI,Slovenia,EURO,1,1486,0,108
19545,2020-06-11T00:00:00Z,SI,Slovenia,EURO,2,1488,1,109
19546,2020-06-12T00:00:00Z,SI,Slovenia,EURO,0,1488,0,109
19547,2020-06-13T00:00:00Z,SI,Slovenia,EURO,2,1490,0,109
19548,2020-06-14T00:00:00Z,SI,Slovenia,EURO,2,1492,0,109
19549,2020-06-15T00:00:00Z,SI,Slovenia,EURO,3,1495,0,109
19550,2020-06-16T00:00:00Z,SI,Slovenia,EURO,1,1496,0,109
19551,2020-06-17T00:00:00Z,SI,Slovenia,EURO,3,1499,0,109
19552,2020-06-18T00:00:00Z,SI,Slovenia,EURO,4,1503,0,109
19553,2020-06-19T00:00:00Z,SI,Slovenia,EURO,8,1511,0,109
19554,2020-06-20T00:00:00Z,SI,Slovenia,EURO,2,1513,0,109
19836,2020-01-31T00:00:00Z,ES,Spain,EURO,1,1,0,0
19837,2020-02-01T00:00:00Z,ES,Spain,EURO,0,1,0,0
19838,2020-02-02T00:00:00Z,ES,Spain,EURO,0,1,0,0
19839,2020-02-03T00:00:00Z,ES,Spain,EURO,0,1,0,0
19840,2020-02-04T00:00:00Z,ES,Spain,EURO,0,1,0,0
19841,2020-02-05T00:00:00Z,ES,Spain,EURO,0,1,0,0
19842,2020-02-06T00:00:00Z,ES,Spain,EURO,0,1,0,0
19843,2020-02-07T00:00:00Z,ES,Spain,EURO,0,1,0,0
19844,2020-02-08T00:00:00Z,ES,Spain,EURO,0,1,0,0
19845,2020-02-09T00:00:00Z,ES,Spain,EURO,1,2,0,0
19846,2020-02-10T00:00:00Z,ES,Spain,EURO,0,2,0,0
19847,2020-02-11T00:00:00Z,ES,Spain,EURO,0,2,0,0
19848,2020-02-12T00:00:00Z,ES,Spain,EURO,0,2,0,0
19849,2020-02-13T00:00:00Z,ES,Spain,EURO,0,2,0,0
19850,2020-02-14T00:00:00Z,ES,Spain,EURO,0,2,0,0
19851,2020-02-15T00:00:00Z,ES,Spain,EURO,0,2,0,0
19852,2020-02-16T00:00:00Z,ES,Spain,EURO,0,2,0,0
19853,2020-02-17T00:00:00Z,ES,Spain,EURO,0,2,0,0
19854,2020-02-18T00:00:00Z,ES,Spain,EURO,0,2,0,0
19855,2020-02-19T00:00:00Z,ES,Spain,EURO,0,2,0,0
19856,2020-02-20T00:00:00Z,ES,Spain,EURO,0,2,0,0
19857,2020-02-21T00:00:00Z,ES,Spain,EURO,0,2,0,0
19858,2020-02-22T00:00:00Z,ES,Spain,EURO,0,2,0,0
19859,2020-02-23T00:00:00Z,ES,Spain,EURO,0,2,0,0
19860,2020-02-24T00:00:00Z,ES,Spain,EURO,0,2,0,0
19861,2020-02-25T00:00:00Z,ES,Spain,EURO,0,2,0,0
19862,2020-02-26T00:00:00Z,ES,Spain,EURO,10,12,0,0
19863,2020-02-27T00:00:00Z,ES,Spain,EURO,13,25,0,0
19864,2020-02-28T00:00:00Z,ES,Spain,EURO,7,32,0,0
19865,2020-02-29T00:00:00Z,ES,Spain,EURO,13,45,0,0
19866,2020-03-01T00:00:00Z,ES,Spain,EURO,0,45,0,0
19867,2020-03-02T00:00:00Z,ES,Spain,EURO,69,114,0,0
19868,2020-03-03T00:00:00Z,ES,Spain,EURO,37,151,0,0
19869,2020-03-04T00:00:00Z,ES,Spain,EURO,47,198,1,1
19870,2020-03-05T00:00:00Z,ES,Spain,EURO,59,257,2,3
19871,2020-03-06T00:00:00Z,ES,Spain,EURO,117,374,2,5
19872,2020-03-07T00:00:00Z,ES,Spain,EURO,56,430,0,5
19873,2020-03-08T00:00:00Z,ES,Spain,EURO,159,589,5,10
19874,2020-03-09T00:00:00Z,ES,Spain,EURO,435,1024,18,28
19875,2020-03-10T00:00:00Z,ES,Spain,EURO,615,1639,8,36
19876,2020-03-11T00:00:00Z,ES,Spain,EURO,501,2140,11,47
19877,2020-03-12T00:00:00Z,ES,Spain,EURO,825,2965,37,84
19878,2020-03-13T00:00:00Z,ES,Spain,EURO,1266,4231,36,120
19879,2020-03-14T00:00:00Z,ES,Spain,EURO,1522,5753,16,136
19880,2020-03-15T00:00:00Z,ES,Spain,EURO,2000,7753,152,288
19881,2020-03-16T00:00:00Z,ES,Spain,EURO,1438,9191,21,309
19882,2020-03-17T00:00:00Z,ES,Spain,EURO,1987,11178,182,491
19883,2020-03-18T00:00:00Z,ES,Spain,EURO,2538,13716,107,598
19884,2020-03-19T00:00:00Z,ES,Spain,EURO,3431,17147,169,767
19885,2020-03-20T00:00:00Z,ES,Spain,EURO,2833,19980,235,1002
19886,2020-03-21T00:00:00Z,ES,Spain,EURO,4946,24926,324,1326
19887,2020-03-22T00:00:00Z,ES,Spain,EURO,0,24926,0,1326
19888,2020-03-23T00:00:00Z,ES,Spain,EURO,3646,28572,394,1720
19889,2020-03-24T00:00:00Z,ES,Spain,EURO,4517,33089,462,2182
19890,2020-03-25T00:00:00Z,ES,Spain,EURO,6584,39673,514,2696
19891,2020-03-26T00:00:00Z,ES,Spain,EURO,7937,47610,738,3434
19892,2020-03-27T00:00:00Z,ES,Spain,EURO,8578,56188,655,4089
19893,2020-03-28T00:00:00Z,ES,Spain,EURO,7871,64059,769,4858
19894,2020-03-29T00:00:00Z,ES,Spain,EURO,8189,72248,832,5690
19895,2020-03-30T00:00:00Z,ES,Spain,EURO,6549,78797,838,6528
19896,2020-03-31T00:00:00Z,ES,Spain,EURO,6398,85195,812,7340
19897,2020-04-01T00:00:00Z,ES,Spain,EURO,9222,94417,849,8189
19898,2020-04-02T00:00:00Z,ES,Spain,EURO,7719,102136,864,9053
19899,2020-04-03T00:00:00Z,ES,Spain,EURO,8102,110238,950,10003
19900,2020-04-04T00:00:00Z,ES,Spain,EURO,7472,117710,932,10935
19901,2020-04-05T00:00:00Z,ES,Spain,EURO,7026,124736,809,11744
19902,2020-04-06T00:00:00Z,ES,Spain,EURO,6023,130759,674,12418
19903,2020-04-07T00:00:00Z,ES,Spain,EURO,4273,135032,637,13055
19904,2020-04-08T00:00:00Z,ES,Spain,EURO,5478,140510,743,13798
19905,2020-04-09T00:00:00Z,ES,Spain,EURO,6180,146690,757,14555
19906,2020-04-10T00:00:00Z,ES,Spain,EURO,5756,152446,683,15238
19907,2020-04-11T00:00:00Z,ES,Spain,EURO,4576,157022,605,15843
19908,2020-04-12T00:00:00Z,ES,Spain,EURO,4830,161852,510,16353
19909,2020-04-13T00:00:00Z,ES,Spain,EURO,4167,166019,619,16972
19910,2020-04-14T00:00:00Z,ES,Spain,EURO,3477,169496,517,17489
19911,2020-04-15T00:00:00Z,ES,Spain,EURO,6538,176034,567,18056
19912,2020-04-16T00:00:00Z,ES,Spain,EURO,4040,180074,523,18579
19913,2020-04-17T00:00:00Z,ES,Spain,EURO,4400,184474,551,19130
19914,2020-04-18T00:00:00Z,ES,Spain,EURO,4104,188578,348,19478
19915,2020-04-19T00:00:00Z,ES,Spain,EURO,0,188578,565,20043
19916,2020-04-20T00:00:00Z,ES,Spain,EURO,2585,191163,410,20453
19917,2020-04-21T00:00:00Z,ES,Spain,EURO,3352,194515,399,20852
19918,2020-04-22T00:00:00Z,ES,Spain,EURO,2627,197142,430,21282
19919,2020-04-23T00:00:00Z,ES,Spain,EURO,3052,200194,435,21717
19920,2020-04-24T00:00:00Z,ES,Spain,EURO,2767,202961,440,22157
19921,2020-04-25T00:00:00Z,ES,Spain,EURO,2944,205905,367,22524
19922,2020-04-26T00:00:00Z,ES,Spain,EURO,0,205905,0,22524
19923,2020-04-27T00:00:00Z,ES,Spain,EURO,1729,207634,666,23190
19924,2020-04-28T00:00:00Z,ES,Spain,EURO,1831,209465,0,23190
19925,2020-04-29T00:00:00Z,ES,Spain,EURO,1308,210773,632,23822
19926,2020-04-30T00:00:00Z,ES,Spain,EURO,2144,212917,453,24275
19927,2020-05-01T00:00:00Z,ES,Spain,EURO,518,213435,268,24543
19928,2020-05-02T00:00:00Z,ES,Spain,EURO,1781,215216,281,24824
19929,2020-05-03T00:00:00Z,ES,Spain,EURO,1366,216582,276,25100
19930,2020-05-04T00:00:00Z,ES,Spain,EURO,884,217466,164,25264
19931,2020-05-05T00:00:00Z,ES,Spain,EURO,545,218011,164,25428
19932,2020-05-06T00:00:00Z,ES,Spain,EURO,1318,219329,185,25613
19933,2020-05-07T00:00:00Z,ES,Spain,EURO,996,220325,244,25857
19934,2020-05-08T00:00:00Z,ES,Spain,EURO,1122,221447,213,26070
19935,2020-05-09T00:00:00Z,ES,Spain,EURO,1410,222857,181,26251
19936,2020-05-10T00:00:00Z,ES,Spain,EURO,721,223578,227,26478
19937,2020-05-11T00:00:00Z,ES,Spain,EURO,812,224390,143,26621
19938,2020-05-12T00:00:00Z,ES,Spain,EURO,3046,227436,123,26744
19939,2020-05-13T00:00:00Z,ES,Spain,EURO,594,228030,176,26920
19940,2020-05-14T00:00:00Z,ES,Spain,EURO,661,228691,184,27104
19941,2020-05-15T00:00:00Z,ES,Spain,EURO,849,229540,217,27321
19942,2020-05-16T00:00:00Z,ES,Spain,EURO,643,230183,138,27459
19943,2020-05-17T00:00:00Z,ES,Spain,EURO,515,230698,104,27563
19944,2020-05-18T00:00:00Z,ES,Spain,EURO,652,231350,87,27650
19945,2020-05-19T00:00:00Z,ES,Spain,EURO,256,231606,59,27709
19946,2020-05-20T00:00:00Z,ES,Spain,EURO,431,232037,69,27778
19947,2020-05-21T00:00:00Z,ES,Spain,EURO,518,232555,110,27888
19948,2020-05-22T00:00:00Z,ES,Spain,EURO,482,233037,52,27940
19949,2020-05-23T00:00:00Z,ES,Spain,EURO,1787,234824,688,28628
19950,2020-05-24T00:00:00Z,ES,Spain,EURO,466,235290,50,28678
19951,2020-05-25T00:00:00Z,ES,Spain,EURO,482,235772,74,28752
19952,2020-05-26T00:00:00Z,ES,Spain,EURO,-372,235400,-1918,26834
19953,2020-05-27T00:00:00Z,ES,Spain,EURO,859,236259,283,27117
19954,2020-05-28T00:00:00Z,ES,Spain,EURO,510,236769,1,27118
19955,2020-05-29T00:00:00Z,ES,Spain,EURO,1137,237906,1,27119
19956,2020-05-30T00:00:00Z,ES,Spain,EURO,658,238564,2,27121
19957,2020-05-31T00:00:00Z,ES,Spain,EURO,664,239228,4,27125
19958,2020-06-01T00:00:00Z,ES,Spain,EURO,201,239429,2,27127
19959,2020-06-02T00:00:00Z,ES,Spain,EURO,209,239638,813,27940
19960,2020-06-03T00:00:00Z,ES,Spain,EURO,294,239932,0,27940
19961,2020-06-04T00:00:00Z,ES,Spain,EURO,394,240326,0,27940
19962,2020-06-05T00:00:00Z,ES,Spain,EURO,334,240660,-807,27133
19963,2020-06-06T00:00:00Z,ES,Spain,EURO,318,240978,1,27134
19964,2020-06-07T00:00:00Z,ES,Spain,EURO,332,241310,1,27135
19965,2020-06-08T00:00:00Z,ES,Spain,EURO,240,241550,1,27136
19966,2020-06-09T00:00:00Z,ES,Spain,EURO,167,241717,0,27136
19967,2020-06-10T00:00:00Z,ES,Spain,EURO,249,241966,0,27136
19968,2020-06-11T00:00:00Z,ES,Spain,EURO,314,242280,0,27136
19969,2020-06-12T00:00:00Z,ES,Spain,EURO,427,242707,0,27136
19970,2020-06-13T00:00:00Z,ES,Spain,EURO,502,243209,0,27136
19971,2020-06-14T00:00:00Z,ES,Spain,EURO,396,243605,0,27136
19972,2020-06-15T00:00:00Z,ES,Spain,EURO,323,243928,0,27136
19973,2020-06-16T00:00:00Z,ES,Spain,EURO,181,244109,0,27136
19974,2020-06-17T00:00:00Z,ES,Spain,EURO,219,244328,0,27136
19975,2020-06-18T00:00:00Z,ES,Spain,EURO,355,244683,0,27136
19976,2020-06-19T00:00:00Z,ES,Spain,EURO,585,245268,0,27136
19977,2020-06-20T00:00:00Z,ES,Spain,EURO,307,245575,1179,28315
20321,2020-01-31T00:00:00Z,SE,Sweden,EURO,1,1,0,0
20322,2020-02-01T00:00:00Z,SE,Sweden,EURO,0,1,0,0
20323,2020-02-02T00:00:00Z,SE,Sweden,EURO,0,1,0,0
20324,2020-02-03T00:00:00Z,SE,Sweden,EURO,0,1,0,0
20325,2020-02-04T00:00:00Z,SE,Sweden,EURO,0,1,0,0
20326,2020-02-05T00:00:00Z,SE,Sweden,EURO,0,1,0,0
20327,2020-02-06T00:00:00Z,SE,Sweden,EURO,0,1,0,0
20328,2020-02-07T00:00:00Z,SE,Sweden,EURO,0,1,0,0
20329,2020-02-08T00:00:00Z,SE,Sweden,EURO,0,1,0,0
20330,2020-02-09T00:00:00Z,SE,Sweden,EURO,0,1,0,0
20331,2020-02-10T00:00:00Z,SE,Sweden,EURO,0,1,0,0
20332,2020-02-11T00:00:00Z,SE,Sweden,EURO,0,1,0,0
20333,2020-02-12T00:00:00Z,SE,Sweden,EURO,0,1,0,0
20334,2020-02-13T00:00:00Z,SE,Sweden,EURO,0,1,0,0
20335,2020-02-14T00:00:00Z,SE,Sweden,EURO,0,1,0,0
20336,2020-02-15T00:00:00Z,SE,Sweden,EURO,0,1,0,0
20337,2020-02-16T00:00:00Z,SE,Sweden,EURO,0,1,0,0
20338,2020-02-17T00:00:00Z,SE,Sweden,EURO,0,1,0,0
20339,2020-02-18T00:00:00Z,SE,Sweden,EURO,0,1,0,0
20340,2020-02-19T00:00:00Z,SE,Sweden,EURO,0,1,0,0
20341,2020-02-20T00:00:00Z,SE,Sweden,EURO,0,1,0,0
20342,2020-02-21T00:00:00Z,SE,Sweden,EURO,0,1,0,0
20343,2020-02-22T00:00:00Z,SE,Sweden,EURO,0,1,0,0
20344,2020-02-23T00:00:00Z,SE,Sweden,EURO,0,1,0,0
20345,2020-02-24T00:00:00Z,SE,Sweden,EURO,0,1,0,0
20346,2020-02-25T00:00:00Z,SE,Sweden,EURO,0,1,0,0
20347,2020-02-26T00:00:00Z,SE,Sweden,EURO,1,2,0,0
20348,2020-02-27T00:00:00Z,SE,Sweden,EURO,5,7,0,0
20349,2020-02-28T00:00:00Z,SE,Sweden,EURO,4,11,0,0
20350,2020-02-29T00:00:00Z,SE,Sweden,EURO,2,13,0,0
20351,2020-03-01T00:00:00Z,SE,Sweden,EURO,1,14,0,0
20352,2020-03-02T00:00:00Z,SE,Sweden,EURO,1,15,0,0
20353,2020-03-03T00:00:00Z,SE,Sweden,EURO,9,24,0,0
20354,2020-03-04T00:00:00Z,SE,Sweden,EURO,11,35,0,0
20355,2020-03-05T00:00:00Z,SE,Sweden,EURO,26,61,0,0
20356,2020-03-06T00:00:00Z,SE,Sweden,EURO,76,137,0,0
20357,2020-03-07T00:00:00Z,SE,Sweden,EURO,24,161,0,0
20358,2020-03-08T00:00:00Z,SE,Sweden,EURO,42,203,0,0
20359,2020-03-09T00:00:00Z,SE,Sweden,EURO,45,248,0,0
20360,2020-03-10T00:00:00Z,SE,Sweden,EURO,78,326,0,0
20361,2020-03-11T00:00:00Z,SE,Sweden,EURO,135,461,0,0
20362,2020-03-12T00:00:00Z,SE,Sweden,EURO,159,620,0,0
20363,2020-03-13T00:00:00Z,SE,Sweden,EURO,155,775,0,0
20364,2020-03-14T00:00:00Z,SE,Sweden,EURO,149,924,0,0
20365,2020-03-15T00:00:00Z,SE,Sweden,EURO,68,992,3,3
20366,2020-03-16T00:00:00Z,SE,Sweden,EURO,67,1059,0,3
20367,2020-03-17T00:00:00Z,SE,Sweden,EURO,108,1167,0,3
20368,2020-03-18T00:00:00Z,SE,Sweden,EURO,112,1279,0,3
20369,2020-03-19T00:00:00Z,SE,Sweden,EURO,144,1423,0,3
20370,2020-03-20T00:00:00Z,SE,Sweden,EURO,200,1623,13,16
20371,2020-03-21T00:00:00Z,SE,Sweden,EURO,123,1746,4,20
20372,2020-03-22T00:00:00Z,SE,Sweden,EURO,0,1746,0,20
20373,2020-03-23T00:00:00Z,SE,Sweden,EURO,160,1906,1,21
20374,2020-03-24T00:00:00Z,SE,Sweden,EURO,110,2016,4,25
20375,2020-03-25T00:00:00Z,SE,Sweden,EURO,256,2272,11,36
20376,2020-03-26T00:00:00Z,SE,Sweden,EURO,238,2510,6,42
20377,2020-03-27T00:00:00Z,SE,Sweden,EURO,296,2806,24,66
20378,2020-03-28T00:00:00Z,SE,Sweden,EURO,240,3046,26,92
20379,2020-03-29T00:00:00Z,SE,Sweden,EURO,401,3447,10,102
20380,2020-03-30T00:00:00Z,SE,Sweden,EURO,253,3700,8,110
20381,2020-03-31T00:00:00Z,SE,Sweden,EURO,328,4028,36,146
20382,2020-04-01T00:00:00Z,SE,Sweden,EURO,407,4435,34,180
20383,2020-04-02T00:00:00Z,SE,Sweden,EURO,512,4947,59,239
20384,2020-04-03T00:00:00Z,SE,Sweden,EURO,519,5466,43,282
20385,2020-04-04T00:00:00Z,SE,Sweden,EURO,612,6078,51,333
20386,2020-04-05T00:00:00Z,SE,Sweden,EURO,365,6443,40,373
20387,2020-04-06T00:00:00Z,SE,Sweden,EURO,387,6830,28,401
20388,2020-04-07T00:00:00Z,SE,Sweden,EURO,376,7206,76,477
20389,2020-04-08T00:00:00Z,SE,Sweden,EURO,487,7693,114,591
20390,2020-04-09T00:00:00Z,SE,Sweden,EURO,726,8419,96,687
20391,2020-04-10T00:00:00Z,SE,Sweden,EURO,722,9141,106,793
20392,2020-04-11T00:00:00Z,SE,Sweden,EURO,544,9685,77,870
20393,2020-04-12T00:00:00Z,SE,Sweden,EURO,466,10151,17,887
20394,2020-04-13T00:00:00Z,SE,Sweden,EURO,332,10483,12,899
20395,2020-04-14T00:00:00Z,SE,Sweden,EURO,465,10948,20,919
20396,2020-04-15T00:00:00Z,SE,Sweden,EURO,497,11445,114,1033
20397,2020-04-16T00:00:00Z,SE,Sweden,EURO,482,11927,170,1203
20398,2020-04-17T00:00:00Z,SE,Sweden,EURO,613,12540,130,1333
20399,2020-04-18T00:00:00Z,SE,Sweden,EURO,676,13216,67,1400
20400,2020-04-19T00:00:00Z,SE,Sweden,EURO,606,13822,111,1511
20401,2020-04-20T00:00:00Z,SE,Sweden,EURO,563,14385,29,1540
20402,2020-04-21T00:00:00Z,SE,Sweden,EURO,392,14777,40,1580
20403,2020-04-22T00:00:00Z,SE,Sweden,EURO,545,15322,185,1765
20404,2020-04-23T00:00:00Z,SE,Sweden,EURO,682,16004,172,1937
20405,2020-04-24T00:00:00Z,SE,Sweden,EURO,751,16755,84,2021
20406,2020-04-25T00:00:00Z,SE,Sweden,EURO,812,17567,131,2152
20407,2020-04-26T00:00:00Z,SE,Sweden,EURO,610,18177,40,2192
20408,2020-04-27T00:00:00Z,SE,Sweden,EURO,463,18640,2,2194
20409,2020-04-28T00:00:00Z,SE,Sweden,EURO,286,18926,80,2274
20410,2020-04-29T00:00:00Z,SE,Sweden,EURO,695,19621,81,2355
20411,2020-04-30T00:00:00Z,SE,Sweden,EURO,681,20302,107,2462
20412,2020-05-01T00:00:00Z,SE,Sweden,EURO,790,21092,124,2586
20413,2020-05-02T00:00:00Z,SE,Sweden,EURO,428,21520,67,2653
20414,2020-05-03T00:00:00Z,SE,Sweden,EURO,562,22082,16,2669
20415,2020-05-04T00:00:00Z,SE,Sweden,EURO,235,22317,10,2679
20416,2020-05-05T00:00:00Z,SE,Sweden,EURO,404,22721,90,2769
20417,2020-05-06T00:00:00Z,SE,Sweden,EURO,495,23216,85,2854
20418,2020-05-07T00:00:00Z,SE,Sweden,EURO,702,23918,87,2941
20419,2020-05-08T00:00:00Z,SE,Sweden,EURO,705,24623,99,3040
20420,2020-05-09T00:00:00Z,SE,Sweden,EURO,642,25265,135,3175
20421,2020-05-10T00:00:00Z,SE,Sweden,EURO,656,25921,45,3220
20422,2020-05-11T00:00:00Z,SE,Sweden,EURO,401,26322,5,3225
20423,2020-05-12T00:00:00Z,SE,Sweden,EURO,348,26670,31,3256
20424,2020-05-13T00:00:00Z,SE,Sweden,EURO,602,27272,57,3313
20425,2020-05-14T00:00:00Z,SE,Sweden,EURO,637,27909,147,3460
20426,2020-05-15T00:00:00Z,SE,Sweden,EURO,673,28582,69,3529
20427,2020-05-16T00:00:00Z,SE,Sweden,EURO,625,29207,117,3646
20428,2020-05-17T00:00:00Z,SE,Sweden,EURO,470,29677,28,3674
20429,2020-05-18T00:00:00Z,SE,Sweden,EURO,466,30143,5,3679
20430,2020-05-19T00:00:00Z,SE,Sweden,EURO,234,30377,19,3698
20431,2020-05-20T00:00:00Z,SE,Sweden,EURO,422,30799,45,3743
20432,2020-05-21T00:00:00Z,SE,Sweden,EURO,724,31523,88,3831
20433,2020-05-22T00:00:00Z,SE,Sweden,EURO,649,32172,40,3871
20434,2020-05-23T00:00:00Z,SE,Sweden,EURO,637,32809,54,3925
20435,2020-05-24T00:00:00Z,SE,Sweden,EURO,379,33188,67,3992
20436,2020-05-25T00:00:00Z,SE,Sweden,EURO,271,33459,6,3998
20437,2020-05-26T00:00:00Z,SE,Sweden,EURO,384,33843,31,4029
20438,2020-05-27T00:00:00Z,SE,Sweden,EURO,597,34440,96,4125
20439,2020-05-28T00:00:00Z,SE,Sweden,EURO,648,35088,95,4220
20440,2020-05-29T00:00:00Z,SE,Sweden,EURO,639,35727,46,4266
20441,2020-05-30T00:00:00Z,SE,Sweden,EURO,749,36476,84,4350
20442,2020-05-31T00:00:00Z,SE,Sweden,EURO,637,37113,45,4395
20443,2020-06-01T00:00:00Z,SE,Sweden,EURO,429,37542,0,4395
20444,2020-06-02T00:00:00Z,SE,Sweden,EURO,272,37814,8,4403
20445,2020-06-03T00:00:00Z,SE,Sweden,EURO,775,38589,65,4468
20446,2020-06-04T00:00:00Z,SE,Sweden,EURO,2214,40803,74,4542
20447,2020-06-05T00:00:00Z,SE,Sweden,EURO,1080,41883,20,4562
20448,2020-06-06T00:00:00Z,SE,Sweden,EURO,1056,42939,77,4639
20449,2020-06-07T00:00:00Z,SE,Sweden,EURO,948,43887,17,4656
20450,2020-06-08T00:00:00Z,SE,Sweden,EURO,843,44730,3,4659
20451,2020-06-09T00:00:00Z,SE,Sweden,EURO,403,45133,35,4694
20452,2020-06-10T00:00:00Z,SE,Sweden,EURO,791,45924,23,4717
20453,2020-06-11T00:00:00Z,SE,Sweden,EURO,890,46814,78,4795
20454,2020-06-12T00:00:00Z,SE,Sweden,EURO,1474,48288,19,4814
20455,2020-06-13T00:00:00Z,SE,Sweden,EURO,1396,49684,40,4854
20456,2020-06-14T00:00:00Z,SE,Sweden,EURO,1247,50931,20,4874
20457,2020-06-15T00:00:00Z,SE,Sweden,EURO,683,51614,0,4874
20458,2020-06-16T00:00:00Z,SE,Sweden,EURO,769,52383,17,4891
20459,2020-06-17T00:00:00Z,SE,Sweden,EURO,940,53323,48,4939
20460,2020-06-18T00:00:00Z,SE,Sweden,EURO,1239,54562,102,5041
20461,2020-06-19T00:00:00Z,SE,Sweden,EURO,1481,56043,12,5053
20462,2020-06-20T00:00:00Z,SE,Sweden,EURO,0,56043,0,5053
20463,2020-02-25T00:00:00Z,CH,Switzerland,EURO,1,1,0,0
20464,2020-02-26T00:00:00Z,CH,Switzerland,EURO,0,1,0,0
20465,2020-02-27T00:00:00Z,CH,Switzerland,EURO,5,6,0,0
20466,2020-02-28T00:00:00Z,CH,Switzerland,EURO,4,10,0,0
20467,2020-02-29T00:00:00Z,CH,Switzerland,EURO,8,18,0,0
20468,2020-03-01T00:00:00Z,CH,Switzerland,EURO,6,24,0,0
20469,2020-03-02T00:00:00Z,CH,Switzerland,EURO,6,30,0,0
20470,2020-03-03T00:00:00Z,CH,Switzerland,EURO,7,37,0,0
20471,2020-03-04T00:00:00Z,CH,Switzerland,EURO,20,57,0,0
20472,2020-03-05T00:00:00Z,CH,Switzerland,EURO,29,86,1,1
20473,2020-03-06T00:00:00Z,CH,Switzerland,EURO,123,209,0,1
20474,2020-03-07T00:00:00Z,CH,Switzerland,EURO,55,264,1,2
20475,2020-03-08T00:00:00Z,CH,Switzerland,EURO,68,332,0,2
20476,2020-03-09T00:00:00Z,CH,Switzerland,EURO,0,332,0,2
20477,2020-03-10T00:00:00Z,CH,Switzerland,EURO,159,491,1,3
20478,2020-03-11T00:00:00Z,CH,Switzerland,EURO,154,645,1,4
20479,2020-03-12T00:00:00Z,CH,Switzerland,EURO,213,858,0,4
20480,2020-03-13T00:00:00Z,CH,Switzerland,EURO,267,1125,3,7
20481,2020-03-14T00:00:00Z,CH,Switzerland,EURO,234,1359,4,11
20482,2020-03-15T00:00:00Z,CH,Switzerland,EURO,841,2200,2,13
20483,2020-03-16T00:00:00Z,CH,Switzerland,EURO,0,2200,1,14
20484,2020-03-17T00:00:00Z,CH,Switzerland,EURO,450,2650,5,19
20485,2020-03-18T00:00:00Z,CH,Switzerland,EURO,360,3010,2,21
20486,2020-03-19T00:00:00Z,CH,Switzerland,EURO,853,3863,12,33
20487,2020-03-20T00:00:00Z,CH,Switzerland,EURO,977,4840,10,43
20488,2020-03-21T00:00:00Z,CH,Switzerland,EURO,1237,6077,13,56
20489,2020-03-22T00:00:00Z,CH,Switzerland,EURO,0,6077,0,56
20490,2020-03-23T00:00:00Z,CH,Switzerland,EURO,894,6971,4,60
20491,2020-03-24T00:00:00Z,CH,Switzerland,EURO,1044,8015,6,66
20492,2020-03-25T00:00:00Z,CH,Switzerland,EURO,774,8789,20,86
20493,2020-03-26T00:00:00Z,CH,Switzerland,EURO,925,9714,17,103
20494,2020-03-27T00:00:00Z,CH,Switzerland,EURO,1000,10714,58,161
20495,2020-03-28T00:00:00Z,CH,Switzerland,EURO,1390,12104,36,197
20496,2020-03-29T00:00:00Z,CH,Switzerland,EURO,1048,13152,38,235
20497,2020-03-30T00:00:00Z,CH,Switzerland,EURO,1122,14274,22,257
20498,2020-03-31T00:00:00Z,CH,Switzerland,EURO,1138,15412,38,295
20499,2020-04-01T00:00:00Z,CH,Switzerland,EURO,696,16108,78,373
20500,2020-04-02T00:00:00Z,CH,Switzerland,EURO,962,17070,5,378
20501,2020-04-03T00:00:00Z,CH,Switzerland,EURO,1774,18844,84,462
20502,2020-04-04T00:00:00Z,CH,Switzerland,EURO,862,19706,71,533
20503,2020-04-05T00:00:00Z,CH,Switzerland,EURO,783,20489,59,592
20504,2020-04-06T00:00:00Z,CH,Switzerland,EURO,576,21065,49,641
20505,2020-04-07T00:00:00Z,CH,Switzerland,EURO,509,21574,0,641
20506,2020-04-08T00:00:00Z,CH,Switzerland,EURO,590,22164,0,641
20507,2020-04-09T00:00:00Z,CH,Switzerland,EURO,546,22710,64,705
20508,2020-04-10T00:00:00Z,CH,Switzerland,EURO,785,23495,51,756
20509,2020-04-11T00:00:00Z,CH,Switzerland,EURO,733,24228,49,805
20510,2020-04-12T00:00:00Z,CH,Switzerland,EURO,592,24820,26,831
20511,2020-04-13T00:00:00Z,CH,Switzerland,EURO,400,25220,27,858
20512,2020-04-14T00:00:00Z,CH,Switzerland,EURO,279,25499,27,885
20513,2020-04-15T00:00:00Z,CH,Switzerland,EURO,254,25753,15,900
20514,2020-04-16T00:00:00Z,CH,Switzerland,EURO,583,26336,73,973
20515,2020-04-17T00:00:00Z,CH,Switzerland,EURO,315,26651,43,1016
20516,2020-04-18T00:00:00Z,CH,Switzerland,EURO,346,26997,42,1058
20517,2020-04-19T00:00:00Z,CH,Switzerland,EURO,325,27322,52,1110
20518,2020-04-20T00:00:00Z,CH,Switzerland,EURO,336,27658,24,1134
20519,2020-04-21T00:00:00Z,CH,Switzerland,EURO,204,27862,7,1141
20520,2020-04-22T00:00:00Z,CH,Switzerland,EURO,119,27981,45,1186
20521,2020-04-23T00:00:00Z,CH,Switzerland,EURO,205,28186,30,1216
20522,2020-04-24T00:00:00Z,CH,Switzerland,EURO,228,28414,51,1267
20523,2020-04-25T00:00:00Z,CH,Switzerland,EURO,181,28595,41,1308
20524,2020-04-26T00:00:00Z,CH,Switzerland,EURO,383,28978,28,1336
20525,2020-04-27T00:00:00Z,CH,Switzerland,EURO,0,28978,0,1336
20526,2020-04-28T00:00:00Z,CH,Switzerland,EURO,103,29081,16,1352
20527,2020-04-29T00:00:00Z,CH,Switzerland,EURO,100,29181,27,1379
20528,2020-04-30T00:00:00Z,CH,Switzerland,EURO,143,29324,28,1407
20529,2020-05-01T00:00:00Z,CH,Switzerland,EURO,179,29503,15,1422
20530,2020-05-02T00:00:00Z,CH,Switzerland,EURO,119,29622,12,1434
20531,2020-05-03T00:00:00Z,CH,Switzerland,EURO,112,29734,32,1466
20532,2020-05-04T00:00:00Z,CH,Switzerland,EURO,88,29822,6,1472
20533,2020-05-05T00:00:00Z,CH,Switzerland,EURO,76,29898,4,1476
20534,2020-05-06T00:00:00Z,CH,Switzerland,EURO,28,29926,6,1482
20535,2020-05-07T00:00:00Z,CH,Switzerland,EURO,51,29977,22,1504
20536,2020-05-08T00:00:00Z,CH,Switzerland,EURO,66,30043,13,1517
20537,2020-05-09T00:00:00Z,CH,Switzerland,EURO,125,30168,14,1531
20538,2020-05-10T00:00:00Z,CH,Switzerland,EURO,0,30168,0,1531
20539,2020-05-11T00:00:00Z,CH,Switzerland,EURO,54,30222,6,1537
20540,2020-05-12T00:00:00Z,CH,Switzerland,EURO,39,30261,5,1542
20541,2020-05-13T00:00:00Z,CH,Switzerland,EURO,36,30297,18,1560
20542,2020-05-14T00:00:00Z,CH,Switzerland,EURO,33,30330,3,1563
20543,2020-05-15T00:00:00Z,CH,Switzerland,EURO,50,30380,25,1588
20544,2020-05-16T00:00:00Z,CH,Switzerland,EURO,51,30431,6,1594
20545,2020-05-17T00:00:00Z,CH,Switzerland,EURO,58,30489,7,1601
20546,2020-05-18T00:00:00Z,CH,Switzerland,EURO,15,30504,1,1602
20547,2020-05-19T00:00:00Z,CH,Switzerland,EURO,10,30514,0,1602
20548,2020-05-20T00:00:00Z,CH,Switzerland,EURO,21,30535,11,1613
20549,2020-05-21T00:00:00Z,CH,Switzerland,EURO,40,30575,16,1629
20550,2020-05-22T00:00:00Z,CH,Switzerland,EURO,36,30611,8,1637
20551,2020-05-23T00:00:00Z,CH,Switzerland,EURO,13,30624,0,1637
20552,2020-05-24T00:00:00Z,CH,Switzerland,EURO,18,30642,3,1640
20553,2020-05-25T00:00:00Z,CH,Switzerland,EURO,11,30653,0,1640
20554,2020-05-26T00:00:00Z,CH,Switzerland,EURO,10,30663,1,1641
20555,2020-05-27T00:00:00Z,CH,Switzerland,EURO,15,30678,6,1647
20556,2020-05-28T00:00:00Z,CH,Switzerland,EURO,15,30693,1,1648
20557,2020-05-29T00:00:00Z,CH,Switzerland,EURO,20,30713,6,1654
20558,2020-05-30T00:00:00Z,CH,Switzerland,EURO,32,30745,2,1656
20559,2020-05-31T00:00:00Z,CH,Switzerland,EURO,17,30762,0,1656
20560,2020-06-01T00:00:00Z,CH,Switzerland,EURO,17,30779,0,1656
20561,2020-06-02T00:00:00Z,CH,Switzerland,EURO,9,30788,0,1656
20562,2020-06-03T00:00:00Z,CH,Switzerland,EURO,3,30791,0,1656
20563,2020-06-04T00:00:00Z,CH,Switzerland,EURO,19,30810,3,1659
20564,2020-06-05T00:00:00Z,CH,Switzerland,EURO,20,30830,0,1659
20565,2020-06-06T00:00:00Z,CH,Switzerland,EURO,23,30853,0,1659
20566,2020-06-07T00:00:00Z,CH,Switzerland,EURO,20,30873,1,1660
20567,2020-06-08T00:00:00Z,CH,Switzerland,EURO,9,30882,0,1660
20568,2020-06-09T00:00:00Z,CH,Switzerland,EURO,7,30889,0,1660
20569,2020-06-10T00:00:00Z,CH,Switzerland,EURO,16,30905,2,1662
20570,2020-06-11T00:00:00Z,CH,Switzerland,EURO,23,30928,12,1674
20571,2020-06-12T00:00:00Z,CH,Switzerland,EURO,33,30961,0,1674
20572,2020-06-13T00:00:00Z,CH,Switzerland,EURO,19,30980,2,1676
20573,2020-06-14T00:00:00Z,CH,Switzerland,EURO,31,31011,0,1676
20574,2020-06-15T00:00:00Z,CH,Switzerland,EURO,23,31034,0,1676
20575,2020-06-16T00:00:00Z,CH,Switzerland,EURO,14,31048,0,1676
20576,2020-06-17T00:00:00Z,CH,Switzerland,EURO,15,31063,1,1677
20577,2020-06-18T00:00:00Z,CH,Switzerland,EURO,37,31100,0,1677
20578,2020-06-19T00:00:00Z,CH,Switzerland,EURO,17,31117,0,1677
20579,2020-06-20T00:00:00Z,CH,Switzerland,EURO,100,31217,3,1680
20670,2020-05-01T00:00:00Z,TJ,Tajikistan,EURO,15,15,0,0
20671,2020-05-02T00:00:00Z,TJ,Tajikistan,EURO,17,32,0,0
20672,2020-05-03T00:00:00Z,TJ,Tajikistan,EURO,44,76,2,2
20673,2020-05-04T00:00:00Z,TJ,Tajikistan,EURO,52,128,2,4
20674,2020-05-05T00:00:00Z,TJ,Tajikistan,EURO,102,230,3,7
20675,2020-05-06T00:00:00Z,TJ,Tajikistan,EURO,63,293,0,7
20676,2020-05-07T00:00:00Z,TJ,Tajikistan,EURO,86,379,2,9
20677,2020-05-08T00:00:00Z,TJ,Tajikistan,EURO,82,461,7,16
20678,2020-05-09T00:00:00Z,TJ,Tajikistan,EURO,61,522,2,18
20679,2020-05-10T00:00:00Z,TJ,Tajikistan,EURO,39,561,1,19
20680,2020-05-11T00:00:00Z,TJ,Tajikistan,EURO,51,612,1,20
20681,2020-05-12T00:00:00Z,TJ,Tajikistan,EURO,49,661,1,21
20682,2020-05-13T00:00:00Z,TJ,Tajikistan,EURO,68,729,2,23
20683,2020-05-14T00:00:00Z,TJ,Tajikistan,EURO,0,729,9,32
20684,2020-05-15T00:00:00Z,TJ,Tajikistan,EURO,356,1085,4,36
20685,2020-05-16T00:00:00Z,TJ,Tajikistan,EURO,33,1118,0,36
20686,2020-05-17T00:00:00Z,TJ,Tajikistan,EURO,204,1322,3,39
20687,2020-05-18T00:00:00Z,TJ,Tajikistan,EURO,0,1322,0,39
20688,2020-05-19T00:00:00Z,TJ,Tajikistan,EURO,407,1729,5,44
20689,2020-05-20T00:00:00Z,TJ,Tajikistan,EURO,207,1936,0,44
20690,2020-05-21T00:00:00Z,TJ,Tajikistan,EURO,204,2140,0,44
20691,2020-05-22T00:00:00Z,TJ,Tajikistan,EURO,210,2350,0,44
20692,2020-05-23T00:00:00Z,TJ,Tajikistan,EURO,201,2551,0,44
20693,2020-05-24T00:00:00Z,TJ,Tajikistan,EURO,187,2738,0,44
20694,2020-05-25T00:00:00Z,TJ,Tajikistan,EURO,191,2929,2,46
20695,2020-05-26T00:00:00Z,TJ,Tajikistan,EURO,171,3100,0,46
20696,2020-05-27T00:00:00Z,TJ,Tajikistan,EURO,166,3266,1,47
20697,2020-05-28T00:00:00Z,TJ,Tajikistan,EURO,158,3424,0,47
20698,2020-05-29T00:00:00Z,TJ,Tajikistan,EURO,139,3563,0,47
20699,2020-05-30T00:00:00Z,TJ,Tajikistan,EURO,123,3686,0,47
20700,2020-05-31T00:00:00Z,TJ,Tajikistan,EURO,121,3807,0,47
20701,2020-06-01T00:00:00Z,TJ,Tajikistan,EURO,123,3930,0,47
20702,2020-06-02T00:00:00Z,TJ,Tajikistan,EURO,83,4013,0,47
20703,2020-06-03T00:00:00Z,TJ,Tajikistan,EURO,87,4100,0,47
20704,2020-06-04T00:00:00Z,TJ,Tajikistan,EURO,91,4191,1,48
20705,2020-06-05T00:00:00Z,TJ,Tajikistan,EURO,98,4289,0,48
20706,2020-06-06T00:00:00Z,TJ,Tajikistan,EURO,81,4370,0,48
20707,2020-06-07T00:00:00Z,TJ,Tajikistan,EURO,83,4453,0,48
20708,2020-06-08T00:00:00Z,TJ,Tajikistan,EURO,76,4529,0,48
20709,2020-06-09T00:00:00Z,TJ,Tajikistan,EURO,80,4609,0,48
20710,2020-06-10T00:00:00Z,TJ,Tajikistan,EURO,81,4690,0,48
20711,2020-06-11T00:00:00Z,TJ,Tajikistan,EURO,73,4763,0,48
20712,2020-06-12T00:00:00Z,TJ,Tajikistan,EURO,71,4834,1,49
20713,2020-06-13T00:00:00Z,TJ,Tajikistan,EURO,68,4902,0,49
20714,2020-06-14T00:00:00Z,TJ,Tajikistan,EURO,69,4971,1,50
20715,2020-06-15T00:00:00Z,TJ,Tajikistan,EURO,64,5035,0,50
20716,2020-06-16T00:00:00Z,TJ,Tajikistan,EURO,62,5097,0,50
20717,2020-06-17T00:00:00Z,TJ,Tajikistan,EURO,63,5160,0,50
20718,2020-06-18T00:00:00Z,TJ,Tajikistan,EURO,61,5221,1,51
20719,2020-06-19T00:00:00Z,TJ,Tajikistan,EURO,58,5279,0,51
20720,2020-06-20T00:00:00Z,TJ,Tajikistan,EURO,59,5338,0,51
20881,2020-01-31T00:00:00Z,GB,The United Kingdom,EURO,2,2,0,0
20882,2020-02-01T00:00:00Z,GB,The United Kingdom,EURO,0,2,0,0
20883,2020-02-02T00:00:00Z,GB,The United Kingdom,EURO,0,2,0,0
20884,2020-02-03T00:00:00Z,GB,The United Kingdom,EURO,0,2,0,0
20885,2020-02-04T00:00:00Z,GB,The United Kingdom,EURO,0,2,0,0
20886,2020-02-05T00:00:00Z,GB,The United Kingdom,EURO,0,2,0,0
20887,2020-02-06T00:00:00Z,GB,The United Kingdom,EURO,1,3,0,0
20888,2020-02-07T00:00:00Z,GB,The United Kingdom,EURO,0,3,0,0
20889,2020-02-08T00:00:00Z,GB,The United Kingdom,EURO,0,3,0,0
20890,2020-02-09T00:00:00Z,GB,The United Kingdom,EURO,1,4,0,0
20891,2020-02-10T00:00:00Z,GB,The United Kingdom,EURO,4,8,0,0
20892,2020-02-11T00:00:00Z,GB,The United Kingdom,EURO,0,8,0,0
20893,2020-02-12T00:00:00Z,GB,The United Kingdom,EURO,1,9,0,0
20894,2020-02-13T00:00:00Z,GB,The United Kingdom,EURO,0,9,0,0
20895,2020-02-14T00:00:00Z,GB,The United Kingdom,EURO,0,9,0,0
20896,2020-02-15T00:00:00Z,GB,The United Kingdom,EURO,0,9,0,0
20897,2020-02-16T00:00:00Z,GB,The United Kingdom,EURO,0,9,0,0
20898,2020-02-17T00:00:00Z,GB,The United Kingdom,EURO,0,9,0,0
20899,2020-02-18T00:00:00Z,GB,The United Kingdom,EURO,0,9,0,0
20900,2020-02-19T00:00:00Z,GB,The United Kingdom,EURO,0,9,0,0
20901,2020-02-20T00:00:00Z,GB,The United Kingdom,EURO,0,9,0,0
20902,2020-02-21T00:00:00Z,GB,The United Kingdom,EURO,0,9,0,0
20903,2020-02-22T00:00:00Z,GB,The United Kingdom,EURO,0,9,0,0
20904,2020-02-23T00:00:00Z,GB,The United Kingdom,EURO,4,13,0,0
20905,2020-02-24T00:00:00Z,GB,The United Kingdom,EURO,0,13,0,0
20906,2020-02-25T00:00:00Z,GB,The United Kingdom,EURO,0,13,0,0
20907,2020-02-26T00:00:00Z,GB,The United Kingdom,EURO,0,13,0,0
20908,2020-02-27T00:00:00Z,GB,The United Kingdom,EURO,3,16,0,0
20909,2020-02-28T00:00:00Z,GB,The United Kingdom,EURO,4,20,0,0
20910,2020-02-29T00:00:00Z,GB,The United Kingdom,EURO,3,23,0,0
20911,2020-03-01T00:00:00Z,GB,The United Kingdom,EURO,13,36,0,0
20912,2020-03-02T00:00:00Z,GB,The United Kingdom,EURO,3,39,0,0
20913,2020-03-03T00:00:00Z,GB,The United Kingdom,EURO,12,51,0,0
20914,2020-03-04T00:00:00Z,GB,The United Kingdom,EURO,38,89,0,0
20915,2020-03-05T00:00:00Z,GB,The United Kingdom,EURO,29,118,0,0
20916,2020-03-06T00:00:00Z,GB,The United Kingdom,EURO,49,167,1,1
20917,2020-03-07T00:00:00Z,GB,The United Kingdom,EURO,43,210,1,2
20918,2020-03-08T00:00:00Z,GB,The United Kingdom,EURO,67,277,0,2
20919,2020-03-09T00:00:00Z,GB,The United Kingdom,EURO,46,323,1,3
20920,2020-03-10T00:00:00Z,GB,The United Kingdom,EURO,50,373,3,6
20921,2020-03-11T00:00:00Z,GB,The United Kingdom,EURO,87,460,0,6
20922,2020-03-12T00:00:00Z,GB,The United Kingdom,EURO,134,594,2,8
20923,2020-03-13T00:00:00Z,GB,The United Kingdom,EURO,208,802,2,10
20924,2020-03-14T00:00:00Z,GB,The United Kingdom,EURO,342,1144,11,21
20925,2020-03-15T00:00:00Z,GB,The United Kingdom,EURO,251,1395,14,35
20926,2020-03-16T00:00:00Z,GB,The United Kingdom,EURO,152,1547,20,55
20927,2020-03-17T00:00:00Z,GB,The United Kingdom,EURO,407,1954,5,60
20928,2020-03-18T00:00:00Z,GB,The United Kingdom,EURO,676,2630,43,103
20929,2020-03-19T00:00:00Z,GB,The United Kingdom,EURO,647,3277,41,144
20930,2020-03-20T00:00:00Z,GB,The United Kingdom,EURO,706,3983,33,177
20931,2020-03-21T00:00:00Z,GB,The United Kingdom,EURO,1035,5018,56,233
20932,2020-03-22T00:00:00Z,GB,The United Kingdom,EURO,0,5018,0,233
20933,2020-03-23T00:00:00Z,GB,The United Kingdom,EURO,669,5687,48,281
20934,2020-03-24T00:00:00Z,GB,The United Kingdom,EURO,967,6654,54,335
20935,2020-03-25T00:00:00Z,GB,The United Kingdom,EURO,1427,8081,87,422
20936,2020-03-26T00:00:00Z,GB,The United Kingdom,EURO,1452,9533,41,463
20937,2020-03-27T00:00:00Z,GB,The United Kingdom,EURO,2129,11662,115,578
20938,2020-03-28T00:00:00Z,GB,The United Kingdom,EURO,2885,14547,181,759
20939,2020-03-29T00:00:00Z,GB,The United Kingdom,EURO,2546,17093,260,1019
20940,2020-03-30T00:00:00Z,GB,The United Kingdom,EURO,2433,19526,209,1228
20941,2020-03-31T00:00:00Z,GB,The United Kingdom,EURO,2619,22145,180,1408
20942,2020-04-01T00:00:00Z,GB,The United Kingdom,EURO,3009,25154,381,1789
20943,2020-04-02T00:00:00Z,GB,The United Kingdom,EURO,4324,29478,743,2532
20944,2020-04-03T00:00:00Z,GB,The United Kingdom,EURO,4244,33722,389,2921
20945,2020-04-04T00:00:00Z,GB,The United Kingdom,EURO,4450,38172,684,3605
20946,2020-04-05T00:00:00Z,GB,The United Kingdom,EURO,3735,41907,708,4313
20947,2020-04-06T00:00:00Z,GB,The United Kingdom,EURO,5903,47810,621,4934
20948,2020-04-07T00:00:00Z,GB,The United Kingdom,EURO,3802,51612,439,5373
20949,2020-04-08T00:00:00Z,GB,The United Kingdom,EURO,3634,55246,786,6159
20950,2020-04-09T00:00:00Z,GB,The United Kingdom,EURO,5491,60737,938,7097
20951,2020-04-10T00:00:00Z,GB,The United Kingdom,EURO,4344,65081,881,7978
20952,2020-04-11T00:00:00Z,GB,The United Kingdom,EURO,5195,70276,980,8958
20953,2020-04-12T00:00:00Z,GB,The United Kingdom,EURO,8719,78995,917,9875
20954,2020-04-13T00:00:00Z,GB,The United Kingdom,EURO,5288,84283,737,10612
20955,2020-04-14T00:00:00Z,GB,The United Kingdom,EURO,4342,88625,717,11329
20956,2020-04-15T00:00:00Z,GB,The United Kingdom,EURO,5252,93877,778,12107
20957,2020-04-16T00:00:00Z,GB,The United Kingdom,EURO,4603,98480,761,12868
20958,2020-04-17T00:00:00Z,GB,The United Kingdom,EURO,4617,103097,861,13729
20959,2020-04-18T00:00:00Z,GB,The United Kingdom,EURO,5599,108696,847,14576
20960,2020-04-19T00:00:00Z,GB,The United Kingdom,EURO,5525,114221,888,15464
20961,2020-04-20T00:00:00Z,GB,The United Kingdom,EURO,5850,120071,596,16060
20962,2020-04-21T00:00:00Z,GB,The United Kingdom,EURO,4676,124747,449,16509
20963,2020-04-22T00:00:00Z,GB,The United Kingdom,EURO,4301,129048,828,17337
20964,2020-04-23T00:00:00Z,GB,The United Kingdom,EURO,4451,133499,763,18100
20965,2020-04-24T00:00:00Z,GB,The United Kingdom,EURO,4583,138082,638,18738
20966,2020-04-25T00:00:00Z,GB,The United Kingdom,EURO,5386,143468,768,19506
20967,2020-04-26T00:00:00Z,GB,The United Kingdom,EURO,4913,148381,813,20319
20968,2020-04-27T00:00:00Z,GB,The United Kingdom,EURO,4463,152844,413,20732
20969,2020-04-28T00:00:00Z,GB,The United Kingdom,EURO,4309,157153,360,21092
20970,2020-04-29T00:00:00Z,GB,The United Kingdom,EURO,3996,161149,586,21678
20971,2020-04-30T00:00:00Z,GB,The United Kingdom,EURO,4076,165225,4419,26097
20972,2020-05-01T00:00:00Z,GB,The United Kingdom,EURO,6032,171257,674,26771
20973,2020-05-02T00:00:00Z,GB,The United Kingdom,EURO,6201,177458,739,27510
20974,2020-05-03T00:00:00Z,GB,The United Kingdom,EURO,4806,182264,621,28131
20975,2020-05-04T00:00:00Z,GB,The United Kingdom,EURO,4339,186603,315,28446
20976,2020-05-05T00:00:00Z,GB,The United Kingdom,EURO,3985,190588,288,28734
20977,2020-05-06T00:00:00Z,GB,The United Kingdom,EURO,4406,194994,693,29427
20978,2020-05-07T00:00:00Z,GB,The United Kingdom,EURO,6211,201205,649,30076
20979,2020-05-08T00:00:00Z,GB,The United Kingdom,EURO,5514,206719,539,30615
20980,2020-05-09T00:00:00Z,GB,The United Kingdom,EURO,4649,211368,626,31241
20981,2020-05-10T00:00:00Z,GB,The United Kingdom,EURO,3896,215264,346,31587
20982,2020-05-11T00:00:00Z,GB,The United Kingdom,EURO,3923,219187,268,31855
20983,2020-05-12T00:00:00Z,GB,The United Kingdom,EURO,3877,223064,210,32065
20984,2020-05-13T00:00:00Z,GB,The United Kingdom,EURO,3403,226467,627,32692
20985,2020-05-14T00:00:00Z,GB,The United Kingdom,EURO,3242,229709,494,33186
20986,2020-05-15T00:00:00Z,GB,The United Kingdom,EURO,3446,233155,428,33614
20987,2020-05-16T00:00:00Z,GB,The United Kingdom,EURO,3560,236715,384,33998
20988,2020-05-17T00:00:00Z,GB,The United Kingdom,EURO,3450,240165,468,34466
20989,2020-05-18T00:00:00Z,GB,The United Kingdom,EURO,3534,243699,170,34636
20990,2020-05-19T00:00:00Z,GB,The United Kingdom,EURO,2711,246410,160,34796
20991,2020-05-20T00:00:00Z,GB,The United Kingdom,EURO,2412,248822,545,35341
20992,2020-05-21T00:00:00Z,GB,The United Kingdom,EURO,-525,248297,363,35704
20993,2020-05-22T00:00:00Z,GB,The United Kingdom,EURO,2615,250912,338,36042
20994,2020-05-23T00:00:00Z,GB,The United Kingdom,EURO,3287,254199,351,36393
20995,2020-05-24T00:00:00Z,GB,The United Kingdom,EURO,2959,257158,282,36675
20996,2020-05-25T00:00:00Z,GB,The United Kingdom,EURO,2405,259563,118,36793
20997,2020-05-26T00:00:00Z,GB,The United Kingdom,EURO,1625,261188,121,36914
20998,2020-05-27T00:00:00Z,GB,The United Kingdom,EURO,4043,265231,134,37048
20999,2020-05-28T00:00:00Z,GB,The United Kingdom,EURO,2013,267244,412,37460
21000,2020-05-29T00:00:00Z,GB,The United Kingdom,EURO,1887,269131,377,37837
21001,2020-05-30T00:00:00Z,GB,The United Kingdom,EURO,2095,271226,324,38161
21002,2020-05-31T00:00:00Z,GB,The United Kingdom,EURO,1604,272830,215,38376
21003,2020-06-01T00:00:00Z,GB,The United Kingdom,EURO,1936,274766,113,38489
21004,2020-06-02T00:00:00Z,GB,The United Kingdom,EURO,1570,276336,556,39045
21005,2020-06-03T00:00:00Z,GB,The United Kingdom,EURO,1653,277989,324,39369
21006,2020-06-04T00:00:00Z,GB,The United Kingdom,EURO,1871,279860,359,39728
21007,2020-06-05T00:00:00Z,GB,The United Kingdom,EURO,1805,281665,176,39904
21008,2020-06-06T00:00:00Z,GB,The United Kingdom,EURO,1650,283315,357,40261
21009,2020-06-07T00:00:00Z,GB,The United Kingdom,EURO,1557,284872,204,40465
21010,2020-06-08T00:00:00Z,GB,The United Kingdom,EURO,1326,286198,77,40542
21011,2020-06-09T00:00:00Z,GB,The United Kingdom,EURO,1205,287403,55,40597
21012,2020-06-10T00:00:00Z,GB,The United Kingdom,EURO,1741,289144,286,40883
21013,2020-06-11T00:00:00Z,GB,The United Kingdom,EURO,1003,290147,245,41128
21014,2020-06-12T00:00:00Z,GB,The United Kingdom,EURO,1266,291413,151,41279
21015,2020-06-13T00:00:00Z,GB,The United Kingdom,EURO,1541,292954,202,41481
21016,2020-06-14T00:00:00Z,GB,The United Kingdom,EURO,1425,294379,181,41662
21017,2020-06-15T00:00:00Z,GB,The United Kingdom,EURO,1514,295893,36,41698
21018,2020-06-16T00:00:00Z,GB,The United Kingdom,EURO,968,296861,38,41736
21019,2020-06-17T00:00:00Z,GB,The United Kingdom,EURO,1279,298140,233,41969
21020,2020-06-18T00:00:00Z,GB,The United Kingdom,EURO,1115,299255,184,42153
21021,2020-06-19T00:00:00Z,GB,The United Kingdom,EURO,1218,300473,135,42288
21022,2020-06-20T00:00:00Z,GB,The United Kingdom,EURO,1346,301819,173,42461
21433,2020-03-11T00:00:00Z,TR,Turkey,EURO,1,1,0,0
21434,2020-03-12T00:00:00Z,TR,Turkey,EURO,0,1,0,0
21435,2020-03-13T00:00:00Z,TR,Turkey,EURO,4,5,0,0
21436,2020-03-14T00:00:00Z,TR,Turkey,EURO,0,5,0,0
21437,2020-03-15T00:00:00Z,TR,Turkey,EURO,0,5,0,0
21438,2020-03-16T00:00:00Z,TR,Turkey,EURO,42,47,0,0
21439,2020-03-17T00:00:00Z,TR,Turkey,EURO,0,47,0,0
21440,2020-03-18T00:00:00Z,TR,Turkey,EURO,144,191,2,2
21441,2020-03-19T00:00:00Z,TR,Turkey,EURO,0,191,0,2
21442,2020-03-20T00:00:00Z,TR,Turkey,EURO,479,670,7,9
21443,2020-03-21T00:00:00Z,TR,Turkey,EURO,277,947,12,21
21444,2020-03-22T00:00:00Z,TR,Turkey,EURO,0,947,0,21
21445,2020-03-23T00:00:00Z,TR,Turkey,EURO,289,1236,9,30
21446,2020-03-24T00:00:00Z,TR,Turkey,EURO,293,1529,7,37
21447,2020-03-25T00:00:00Z,TR,Turkey,EURO,343,1872,7,44
21448,2020-03-26T00:00:00Z,TR,Turkey,EURO,561,2433,15,59
21449,2020-03-27T00:00:00Z,TR,Turkey,EURO,1196,3629,16,75
21450,2020-03-28T00:00:00Z,TR,Turkey,EURO,2069,5698,17,92
21451,2020-03-29T00:00:00Z,TR,Turkey,EURO,1704,7402,16,108
21452,2020-03-30T00:00:00Z,TR,Turkey,EURO,1869,9271,23,131
21453,2020-03-31T00:00:00Z,TR,Turkey,EURO,1556,10827,37,168
21454,2020-04-01T00:00:00Z,TR,Turkey,EURO,2704,13531,46,214
21455,2020-04-02T00:00:00Z,TR,Turkey,EURO,2148,15679,63,277
21456,2020-04-03T00:00:00Z,TR,Turkey,EURO,2456,18135,79,356
21457,2020-04-04T00:00:00Z,TR,Turkey,EURO,2786,20921,69,425
21458,2020-04-05T00:00:00Z,TR,Turkey,EURO,3013,23934,76,501
21459,2020-04-06T00:00:00Z,TR,Turkey,EURO,3135,27069,73,574
21460,2020-04-07T00:00:00Z,TR,Turkey,EURO,3148,30217,75,649
21461,2020-04-08T00:00:00Z,TR,Turkey,EURO,3892,34109,76,725
21462,2020-04-09T00:00:00Z,TR,Turkey,EURO,4117,38226,87,812
21463,2020-04-10T00:00:00Z,TR,Turkey,EURO,4056,42282,96,908
21464,2020-04-11T00:00:00Z,TR,Turkey,EURO,4747,47029,98,1006
21465,2020-04-12T00:00:00Z,TR,Turkey,EURO,5138,52167,95,1101
21466,2020-04-13T00:00:00Z,TR,Turkey,EURO,4789,56956,97,1198
21467,2020-04-14T00:00:00Z,TR,Turkey,EURO,4093,61049,98,1296
21468,2020-04-15T00:00:00Z,TR,Turkey,EURO,4062,65111,107,1403
21469,2020-04-16T00:00:00Z,TR,Turkey,EURO,4281,69392,115,1518
21470,2020-04-17T00:00:00Z,TR,Turkey,EURO,4801,74193,125,1643
21471,2020-04-18T00:00:00Z,TR,Turkey,EURO,4353,78546,126,1769
21472,2020-04-19T00:00:00Z,TR,Turkey,EURO,3783,82329,121,1890
21473,2020-04-20T00:00:00Z,TR,Turkey,EURO,3977,86306,127,2017
21474,2020-04-21T00:00:00Z,TR,Turkey,EURO,4674,90980,123,2140
21475,2020-04-22T00:00:00Z,TR,Turkey,EURO,4611,95591,119,2259
21476,2020-04-23T00:00:00Z,TR,Turkey,EURO,3083,98674,117,2376
21477,2020-04-24T00:00:00Z,TR,Turkey,EURO,3116,101790,115,2491
21478,2020-04-25T00:00:00Z,TR,Turkey,EURO,3122,104912,109,2600
21479,2020-04-26T00:00:00Z,TR,Turkey,EURO,2861,107773,106,2706
21480,2020-04-27T00:00:00Z,TR,Turkey,EURO,2357,110130,99,2805
21481,2020-04-28T00:00:00Z,TR,Turkey,EURO,2131,112261,95,2900
21482,2020-04-29T00:00:00Z,TR,Turkey,EURO,2392,114653,92,2992
21483,2020-04-30T00:00:00Z,TR,Turkey,EURO,2936,117589,89,3081
21484,2020-05-01T00:00:00Z,TR,Turkey,EURO,2615,120204,93,3174
21485,2020-05-02T00:00:00Z,TR,Turkey,EURO,2188,122392,84,3258
21486,2020-05-03T00:00:00Z,TR,Turkey,EURO,1983,124375,78,3336
21487,2020-05-04T00:00:00Z,TR,Turkey,EURO,1670,126045,61,3397
21488,2020-05-05T00:00:00Z,TR,Turkey,EURO,1614,127659,64,3461
21489,2020-05-06T00:00:00Z,TR,Turkey,EURO,1832,129491,59,3520
21490,2020-05-07T00:00:00Z,TR,Turkey,EURO,2253,131744,64,3584
21491,2020-05-08T00:00:00Z,TR,Turkey,EURO,1977,133721,57,3641
21492,2020-05-09T00:00:00Z,TR,Turkey,EURO,1848,135569,48,3689
21493,2020-05-10T00:00:00Z,TR,Turkey,EURO,1546,137115,50,3739
21494,2020-05-11T00:00:00Z,TR,Turkey,EURO,1542,138657,47,3786
21495,2020-05-12T00:00:00Z,TR,Turkey,EURO,1114,139771,55,3841
21496,2020-05-13T00:00:00Z,TR,Turkey,EURO,1704,141475,53,3894
21497,2020-05-14T00:00:00Z,TR,Turkey,EURO,1639,143114,58,3952
21498,2020-05-15T00:00:00Z,TR,Turkey,EURO,1635,144749,55,4007
21499,2020-05-16T00:00:00Z,TR,Turkey,EURO,1708,146457,48,4055
21500,2020-05-17T00:00:00Z,TR,Turkey,EURO,1610,148067,41,4096
21501,2020-05-18T00:00:00Z,TR,Turkey,EURO,1368,149435,44,4140
21502,2020-05-19T00:00:00Z,TR,Turkey,EURO,1158,150593,31,4171
21503,2020-05-20T00:00:00Z,TR,Turkey,EURO,1022,151615,28,4199
21504,2020-05-21T00:00:00Z,TR,Turkey,EURO,972,152587,23,4222
21505,2020-05-22T00:00:00Z,TR,Turkey,EURO,961,153548,27,4249
21506,2020-05-23T00:00:00Z,TR,Turkey,EURO,952,154500,27,4276
21507,2020-05-24T00:00:00Z,TR,Turkey,EURO,1186,155686,32,4308
21508,2020-05-25T00:00:00Z,TR,Turkey,EURO,1141,156827,32,4340
21509,2020-05-26T00:00:00Z,TR,Turkey,EURO,987,157814,29,4369
21510,2020-05-27T00:00:00Z,TR,Turkey,EURO,948,158762,28,4397
21511,2020-05-28T00:00:00Z,TR,Turkey,EURO,1035,159797,34,4431
21512,2020-05-29T00:00:00Z,TR,Turkey,EURO,1182,160979,30,4461
21513,2020-05-30T00:00:00Z,TR,Turkey,EURO,1141,162120,28,4489
21514,2020-05-31T00:00:00Z,TR,Turkey,EURO,983,163103,26,4515
21515,2020-06-01T00:00:00Z,TR,Turkey,EURO,839,163942,25,4540
21516,2020-06-02T00:00:00Z,TR,Turkey,EURO,827,164769,23,4563
21517,2020-06-03T00:00:00Z,TR,Turkey,EURO,786,165555,22,4585
21518,2020-06-04T00:00:00Z,TR,Turkey,EURO,867,166422,24,4609
21519,2020-06-05T00:00:00Z,TR,Turkey,EURO,988,167410,21,4630
21520,2020-06-06T00:00:00Z,TR,Turkey,EURO,930,168340,18,4648
21521,2020-06-07T00:00:00Z,TR,Turkey,EURO,878,169218,21,4669
21522,2020-06-08T00:00:00Z,TR,Turkey,EURO,914,170132,23,4692
21523,2020-06-09T00:00:00Z,TR,Turkey,EURO,989,171121,19,4711
21524,2020-06-10T00:00:00Z,TR,Turkey,EURO,993,172114,18,4729
21525,2020-06-11T00:00:00Z,TR,Turkey,EURO,922,173036,17,4746
21526,2020-06-12T00:00:00Z,TR,Turkey,EURO,987,174023,17,4763
21527,2020-06-13T00:00:00Z,TR,Turkey,EURO,1195,175218,15,4778
21528,2020-06-14T00:00:00Z,TR,Turkey,EURO,1459,176677,14,4792
21529,2020-06-15T00:00:00Z,TR,Turkey,EURO,1562,178239,15,4807
21530,2020-06-16T00:00:00Z,TR,Turkey,EURO,1592,179831,18,4825
21531,2020-06-17T00:00:00Z,TR,Turkey,EURO,1467,181298,17,4842
21532,2020-06-18T00:00:00Z,TR,Turkey,EURO,1429,182727,19,4861
21533,2020-06-19T00:00:00Z,TR,Turkey,EURO,1304,184031,21,4882
21534,2020-06-20T00:00:00Z,TR,Turkey,EURO,1214,185245,23,4905
21716,2020-03-03T00:00:00Z,UA,Ukraine,EURO,1,1,0,0
21717,2020-03-04T00:00:00Z,UA,Ukraine,EURO,0,1,0,0
21718,2020-03-05T00:00:00Z,UA,Ukraine,EURO,0,1,0,0
21719,2020-03-06T00:00:00Z,UA,Ukraine,EURO,0,1,0,0
21720,2020-03-07T00:00:00Z,UA,Ukraine,EURO,0,1,0,0
21721,2020-03-08T00:00:00Z,UA,Ukraine,EURO,0,1,0,0
21722,2020-03-09T00:00:00Z,UA,Ukraine,EURO,0,1,0,0
21723,2020-03-10T00:00:00Z,UA,Ukraine,EURO,0,1,0,0
21724,2020-03-11T00:00:00Z,UA,Ukraine,EURO,0,1,0,0
21725,2020-03-12T00:00:00Z,UA,Ukraine,EURO,0,1,0,0
21726,2020-03-13T00:00:00Z,UA,Ukraine,EURO,2,3,1,1
21727,2020-03-14T00:00:00Z,UA,Ukraine,EURO,0,3,0,1
21728,2020-03-15T00:00:00Z,UA,Ukraine,EURO,0,3,0,1
21729,2020-03-16T00:00:00Z,UA,Ukraine,EURO,2,5,0,1
21730,2020-03-17T00:00:00Z,UA,Ukraine,EURO,9,14,1,2
21731,2020-03-18T00:00:00Z,UA,Ukraine,EURO,2,16,0,2
21732,2020-03-19T00:00:00Z,UA,Ukraine,EURO,0,16,0,2
21733,2020-03-20T00:00:00Z,UA,Ukraine,EURO,10,26,1,3
21734,2020-03-21T00:00:00Z,UA,Ukraine,EURO,21,47,0,3
21735,2020-03-22T00:00:00Z,UA,Ukraine,EURO,0,47,0,3
21736,2020-03-23T00:00:00Z,UA,Ukraine,EURO,0,47,0,3
21737,2020-03-24T00:00:00Z,UA,Ukraine,EURO,37,84,0,3
21738,2020-03-25T00:00:00Z,UA,Ukraine,EURO,29,113,1,4
21739,2020-03-26T00:00:00Z,UA,Ukraine,EURO,43,156,1,5
21740,2020-03-27T00:00:00Z,UA,Ukraine,EURO,62,218,0,5
21741,2020-03-28T00:00:00Z,UA,Ukraine,EURO,93,311,3,8
21742,2020-03-29T00:00:00Z,UA,Ukraine,EURO,107,418,1,9
21743,2020-03-30T00:00:00Z,UA,Ukraine,EURO,62,480,2,11
21744,2020-03-31T00:00:00Z,UA,Ukraine,EURO,69,549,2,13
21745,2020-04-01T00:00:00Z,UA,Ukraine,EURO,120,669,4,17
21746,2020-04-02T00:00:00Z,UA,Ukraine,EURO,135,804,3,20
21747,2020-04-03T00:00:00Z,UA,Ukraine,EURO,183,987,3,23
21748,2020-04-04T00:00:00Z,UA,Ukraine,EURO,109,1096,5,28
21749,2020-04-05T00:00:00Z,UA,Ukraine,EURO,155,1251,4,32
21750,2020-04-06T00:00:00Z,UA,Ukraine,EURO,68,1319,6,38
21751,2020-04-07T00:00:00Z,UA,Ukraine,EURO,143,1462,7,45
21752,2020-04-08T00:00:00Z,UA,Ukraine,EURO,206,1668,7,52
21753,2020-04-09T00:00:00Z,UA,Ukraine,EURO,224,1892,5,57
21754,2020-04-10T00:00:00Z,UA,Ukraine,EURO,311,2203,12,69
21755,2020-04-11T00:00:00Z,UA,Ukraine,EURO,308,2511,4,73
21756,2020-04-12T00:00:00Z,UA,Ukraine,EURO,266,2777,10,83
21757,2020-04-13T00:00:00Z,UA,Ukraine,EURO,325,3102,10,93
21758,2020-04-14T00:00:00Z,UA,Ukraine,EURO,270,3372,5,98
21759,2020-04-15T00:00:00Z,UA,Ukraine,EURO,392,3764,10,108
21760,2020-04-16T00:00:00Z,UA,Ukraine,EURO,398,4162,7,115
21761,2020-04-17T00:00:00Z,UA,Ukraine,EURO,500,4662,10,125
21762,2020-04-18T00:00:00Z,UA,Ukraine,EURO,444,5106,8,133
21763,2020-04-19T00:00:00Z,UA,Ukraine,EURO,343,5449,8,141
21764,2020-04-20T00:00:00Z,UA,Ukraine,EURO,261,5710,10,151
21765,2020-04-21T00:00:00Z,UA,Ukraine,EURO,415,6125,10,161
21766,2020-04-22T00:00:00Z,UA,Ukraine,EURO,467,6592,13,174
21767,2020-04-23T00:00:00Z,UA,Ukraine,EURO,578,7170,13,187
21768,2020-04-24T00:00:00Z,UA,Ukraine,EURO,477,7647,6,193
21769,2020-04-25T00:00:00Z,UA,Ukraine,EURO,478,8125,8,201
21770,2020-04-26T00:00:00Z,UA,Ukraine,EURO,492,8617,8,209
21771,2020-04-27T00:00:00Z,UA,Ukraine,EURO,392,9009,11,220
21772,2020-04-28T00:00:00Z,UA,Ukraine,EURO,401,9410,19,239
21773,2020-04-29T00:00:00Z,UA,Ukraine,EURO,456,9866,11,250
21774,2020-04-30T00:00:00Z,UA,Ukraine,EURO,540,10406,11,261
21775,2020-05-01T00:00:00Z,UA,Ukraine,EURO,455,10861,11,272
21776,2020-05-02T00:00:00Z,UA,Ukraine,EURO,550,11411,7,279
21777,2020-05-03T00:00:00Z,UA,Ukraine,EURO,502,11913,9,288
21778,2020-05-04T00:00:00Z,UA,Ukraine,EURO,418,12331,15,303
21779,2020-05-05T00:00:00Z,UA,Ukraine,EURO,366,12697,13,316
21780,2020-05-06T00:00:00Z,UA,Ukraine,EURO,487,13184,11,327
21781,2020-05-07T00:00:00Z,UA,Ukraine,EURO,507,13691,13,340
21782,2020-05-08T00:00:00Z,UA,Ukraine,EURO,504,14195,21,361
21783,2020-05-09T00:00:00Z,UA,Ukraine,EURO,515,14710,15,376
21784,2020-05-10T00:00:00Z,UA,Ukraine,EURO,522,15232,15,391
21785,2020-05-11T00:00:00Z,UA,Ukraine,EURO,416,15648,17,408
21786,2020-05-12T00:00:00Z,UA,Ukraine,EURO,375,16023,17,425
21787,2020-05-13T00:00:00Z,UA,Ukraine,EURO,402,16425,14,439
21788,2020-05-14T00:00:00Z,UA,Ukraine,EURO,422,16847,17,456
21789,2020-05-15T00:00:00Z,UA,Ukraine,EURO,483,17330,20,476
21790,2020-05-16T00:00:00Z,UA,Ukraine,EURO,528,17858,21,497
21791,2020-05-17T00:00:00Z,UA,Ukraine,EURO,433,18291,17,514
21792,2020-05-18T00:00:00Z,UA,Ukraine,EURO,325,18616,21,535
21793,2020-05-19T00:00:00Z,UA,Ukraine,EURO,260,18876,13,548
21794,2020-05-20T00:00:00Z,UA,Ukraine,EURO,354,19230,16,564
21795,2020-05-21T00:00:00Z,UA,Ukraine,EURO,476,19706,15,579
21796,2020-05-22T00:00:00Z,UA,Ukraine,EURO,442,20148,9,588
21797,2020-05-23T00:00:00Z,UA,Ukraine,EURO,432,20580,17,605
21798,2020-05-24T00:00:00Z,UA,Ukraine,EURO,406,20986,12,617
21799,2020-05-25T00:00:00Z,UA,Ukraine,EURO,259,21245,6,623
21800,2020-05-26T00:00:00Z,UA,Ukraine,EURO,339,21584,21,644
21801,2020-05-27T00:00:00Z,UA,Ukraine,EURO,321,21905,14,658
21802,2020-05-28T00:00:00Z,UA,Ukraine,EURO,477,22382,11,669
21803,2020-05-29T00:00:00Z,UA,Ukraine,EURO,429,22811,10,679
21804,2020-05-30T00:00:00Z,UA,Ukraine,EURO,393,23204,17,696
21805,2020-05-31T00:00:00Z,UA,Ukraine,EURO,468,23672,12,708
21806,2020-06-01T00:00:00Z,UA,Ukraine,EURO,340,24012,10,718
21807,2020-06-02T00:00:00Z,UA,Ukraine,EURO,328,24340,9,727
21808,2020-06-03T00:00:00Z,UA,Ukraine,EURO,483,24823,8,735
21809,2020-06-04T00:00:00Z,UA,Ukraine,EURO,588,25411,13,748
21810,2020-06-05T00:00:00Z,UA,Ukraine,EURO,553,25964,14,762
21811,2020-06-06T00:00:00Z,UA,Ukraine,EURO,550,26514,15,777
21812,2020-06-07T00:00:00Z,UA,Ukraine,EURO,485,26999,11,788
21813,2020-06-08T00:00:00Z,UA,Ukraine,EURO,463,27462,9,797
21814,2020-06-09T00:00:00Z,UA,Ukraine,EURO,394,27856,13,810
21815,2020-06-10T00:00:00Z,UA,Ukraine,EURO,525,28381,23,833
21816,2020-06-11T00:00:00Z,UA,Ukraine,EURO,689,29070,21,854
21817,2020-06-12T00:00:00Z,UA,Ukraine,EURO,683,29753,16,870
21818,2020-06-13T00:00:00Z,UA,Ukraine,EURO,753,30506,10,880
21819,2020-06-14T00:00:00Z,UA,Ukraine,EURO,648,31154,9,889
21820,2020-06-15T00:00:00Z,UA,Ukraine,EURO,656,31810,12,901
21821,2020-06-16T00:00:00Z,UA,Ukraine,EURO,666,32476,12,913
21822,2020-06-17T00:00:00Z,UA,Ukraine,EURO,758,33234,30,943
21823,2020-06-18T00:00:00Z,UA,Ukraine,EURO,829,34063,23,966
21824,2020-06-19T00:00:00Z,UA,Ukraine,EURO,921,34984,19,985
21825,2020-06-20T00:00:00Z,UA,Ukraine,EURO,841,35825,9,994
22417,2020-03-16T00:00:00Z,UZ,Uzbekistan,EURO,4,4,0,0
22418,2020-03-17T00:00:00Z,UZ,Uzbekistan,EURO,12,16,0,0
22419,2020-03-18T00:00:00Z,UZ,Uzbekistan,EURO,0,16,0,0
22420,2020-03-19T00:00:00Z,UZ,Uzbekistan,EURO,5,21,0,0
22421,2020-03-20T00:00:00Z,UZ,Uzbekistan,EURO,12,33,0,0
22422,2020-03-21T00:00:00Z,UZ,Uzbekistan,EURO,0,33,0,0
22423,2020-03-22T00:00:00Z,UZ,Uzbekistan,EURO,0,33,0,0
22424,2020-03-23T00:00:00Z,UZ,Uzbekistan,EURO,13,46,0,0
22425,2020-03-24T00:00:00Z,UZ,Uzbekistan,EURO,0,46,0,0
22426,2020-03-25T00:00:00Z,UZ,Uzbekistan,EURO,4,50,0,0
22427,2020-03-26T00:00:00Z,UZ,Uzbekistan,EURO,15,65,0,0
22428,2020-03-27T00:00:00Z,UZ,Uzbekistan,EURO,18,83,0,0
22429,2020-03-28T00:00:00Z,UZ,Uzbekistan,EURO,21,104,1,1
22430,2020-03-29T00:00:00Z,UZ,Uzbekistan,EURO,29,133,1,2
22431,2020-03-30T00:00:00Z,UZ,Uzbekistan,EURO,12,145,0,2
22432,2020-03-31T00:00:00Z,UZ,Uzbekistan,EURO,4,149,0,2
22433,2020-04-01T00:00:00Z,UZ,Uzbekistan,EURO,24,173,0,2
22434,2020-04-02T00:00:00Z,UZ,Uzbekistan,EURO,17,190,0,2
22435,2020-04-03T00:00:00Z,UZ,Uzbekistan,EURO,31,221,0,2
22436,2020-04-04T00:00:00Z,UZ,Uzbekistan,EURO,20,241,0,2
22437,2020-04-05T00:00:00Z,UZ,Uzbekistan,EURO,57,298,0,2
22438,2020-04-06T00:00:00Z,UZ,Uzbekistan,EURO,92,390,0,2
22439,2020-04-07T00:00:00Z,UZ,Uzbekistan,EURO,82,472,0,2
22440,2020-04-08T00:00:00Z,UZ,Uzbekistan,EURO,62,534,1,3
22441,2020-04-09T00:00:00Z,UZ,Uzbekistan,EURO,21,555,0,3
22442,2020-04-10T00:00:00Z,UZ,Uzbekistan,EURO,69,624,0,3
22443,2020-04-11T00:00:00Z,UZ,Uzbekistan,EURO,0,624,0,3
22444,2020-04-12T00:00:00Z,UZ,Uzbekistan,EURO,172,796,0,3
22445,2020-04-13T00:00:00Z,UZ,Uzbekistan,EURO,100,896,1,4
22446,2020-04-14T00:00:00Z,UZ,Uzbekistan,EURO,158,1054,0,4
22447,2020-04-15T00:00:00Z,UZ,Uzbekistan,EURO,160,1214,0,4
22448,2020-04-16T00:00:00Z,UZ,Uzbekistan,EURO,135,1349,0,4
22449,2020-04-17T00:00:00Z,UZ,Uzbekistan,EURO,31,1380,0,4
22450,2020-04-18T00:00:00Z,UZ,Uzbekistan,EURO,70,1450,0,4
22451,2020-04-19T00:00:00Z,UZ,Uzbekistan,EURO,45,1495,1,5
22452,2020-04-20T00:00:00Z,UZ,Uzbekistan,EURO,70,1565,0,5
22453,2020-04-21T00:00:00Z,UZ,Uzbekistan,EURO,92,1657,0,5
22454,2020-04-22T00:00:00Z,UZ,Uzbekistan,EURO,0,1657,1,6
22455,2020-04-23T00:00:00Z,UZ,Uzbekistan,EURO,59,1716,1,7
22456,2020-04-24T00:00:00Z,UZ,Uzbekistan,EURO,62,1778,0,7
22457,2020-04-25T00:00:00Z,UZ,Uzbekistan,EURO,58,1836,1,8
22458,2020-04-26T00:00:00Z,UZ,Uzbekistan,EURO,29,1865,0,8
22459,2020-04-27T00:00:00Z,UZ,Uzbekistan,EURO,22,1887,0,8
22460,2020-04-28T00:00:00Z,UZ,Uzbekistan,EURO,37,1924,0,8
22461,2020-04-29T00:00:00Z,UZ,Uzbekistan,EURO,31,1955,0,8
22462,2020-04-30T00:00:00Z,UZ,Uzbekistan,EURO,76,2031,1,9
22463,2020-05-01T00:00:00Z,UZ,Uzbekistan,EURO,15,2046,0,9
22464,2020-05-02T00:00:00Z,UZ,Uzbekistan,EURO,48,2094,0,9
22465,2020-05-03T00:00:00Z,UZ,Uzbekistan,EURO,33,2127,0,9
22466,2020-05-04T00:00:00Z,UZ,Uzbekistan,EURO,33,2160,1,10
22467,2020-05-05T00:00:00Z,UZ,Uzbekistan,EURO,29,2189,0,10
22468,2020-05-06T00:00:00Z,UZ,Uzbekistan,EURO,28,2217,0,10
22469,2020-05-07T00:00:00Z,UZ,Uzbekistan,EURO,49,2266,0,10
22470,2020-05-08T00:00:00Z,UZ,Uzbekistan,EURO,48,2314,0,10
22471,2020-05-09T00:00:00Z,UZ,Uzbekistan,EURO,22,2336,0,10
22472,2020-05-10T00:00:00Z,UZ,Uzbekistan,EURO,51,2387,0,10
22473,2020-05-11T00:00:00Z,UZ,Uzbekistan,EURO,24,2411,0,10
22474,2020-05-12T00:00:00Z,UZ,Uzbekistan,EURO,98,2509,0,10
22475,2020-05-13T00:00:00Z,UZ,Uzbekistan,EURO,89,2598,0,10
22476,2020-05-14T00:00:00Z,UZ,Uzbekistan,EURO,22,2620,1,11
22477,2020-05-15T00:00:00Z,UZ,Uzbekistan,EURO,32,2652,0,11
22478,2020-05-16T00:00:00Z,UZ,Uzbekistan,EURO,39,2691,0,11
22479,2020-05-17T00:00:00Z,UZ,Uzbekistan,EURO,50,2741,0,11
22480,2020-05-18T00:00:00Z,UZ,Uzbekistan,EURO,21,2762,1,12
22481,2020-05-19T00:00:00Z,UZ,Uzbekistan,EURO,40,2802,1,13
22482,2020-05-20T00:00:00Z,UZ,Uzbekistan,EURO,78,2880,0,13
22483,2020-05-21T00:00:00Z,UZ,Uzbekistan,EURO,70,2950,0,13
22484,2020-05-22T00:00:00Z,UZ,Uzbekistan,EURO,56,3006,0,13
22485,2020-05-23T00:00:00Z,UZ,Uzbekistan,EURO,72,3078,0,13
22486,2020-05-24T00:00:00Z,UZ,Uzbekistan,EURO,54,3132,0,13
22487,2020-05-25T00:00:00Z,UZ,Uzbekistan,EURO,48,3180,0,13
22488,2020-05-26T00:00:00Z,UZ,Uzbekistan,EURO,81,3261,0,13
22489,2020-05-27T00:00:00Z,UZ,Uzbekistan,EURO,72,3333,1,14
22490,2020-05-28T00:00:00Z,UZ,Uzbekistan,EURO,63,3396,0,14
22491,2020-05-29T00:00:00Z,UZ,Uzbekistan,EURO,67,3463,0,14
22492,2020-05-30T00:00:00Z,UZ,Uzbekistan,EURO,50,3513,0,14
22493,2020-05-31T00:00:00Z,UZ,Uzbekistan,EURO,41,3554,0,14
22494,2020-06-01T00:00:00Z,UZ,Uzbekistan,EURO,108,3662,1,15
22495,2020-06-02T00:00:00Z,UZ,Uzbekistan,EURO,56,3718,0,15
22496,2020-06-03T00:00:00Z,UZ,Uzbekistan,EURO,0,3718,0,15
22497,2020-06-04T00:00:00Z,UZ,Uzbekistan,EURO,156,3874,1,16
22498,2020-06-05T00:00:00Z,UZ,Uzbekistan,EURO,91,3965,0,16
22499,2020-06-06T00:00:00Z,UZ,Uzbekistan,EURO,57,4022,0,16
22500,2020-06-07T00:00:00Z,UZ,Uzbekistan,EURO,159,4181,1,17
22501,2020-06-08T00:00:00Z,UZ,Uzbekistan,EURO,171,4352,0,17
22502,2020-06-09T00:00:00Z,UZ,Uzbekistan,EURO,96,4448,1,18
22503,2020-06-10T00:00:00Z,UZ,Uzbekistan,EURO,99,4547,0,18
22504,2020-06-11T00:00:00Z,UZ,Uzbekistan,EURO,148,4695,1,19
22505,2020-06-12T00:00:00Z,UZ,Uzbekistan,EURO,124,4819,0,19
22506,2020-06-13T00:00:00Z,UZ,Uzbekistan,EURO,82,4901,0,19
22507,2020-06-14T00:00:00Z,UZ,Uzbekistan,EURO,93,4994,0,19
22508,2020-06-15T00:00:00Z,UZ,Uzbekistan,EURO,109,5103,0,19
22509,2020-06-16T00:00:00Z,UZ,Uzbekistan,EURO,190,5293,0,19
22510,2020-06-17T00:00:00Z,UZ,Uzbekistan,EURO,268,5561,0,19
22511,2020-06-18T00:00:00Z,UZ,Uzbekistan,EURO,136,5697,0,19
22512,2020-06-19T00:00:00Z,UZ,Uzbekistan,EURO,158,5855,0,19
22513,2020-06-20T00:00:00Z,UZ,Uzbekistan,EURO,170,6025,0,19
