index,Date_reported,Country_code,Country,WHO_region,New_cases,Cumulative_cases,New_deaths,Cumulative_deaths
1639,2020-03-08T00:00:00Z,BD,Bangladesh,SEARO,3,3,0,0
1640,2020-03-09T00:00:00Z,BD,Bangladesh,SEARO,0,3,0,0
1641,2020-03-10T00:00:00Z,BD,Bangladesh,SEARO,0,3,0,0
1642,2020-03-11T00:00:00Z,BD,Bangladesh,SEARO,0,3,0,0
1643,2020-03-12T00:00:00Z,BD,Bangladesh,SEARO,0,3,0,0
1644,2020-03-13T00:00:00Z,BD,Bangladesh,SEARO,0,3,0,0
1645,2020-03-14T00:00:00Z,BD,Bangladesh,SEARO,0,3,0,0
1646,2020-03-15T00:00:00Z,BD,Bangladesh,SEARO,0,3,0,0
1647,2020-03-16T00:00:00Z,BD,Bangladesh,SEARO,5,8,0,0
1648,2020-03-17T00:00:00Z,BD,Bangladesh,SEARO,0,8,0,0
1649,2020-03-18T00:00:00Z,BD,Bangladesh,SEARO,2,10,0,0
1650,2020-03-19T00:00:00Z,BD,Bangladesh,SEARO,7,17,1,1
1651,2020-03-20T00:00:00Z,BD,Bangladesh,SEARO,0,17,0,1
1652,2020-03-21T00:00:00Z,BD,Bangladesh,SEARO,7,24,1,2
1653,2020-03-22T00:00:00Z,BD,Bangladesh,SEARO,0,24,0,2
1654,2020-03-23T00:00:00Z,BD,Bangladesh,SEARO,3,27,0,2
1655,2020-03-24T00:00:00Z,BD,Bangladesh,SEARO,12,39,2,4
1656,2020-03-25T00:00:00Z,BD,Bangladesh,SEARO,0,39,0,4
1657,2020-03-26T00:00:00Z,BD,Bangladesh,SEARO,5,44,1,5
1658,2020-03-27T00:00:00Z,BD,Bangladesh,SEARO,4,48,0,5
1659,2020-03-28T00:00:00Z,BD,Bangladesh,SEARO,0,48,0,5
1660,2020-03-29T00:00:00Z,BD,Bangladesh,SEARO,0,48,0,5
1661,2020-03-30T00:00:00Z,BD,Bangladesh,SEARO,1,49,0,5
1662,2020-03-31T00:00:00Z,BD,Bangladesh,SEARO,0,49,0,5
1663,2020-04-01T00:00:00Z,BD,Bangladesh,SEARO,5,54,1,6
1664,2020-04-02T00:00:00Z,BD,Bangladesh,SEARO,2,56,0,6
1665,2020-04-03T00:00:00Z,BD,Bangladesh,SEARO,5,61,0,6
1666,2020-04-04T00:00:00Z,BD,Bangladesh,SEARO,9,70,2,8
1667,2020-04-05T00:00:00Z,BD,Bangladesh,SEARO,18,88,0,8
1668,2020-04-06T00:00:00Z,BD,Bangladesh,SEARO,35,123,4,12
1669,2020-04-07T00:00:00Z,BD,Bangladesh,SEARO,41,164,5,17
1670,2020-04-08T00:00:00Z,BD,Bangladesh,SEARO,54,218,3,20
1671,2020-04-09T00:00:00Z,BD,Bangladesh,SEARO,112,330,1,21
1672,2020-04-10T00:00:00Z,BD,Bangladesh,SEARO,94,424,6,27
1673,2020-04-11T00:00:00Z,BD,Bangladesh,SEARO,58,482,3,30
1674,2020-04-12T00:00:00Z,BD,Bangladesh,SEARO,139,621,4,34
1675,2020-04-13T00:00:00Z,BD,Bangladesh,SEARO,182,803,5,39
1676,2020-04-14T00:00:00Z,BD,Bangladesh,SEARO,209,1012,7,46
1677,2020-04-15T00:00:00Z,BD,Bangladesh,SEARO,219,1231,4,50
1678,2020-04-16T00:00:00Z,BD,Bangladesh,SEARO,341,1572,10,60
1679,2020-04-17T00:00:00Z,BD,Bangladesh,SEARO,266,1838,15,75
1680,2020-04-18T00:00:00Z,BD,Bangladesh,SEARO,306,2144,9,84
1681,2020-04-19T00:00:00Z,BD,Bangladesh,SEARO,312,2456,7,91
1682,2020-04-20T00:00:00Z,BD,Bangladesh,SEARO,492,2948,10,101
1683,2020-04-21T00:00:00Z,BD,Bangladesh,SEARO,434,3382,9,110
1684,2020-04-22T00:00:00Z,BD,Bangladesh,SEARO,390,3772,10,120
1685,2020-04-23T00:00:00Z,BD,Bangladesh,SEARO,414,4186,7,127
1686,2020-04-24T00:00:00Z,BD,Bangladesh,SEARO,503,4689,4,131
1687,2020-04-25T00:00:00Z,BD,Bangladesh,SEARO,309,4998,9,140
1688,2020-04-26T00:00:00Z,BD,Bangladesh,SEARO,418,5416,5,145
1689,2020-04-27T00:00:00Z,BD,Bangladesh,SEARO,497,5913,7,152
1690,2020-04-28T00:00:00Z,BD,Bangladesh,SEARO,549,6462,3,155
1691,2020-04-29T00:00:00Z,BD,Bangladesh,SEARO,641,7103,8,163
1692,2020-04-30T00:00:00Z,BD,Bangladesh,SEARO,564,7667,5,168
1693,2020-05-01T00:00:00Z,BD,Bangladesh,SEARO,571,8238,2,170
1694,2020-05-02T00:00:00Z,BD,Bangladesh,SEARO,552,8790,5,175
1695,2020-05-03T00:00:00Z,BD,Bangladesh,SEARO,665,9455,2,177
1696,2020-05-04T00:00:00Z,BD,Bangladesh,SEARO,688,10143,5,182
1697,2020-05-05T00:00:00Z,BD,Bangladesh,SEARO,786,10929,1,183
1698,2020-05-06T00:00:00Z,BD,Bangladesh,SEARO,790,11719,3,186
1699,2020-05-07T00:00:00Z,BD,Bangladesh,SEARO,706,12425,0,186
1700,2020-05-08T00:00:00Z,BD,Bangladesh,SEARO,709,13134,20,206
1701,2020-05-09T00:00:00Z,BD,Bangladesh,SEARO,636,13770,8,214
1702,2020-05-10T00:00:00Z,BD,Bangladesh,SEARO,887,14657,14,228
1703,2020-05-11T00:00:00Z,BD,Bangladesh,SEARO,1034,15691,11,239
1704,2020-05-12T00:00:00Z,BD,Bangladesh,SEARO,969,16660,11,250
1705,2020-05-13T00:00:00Z,BD,Bangladesh,SEARO,1162,17822,19,269
1706,2020-05-14T00:00:00Z,BD,Bangladesh,SEARO,1041,18863,14,283
1707,2020-05-15T00:00:00Z,BD,Bangladesh,SEARO,1202,20065,15,298
1708,2020-05-16T00:00:00Z,BD,Bangladesh,SEARO,930,20995,16,314
1709,2020-05-17T00:00:00Z,BD,Bangladesh,SEARO,0,20995,0,314
1710,2020-05-18T00:00:00Z,BD,Bangladesh,SEARO,2875,23870,35,349
1711,2020-05-19T00:00:00Z,BD,Bangladesh,SEARO,1251,25121,21,370
1712,2020-05-20T00:00:00Z,BD,Bangladesh,SEARO,1617,26738,16,386
1713,2020-05-21T00:00:00Z,BD,Bangladesh,SEARO,1773,28511,22,408
1714,2020-05-22T00:00:00Z,BD,Bangladesh,SEARO,1694,30205,24,432
1715,2020-05-23T00:00:00Z,BD,Bangladesh,SEARO,1873,32078,20,452
1716,2020-05-24T00:00:00Z,BD,Bangladesh,SEARO,1532,33610,28,480
1717,2020-05-25T00:00:00Z,BD,Bangladesh,SEARO,1975,35585,21,501
1718,2020-05-26T00:00:00Z,BD,Bangladesh,SEARO,1166,36751,21,522
1719,2020-05-27T00:00:00Z,BD,Bangladesh,SEARO,1541,38292,22,544
1720,2020-05-28T00:00:00Z,BD,Bangladesh,SEARO,2029,40321,15,559
1721,2020-05-29T00:00:00Z,BD,Bangladesh,SEARO,2523,42844,23,582
1722,2020-05-30T00:00:00Z,BD,Bangladesh,SEARO,1764,44608,28,610
1723,2020-05-31T00:00:00Z,BD,Bangladesh,SEARO,2545,47153,40,650
1724,2020-06-01T00:00:00Z,BD,Bangladesh,SEARO,0,47153,0,650
1725,2020-06-02T00:00:00Z,BD,Bangladesh,SEARO,2381,49534,22,672
1726,2020-06-03T00:00:00Z,BD,Bangladesh,SEARO,2911,52445,37,709
1727,2020-06-04T00:00:00Z,BD,Bangladesh,SEARO,2695,55140,37,746
1728,2020-06-05T00:00:00Z,BD,Bangladesh,SEARO,2423,57563,35,781
1729,2020-06-06T00:00:00Z,BD,Bangladesh,SEARO,2828,60391,30,811
1730,2020-06-07T00:00:00Z,BD,Bangladesh,SEARO,2635,63026,35,846
1731,2020-06-08T00:00:00Z,BD,Bangladesh,SEARO,2743,65769,42,888
1732,2020-06-09T00:00:00Z,BD,Bangladesh,SEARO,2735,68504,42,930
1733,2020-06-10T00:00:00Z,BD,Bangladesh,SEARO,3171,71675,45,975
1734,2020-06-11T00:00:00Z,BD,Bangladesh,SEARO,3190,74865,37,1012
1735,2020-06-12T00:00:00Z,BD,Bangladesh,SEARO,3187,78052,37,1049
1736,2020-06-13T00:00:00Z,BD,Bangladesh,SEARO,3471,81523,46,1095
1737,2020-06-14T00:00:00Z,BD,Bangladesh,SEARO,2856,84379,44,1139
1738,2020-06-15T00:00:00Z,BD,Bangladesh,SEARO,3141,87520,32,1171
1739,2020-06-16T00:00:00Z,BD,Bangladesh,SEARO,3099,90619,38,1209
1740,2020-06-17T00:00:00Z,BD,Bangladesh,SEARO,3862,94481,53,1262
1741,2020-06-18T00:00:00Z,BD,Bangladesh,SEARO,4008,98489,43,1305
1742,2020-06-19T00:00:00Z,BD,Bangladesh,SEARO,3803,102292,38,1343
1743,2020-06-20T00:00:00Z,BD,Bangladesh,SEARO,3243,105535,45,1388
2371,2020-03-06T00:00:00Z,BT,Bhutan,SEARO,1,1,0,0
2372,2020-03-07T00:00:00Z,BT,Bhutan,SEARO,0,1,0,0
2373,2020-03-08T00:00:00Z,BT,Bhutan,SEARO,0,1,0,0
2374,2020-03-09T00:00:00Z,BT,Bhutan,SEARO,0,1,0,0
2375,2020-03-10T00:00:00Z,BT,Bhutan,SEARO,0,1,0,0
2376,2020-03-11T00:00:00Z,BT,Bhutan,SEARO,0,1,0,0
2377,2020-03-12T00:00:00Z,BT,Bhutan,SEARO,0,1,0,0
2378,2020-03-13T00:00:00Z,BT,Bhutan,SEARO,0,1,0,0
2379,2020-03-14T00:00:00Z,BT,Bhutan,SEARO,0,1,0,0
2380,2020-03-15T00:00:00Z,BT,Bhutan,SEARO,0,1,0,0
2381,2020-03-16T00:00:00Z,BT,Bhutan,SEARO,0,1,0,0
2382,2020-03-17T00:00:00Z,BT,Bhutan,SEARO,0,1,0,0
2383,2020-03-18T00:00:00Z,BT,Bhutan,SEARO,0,1,0,0
2384,2020-03-19T00:00:00Z,BT,Bhutan,SEARO,1,2,0,0
2385,2020-03-20T00:00:00Z,BT,Bhutan,SEARO,0,2,0,0
2386,2020-03-21T00:00:00Z,BT,Bhutan,SEARO,0,2,0,0
2387,2020-03-22T00:00:00Z,BT,Bhutan,SEARO,0,2,0,0
2388,2020-03-23T00:00:00Z,BT,Bhutan,SEARO,0,2,0,0
2389,2020-03-24T00:00:00Z,BT,Bhutan,SEARO,0,2,0,0
2390,2020-03-25T00:00:00Z,BT,Bhutan,SEARO,0,2,0,0
2391,2020-03-26T00:00:00Z,BT,Bhutan,SEARO,1,3,0,0
2392,2020-03-27T00:00:00Z,BT,Bhutan,SEARO,0,3,0,0
2393,2020-03-28T00:00:00Z,BT,Bhutan,SEARO,0,3,0,0
2394,2020-03-29T00:00:00Z,BT,Bhutan,SEARO,0,3,0,0
2395,2020-03-30T00:00:00Z,BT,Bhutan,SEARO,1,4,0,0
2396,2020-03-31T00:00:00Z,BT,Bhutan,SEARO,0,4,0,0
2397,2020-04-01T00:00:00Z,BT,Bhutan,SEARO,0,4,0,0
2398,2020-04-02T00:00:00Z,BT,Bhutan,SEARO,1,5,0,0
2399,2020-04-03T00:00:00Z,BT,Bhutan,SEARO,0,5,0,0
2400,2020-04-04T00:00:00Z,BT,Bhutan,SEARO,0,5,0,0
2401,2020-04-05T00:00:00Z,BT,Bhutan,SEARO,0,5,0,0
2402,2020-04-06T00:00:00Z,BT,Bhutan,SEARO,0,5,0,0
2403,2020-04-07T00:00:00Z,BT,Bhutan,SEARO,0,5,0,0
2404,2020-04-08T00:00:00Z,BT,Bhutan,SEARO,0,5,0,0
2405,2020-04-09T00:00:00Z,BT,Bhutan,SEARO,0,5,0,0
2406,2020-04-10T00:00:00Z,BT,Bhutan,SEARO,0,5,0,0
2407,2020-04-11T00:00:00Z,BT,Bhutan,SEARO,0,5,0,0
2408,2020-04-12T00:00:00Z,BT,Bhutan,SEARO,0,5,0,0
2409,2020-04-13T00:00:00Z,BT,Bhutan,SEARO,0,5,0,0
2410,2020-04-14T00:00:00Z,BT,Bhutan,SEARO,0,5,0,0
2411,2020-04-15T00:00:00Z,BT,Bhutan,SEARO,0,5,0,0
2412,2020-04-16T00:00:00Z,BT,Bhutan,SEARO,0,5,0,0
2413,2020-04-17T00:00:00Z,BT,Bhutan,SEARO,0,5,0,0
2414,2020-04-18T00:00:00Z,BT,Bhutan,SEARO,0,5,0,0
2415,2020-04-19T00:00:00Z,BT,Bhutan,SEARO,0,5,0,0
2416,2020-04-20T00:00:00Z,BT,Bhutan,SEARO,0,5,0,0
2417,2020-04-21T00:00:00Z,BT,Bhutan,SEARO,1,6,0,0
2418,2020-04-22T00:00:00Z,BT,Bhutan,SEARO,0,6,0,0
2419,2020-04-23T00:00:00Z,BT,Bhutan,SEARO,1,7,0,0
2420,2020-04-24T00:00:00Z,BT,Bhutan,SEARO,0,7,0,0
2421,2020-04-25T00:00:00Z,BT,Bhutan,SEARO,0,7,0,0
2422,2020-04-26T00:00:00Z,BT,Bhutan,SEARO,0,7,0,0
2423,2020-04-27T00:00:00Z,BT,Bhutan,SEARO,0,7,0,0
2424,2020-04-28T00:00:00Z,BT,Bhutan,SEARO,0,7,0,0
2425,2020-04-29T00:00:00Z,BT,Bhutan,SEARO,0,7,0,0
2426,2020-04-30T00:00:00Z,BT,Bhutan,SEARO,0,7,0,0
2427,2020-05-01T00:00:00Z,BT,Bhutan,SEARO,0,7,0,0
2428,2020-05-02T00:00:00Z,BT,Bhutan,SEARO,0,7,0,0
2429,2020-05-03T00:00:00Z,BT,Bhutan,SEARO,0,7,0,0
2430,2020-05-04T00:00:00Z,BT,Bhutan,SEARO,0,7,0,0
2431,2020-05-05T00:00:00Z,BT,Bhutan,SEARO,0,7,0,0
2432,2020-05-06T00:00:00Z,BT,Bhutan,SEARO,0,7,0,0
2433,2020-05-07T00:00:00Z,BT,Bhutan,SEARO,0,7,0,0
2434,2020-05-08T00:00:00Z,BT,Bhutan,SEARO,0,7,0,0
2435,2020-05-09T00:00:00Z,BT,Bhutan,SEARO,0,7,0,0
2436,2020-05-10T00:00:00Z,BT,Bhutan,SEARO,0,7,0,0
2437,2020-05-11T00:00:00Z,BT,Bhutan,SEARO,2,9,0,0
2438,2020-05-12T00:00:00Z,BT,Bhutan,SEARO,2,11,0,0
2439,2020-05-13T00:00:00Z,BT,Bhutan,SEARO,0,11,0,0
2440,2020-05-14T00:00:00Z,BT,Bhutan,SEARO,4,15,0,0
2441,2020-05-15T00:00:00Z,BT,Bhutan,SEARO,5,20,0,0
2442,2020-05-16T00:00:00Z,BT,Bhutan,SEARO,1,21,0,0
2443,2020-05-17T00:00:00Z,BT,Bhutan,SEARO,0,21,0,0
2444,2020-05-18T00:00:00Z,BT,Bhutan,SEARO,0,21,0,0
2445,2020-05-19T00:00:00Z,BT,Bhutan,SEARO,0,21,0,0
2446,2020-05-20T00:00:00Z,BT,Bhutan,SEARO,0,21,0,0
2447,2020-05-21T00:00:00Z,BT,Bhutan,SEARO,0,21,0,0
2448,2020-05-22T00:00:00Z,BT,Bhutan,SEARO,0,21,0,0
2449,2020-05-23T00:00:00Z,BT,Bhutan,SEARO,0,21,0,0
2450,2020-05-24T00:00:00Z,BT,Bhutan,SEARO,3,24,0,0
2451,2020-05-25T00:00:00Z,BT,Bhutan,SEARO,3,27,0,0
2452,2020-05-26T00:00:00Z,BT,Bhutan,SEARO,0,27,0,0
2453,2020-05-27T00:00:00Z,BT,Bhutan,SEARO,0,27,0,0
2454,2020-05-28T00:00:00Z,BT,Bhutan,SEARO,1,28,0,0
2455,2020-05-29T00:00:00Z,BT,Bhutan,SEARO,3,31,0,0
2456,2020-05-30T00:00:00Z,BT,Bhutan,SEARO,2,33,0,0
2457,2020-05-31T00:00:00Z,BT,Bhutan,SEARO,10,43,0,0
2458,2020-06-01T00:00:00Z,BT,Bhutan,SEARO,0,43,0,0
2459,2020-06-02T00:00:00Z,BT,Bhutan,SEARO,4,47,0,0
2460,2020-06-03T00:00:00Z,BT,Bhutan,SEARO,0,47,0,0
2461,2020-06-04T00:00:00Z,BT,Bhutan,SEARO,0,47,0,0
2462,2020-06-05T00:00:00Z,BT,Bhutan,SEARO,0,47,0,0
2463,2020-06-06T00:00:00Z,BT,Bhutan,SEARO,1,48,0,0
2464,2020-06-07T00:00:00Z,BT,Bhutan,SEARO,0,48,0,0
2465,2020-06-08T00:00:00Z,BT,Bhutan,SEARO,11,59,0,0
2466,2020-06-09T00:00:00Z,BT,Bhutan,SEARO,0,59,0,0
2467,2020-06-10T00:00:00Z,BT,Bhutan,SEARO,0,59,0,0
2468,2020-06-11T00:00:00Z,BT,Bhutan,SEARO,3,62,0,0
2469,2020-06-12T00:00:00Z,BT,Bhutan,SEARO,0,62,0,0
2470,2020-06-13T00:00:00Z,BT,Bhutan,SEARO,0,62,0,0
2471,2020-06-14T00:00:00Z,BT,Bhutan,SEARO,4,66,0,0
2472,2020-06-15T00:00:00Z,BT,Bhutan,SEARO,0,66,0,0
2473,2020-06-16T00:00:00Z,BT,Bhutan,SEARO,1,67,0,0
2474,2020-06-17T00:00:00Z,BT,Bhutan,SEARO,0,67,0,0
2475,2020-06-18T00:00:00Z,BT,Bhutan,SEARO,0,67,0,0
2476,2020-06-19T00:00:00Z,BT,Bhutan,SEARO,0,67,0,0
2477,2020-06-20T00:00:00Z,BT,Bhutan,SEARO,1,68,0,0
9794,2020-01-30T00:00:00Z,IN,India,SEARO,1,1,0,0
9795,2020-01-31T00:00:00Z,IN,India,SEARO,0,1,0,0
9796,2020-02-01T00:00:00Z,IN,India,SEARO,0,1,0,0
9797,2020-02-02T00:00:00Z,IN,India,SEARO,1,2,0,0
9798,2020-02-03T00:00:00Z,IN,India,SEARO,1,3,0,0
9799,2020-02-04T00:00:00Z,IN,India,SEARO,0,3,0,0
9800,2020-02-05T00:00:00Z,IN,India,SEARO,0,3,0,0
9801,2020-02-06T00:00:00Z,IN,India,SEARO,0,3,0,0
9802,2020-02-07T00:00:00Z,IN,India,SEARO,0,3,0,0
9803,2020-02-08T00:00:00Z,IN,India,SEARO,0,3,0,0
9804,2020-02-09T00:00:00Z,IN,India,SEARO,0,3,0,0
9805,2020-02-10T00:00:00Z,IN,India,SEARO,0,3,0,0
9806,2020-02-11T00:00:00Z,IN,India,SEARO,0,3,0,0
9807,2020-02-12T00:00:00Z,IN,India,SEARO,0,3,0,0
9808,2020-02-13T00:00:00Z,IN,India,SEARO,0,3,0,0
9809,2020-02-14T00:00:00Z,IN,India,SEARO,0,3,0,0
9810,2020-02-15T00:00:00Z,IN,India,SEARO,0,3,0,0
9811,2020-02-16T00:00:00Z,IN,India,SEARO,0,3,0,0
9812,2020-02-17T00:00:00Z,IN,India,SEARO,0,3,0,0
9813,2020-02-18T00:00:00Z,IN,India,SEARO,0,3,0,0
9814,2020-02-19T00:00:00Z,IN,India,SEARO,0,3,0,0
9815,2020-02-20T00:00:00Z,IN,India,SEARO,0,3,0,0
9816,2020-02-21T00:00:00Z,IN,India,SEARO,0,3,0,0
9817,2020-02-22T00:00:00Z,IN,India,SEARO,0,3,0,0
9818,2020-02-23T00:00:00Z,IN,India,SEARO,0,3,0,0
9819,2020-02-24T00:00:00Z,IN,India,SEARO,0,3,0,0
9820,2020-02-25T00:00:00Z,IN,India,SEARO,0,3,0,0
9821,2020-02-26T00:00:00Z,IN,India,SEARO,0,3,0,0
9822,2020-02-27T00:00:00Z,IN,India,SEARO,0,3,0,0
9823,2020-02-28T00:00:00Z,IN,India,SEARO,0,3,0,0
9824,2020-02-29T00:00:00Z,IN,India,SEARO,0,3,0,0
9825,2020-03-01T00:00:00Z,IN,India,SEARO,0,3,0,0
9826,2020-03-02T00:00:00Z,IN,India,SEARO,2,5,0,0
9827,2020-03-03T00:00:00Z,IN,India,SEARO,0,5,0,0
9828,2020-03-04T00:00:00Z,IN,India,SEARO,22,27,0,0
9829,2020-03-05T00:00:00Z,IN,India,SEARO,2,29,0,0
9830,2020-03-06T00:00:00Z,IN,India,SEARO,2,31,0,0
9831,2020-03-07T00:00:00Z,IN,India,SEARO,3,34,0,0
9832,2020-03-08T00:00:00Z,IN,India,SEARO,5,39,0,0
9833,2020-03-09T00:00:00Z,IN,India,SEARO,5,44,0,0
9834,2020-03-10T00:00:00Z,IN,India,SEARO,6,50,0,0
9835,2020-03-11T00:00:00Z,IN,India,SEARO,10,60,0,0
9836,2020-03-12T00:00:00Z,IN,India,SEARO,14,74,0,0
9837,2020-03-13T00:00:00Z,IN,India,SEARO,7,81,1,1
9838,2020-03-14T00:00:00Z,IN,India,SEARO,3,84,1,2
9839,2020-03-15T00:00:00Z,IN,India,SEARO,23,107,0,2
9840,2020-03-16T00:00:00Z,IN,India,SEARO,7,114,0,2
9841,2020-03-17T00:00:00Z,IN,India,SEARO,23,137,1,3
9842,2020-03-18T00:00:00Z,IN,India,SEARO,14,151,0,3
9843,2020-03-19T00:00:00Z,IN,India,SEARO,44,195,1,4
9844,2020-03-20T00:00:00Z,IN,India,SEARO,0,195,0,4
9845,2020-03-21T00:00:00Z,IN,India,SEARO,88,283,0,4
9846,2020-03-22T00:00:00Z,IN,India,SEARO,58,341,1,5
9847,2020-03-23T00:00:00Z,IN,India,SEARO,93,434,4,9
9848,2020-03-24T00:00:00Z,IN,India,SEARO,85,519,0,9
9849,2020-03-25T00:00:00Z,IN,India,SEARO,87,606,1,10
9850,2020-03-26T00:00:00Z,IN,India,SEARO,43,649,3,13
9851,2020-03-27T00:00:00Z,IN,India,SEARO,75,724,4,17
9852,2020-03-28T00:00:00Z,IN,India,SEARO,0,724,0,17
9853,2020-03-29T00:00:00Z,IN,India,SEARO,255,979,8,25
9854,2020-03-30T00:00:00Z,IN,India,SEARO,92,1071,4,29
9855,2020-03-31T00:00:00Z,IN,India,SEARO,180,1251,3,32
9856,2020-04-01T00:00:00Z,IN,India,SEARO,385,1636,6,38
9857,2020-04-02T00:00:00Z,IN,India,SEARO,329,1965,12,50
9858,2020-04-03T00:00:00Z,IN,India,SEARO,336,2301,6,56
9859,2020-04-04T00:00:00Z,IN,India,SEARO,601,2902,12,68
9860,2020-04-05T00:00:00Z,IN,India,SEARO,472,3374,9,77
9861,2020-04-06T00:00:00Z,IN,India,SEARO,693,4067,32,109
9862,2020-04-07T00:00:00Z,IN,India,SEARO,354,4421,5,114
9863,2020-04-08T00:00:00Z,IN,India,SEARO,853,5274,35,149
9864,2020-04-09T00:00:00Z,IN,India,SEARO,591,5865,20,169
9865,2020-04-10T00:00:00Z,IN,India,SEARO,547,6412,30,199
9866,2020-04-11T00:00:00Z,IN,India,SEARO,1035,7447,40,239
9867,2020-04-12T00:00:00Z,IN,India,SEARO,909,8356,34,273
9868,2020-04-13T00:00:00Z,IN,India,SEARO,796,9152,35,308
9869,2020-04-14T00:00:00Z,IN,India,SEARO,1211,10363,31,339
9870,2020-04-15T00:00:00Z,IN,India,SEARO,1076,11439,38,377
9871,2020-04-16T00:00:00Z,IN,India,SEARO,941,12380,37,414
9872,2020-04-17T00:00:00Z,IN,India,SEARO,1007,13387,23,437
9873,2020-04-18T00:00:00Z,IN,India,SEARO,991,14378,43,480
9874,2020-04-19T00:00:00Z,IN,India,SEARO,1334,15712,27,507
9875,2020-04-20T00:00:00Z,IN,India,SEARO,1553,17265,36,543
9876,2020-04-21T00:00:00Z,IN,India,SEARO,1336,18601,47,590
9877,2020-04-22T00:00:00Z,IN,India,SEARO,1383,19984,50,640
9878,2020-04-23T00:00:00Z,IN,India,SEARO,1409,21393,41,681
9879,2020-04-24T00:00:00Z,IN,India,SEARO,1684,23077,37,718
9880,2020-04-25T00:00:00Z,IN,India,SEARO,1429,24506,57,775
9881,2020-04-26T00:00:00Z,IN,India,SEARO,1990,26496,49,824
9882,2020-04-27T00:00:00Z,IN,India,SEARO,1396,27892,48,872
9883,2020-04-28T00:00:00Z,IN,India,SEARO,1543,29435,62,934
9884,2020-04-29T00:00:00Z,IN,India,SEARO,1897,31332,73,1007
9885,2020-04-30T00:00:00Z,IN,India,SEARO,1718,33050,67,1074
9886,2020-05-01T00:00:00Z,IN,India,SEARO,1993,35043,73,1147
9887,2020-05-02T00:00:00Z,IN,India,SEARO,2293,37336,71,1218
9888,2020-05-03T00:00:00Z,IN,India,SEARO,2644,39980,83,1301
9889,2020-05-04T00:00:00Z,IN,India,SEARO,2553,42533,72,1373
9890,2020-05-05T00:00:00Z,IN,India,SEARO,3900,46433,195,1568
9891,2020-05-06T00:00:00Z,IN,India,SEARO,2958,49391,126,1694
9892,2020-05-07T00:00:00Z,IN,India,SEARO,3561,52952,89,1783
9893,2020-05-08T00:00:00Z,IN,India,SEARO,3390,56342,103,1886
9894,2020-05-09T00:00:00Z,IN,India,SEARO,3320,59662,95,1981
9895,2020-05-10T00:00:00Z,IN,India,SEARO,3277,62939,128,2109
9896,2020-05-11T00:00:00Z,IN,India,SEARO,4213,67152,97,2206
9897,2020-05-12T00:00:00Z,IN,India,SEARO,3604,70756,87,2293
9898,2020-05-13T00:00:00Z,IN,India,SEARO,3525,74281,122,2415
9899,2020-05-14T00:00:00Z,IN,India,SEARO,3722,78003,134,2549
9900,2020-05-15T00:00:00Z,IN,India,SEARO,3967,81970,100,2649
9901,2020-05-16T00:00:00Z,IN,India,SEARO,3970,85940,103,2752
9902,2020-05-17T00:00:00Z,IN,India,SEARO,4987,90927,120,2872
9903,2020-05-18T00:00:00Z,IN,India,SEARO,5242,96169,157,3029
9904,2020-05-19T00:00:00Z,IN,India,SEARO,4970,101139,134,3163
9905,2020-05-20T00:00:00Z,IN,India,SEARO,5611,106750,140,3303
9906,2020-05-21T00:00:00Z,IN,India,SEARO,5609,112359,132,3435
9907,2020-05-22T00:00:00Z,IN,India,SEARO,6088,118447,148,3583
9908,2020-05-23T00:00:00Z,IN,India,SEARO,6654,125101,137,3720
9909,2020-05-24T00:00:00Z,IN,India,SEARO,6767,131868,147,3867
9910,2020-05-25T00:00:00Z,IN,India,SEARO,6977,138845,154,4021
9911,2020-05-26T00:00:00Z,IN,India,SEARO,6535,145380,146,4167
9912,2020-05-27T00:00:00Z,IN,India,SEARO,6387,151767,170,4337
9913,2020-05-28T00:00:00Z,IN,India,SEARO,6566,158333,194,4531
9914,2020-05-29T00:00:00Z,IN,India,SEARO,7466,165799,175,4706
9915,2020-05-30T00:00:00Z,IN,India,SEARO,7964,173763,265,4971
9916,2020-05-31T00:00:00Z,IN,India,SEARO,8380,182143,193,5164
9917,2020-06-01T00:00:00Z,IN,India,SEARO,8392,190535,230,5394
9918,2020-06-02T00:00:00Z,IN,India,SEARO,8171,198706,204,5598
9919,2020-06-03T00:00:00Z,IN,India,SEARO,8909,207615,217,5815
9920,2020-06-04T00:00:00Z,IN,India,SEARO,9304,216919,260,6075
9921,2020-06-05T00:00:00Z,IN,India,SEARO,9851,226770,273,6348
9922,2020-06-06T00:00:00Z,IN,India,SEARO,9887,236657,294,6642
9923,2020-06-07T00:00:00Z,IN,India,SEARO,9971,246628,287,6929
9924,2020-06-08T00:00:00Z,IN,India,SEARO,9983,256611,206,7135
9925,2020-06-09T00:00:00Z,IN,India,SEARO,9987,266598,331,7466
9926,2020-06-10T00:00:00Z,IN,India,SEARO,9985,276583,279,7745
9927,2020-06-11T00:00:00Z,IN,India,SEARO,9996,286579,357,8102
9928,2020-06-12T00:00:00Z,IN,India,SEARO,10956,297535,396,8498
9929,2020-06-13T00:00:00Z,IN,India,SEARO,11458,308993,386,8884
9930,2020-06-14T00:00:00Z,IN,India,SEARO,11929,320922,311,9195
9931,2020-06-15T00:00:00Z,IN,India,SEARO,11502,332424,325,9520
9932,2020-06-16T00:00:00Z,IN,India,SEARO,10667,343091,380,9900
9933,2020-06-17T00:00:00Z,IN,India,SEARO,10974,354065,2003,11903
9934,2020-06-18T00:00:00Z,IN,India,SEARO,12881,366946,334,12237
9935,2020-06-19T00:00:00Z,IN,India,SEARO,13586,380532,336,12573
9936,2020-06-20T00:00:00Z,IN,India,SEARO,14516,395048,375,12948
9937,2020-03-02T00:00:00Z,ID,Indonesia,SEARO,2,2,0,0
9938,2020-03-03T00:00:00Z,ID,Indonesia,SEARO,0,2,0,0
9939,2020-03-04T00:00:00Z,ID,Indonesia,SEARO,0,2,0,0
9940,2020-03-05T00:00:00Z,ID,Indonesia,SEARO,0,2,0,0
9941,2020-03-06T00:00:00Z,ID,Indonesia,SEARO,2,4,0,0
9942,2020-03-07T00:00:00Z,ID,Indonesia,SEARO,0,4,0,0
9943,2020-03-08T00:00:00Z,ID,Indonesia,SEARO,2,6,0,0
9944,2020-03-09T00:00:00Z,ID,Indonesia,SEARO,0,6,0,0
9945,2020-03-10T00:00:00Z,ID,Indonesia,SEARO,13,19,0,0
9946,2020-03-11T00:00:00Z,ID,Indonesia,SEARO,8,27,1,1
9947,2020-03-12T00:00:00Z,ID,Indonesia,SEARO,7,34,0,1
9948,2020-03-13T00:00:00Z,ID,Indonesia,SEARO,35,69,3,4
9949,2020-03-14T00:00:00Z,ID,Indonesia,SEARO,0,69,0,4
9950,2020-03-15T00:00:00Z,ID,Indonesia,SEARO,48,117,0,4
9951,2020-03-16T00:00:00Z,ID,Indonesia,SEARO,55,172,1,5
9952,2020-03-17T00:00:00Z,ID,Indonesia,SEARO,0,172,0,5
9953,2020-03-18T00:00:00Z,ID,Indonesia,SEARO,55,227,14,19
9954,2020-03-19T00:00:00Z,ID,Indonesia,SEARO,82,309,6,25
9955,2020-03-20T00:00:00Z,ID,Indonesia,SEARO,60,369,7,32
9956,2020-03-21T00:00:00Z,ID,Indonesia,SEARO,81,450,6,38
9957,2020-03-22T00:00:00Z,ID,Indonesia,SEARO,64,514,10,48
9958,2020-03-23T00:00:00Z,ID,Indonesia,SEARO,65,579,1,49
9959,2020-03-24T00:00:00Z,ID,Indonesia,SEARO,0,579,0,49
9960,2020-03-25T00:00:00Z,ID,Indonesia,SEARO,211,790,9,58
9961,2020-03-26T00:00:00Z,ID,Indonesia,SEARO,103,893,20,78
9962,2020-03-27T00:00:00Z,ID,Indonesia,SEARO,153,1046,9,87
9963,2020-03-28T00:00:00Z,ID,Indonesia,SEARO,0,1046,0,87
9964,2020-03-29T00:00:00Z,ID,Indonesia,SEARO,239,1285,27,114
9965,2020-03-30T00:00:00Z,ID,Indonesia,SEARO,129,1414,8,122
9966,2020-03-31T00:00:00Z,ID,Indonesia,SEARO,114,1528,14,136
9967,2020-04-01T00:00:00Z,ID,Indonesia,SEARO,149,1677,21,157
9968,2020-04-02T00:00:00Z,ID,Indonesia,SEARO,113,1790,13,170
9969,2020-04-03T00:00:00Z,ID,Indonesia,SEARO,196,1986,11,181
9970,2020-04-04T00:00:00Z,ID,Indonesia,SEARO,106,2092,10,191
9971,2020-04-05T00:00:00Z,ID,Indonesia,SEARO,181,2273,7,198
9972,2020-04-06T00:00:00Z,ID,Indonesia,SEARO,218,2491,11,209
9973,2020-04-07T00:00:00Z,ID,Indonesia,SEARO,247,2738,12,221
9974,2020-04-08T00:00:00Z,ID,Indonesia,SEARO,218,2956,19,240
9975,2020-04-09T00:00:00Z,ID,Indonesia,SEARO,337,3293,40,280
9976,2020-04-10T00:00:00Z,ID,Indonesia,SEARO,219,3512,26,306
9977,2020-04-11T00:00:00Z,ID,Indonesia,SEARO,330,3842,21,327
9978,2020-04-12T00:00:00Z,ID,Indonesia,SEARO,399,4241,46,373
9979,2020-04-13T00:00:00Z,ID,Indonesia,SEARO,316,4557,26,399
9980,2020-04-14T00:00:00Z,ID,Indonesia,SEARO,282,4839,60,459
9981,2020-04-15T00:00:00Z,ID,Indonesia,SEARO,297,5136,10,469
9982,2020-04-16T00:00:00Z,ID,Indonesia,SEARO,380,5516,27,496
9983,2020-04-17T00:00:00Z,ID,Indonesia,SEARO,407,5923,24,520
9984,2020-04-18T00:00:00Z,ID,Indonesia,SEARO,325,6248,15,535
9985,2020-04-19T00:00:00Z,ID,Indonesia,SEARO,327,6575,47,582
9986,2020-04-20T00:00:00Z,ID,Indonesia,SEARO,185,6760,8,590
9987,2020-04-21T00:00:00Z,ID,Indonesia,SEARO,375,7135,26,616
9988,2020-04-22T00:00:00Z,ID,Indonesia,SEARO,283,7418,19,635
9989,2020-04-23T00:00:00Z,ID,Indonesia,SEARO,357,7775,12,647
9990,2020-04-24T00:00:00Z,ID,Indonesia,SEARO,436,8211,42,689
9991,2020-04-25T00:00:00Z,ID,Indonesia,SEARO,396,8607,31,720
9992,2020-04-26T00:00:00Z,ID,Indonesia,SEARO,275,8882,23,743
9993,2020-04-27T00:00:00Z,ID,Indonesia,SEARO,214,9096,22,765
9994,2020-04-28T00:00:00Z,ID,Indonesia,SEARO,415,9511,8,773
9995,2020-04-29T00:00:00Z,ID,Indonesia,SEARO,260,9771,11,784
9996,2020-04-30T00:00:00Z,ID,Indonesia,SEARO,347,10118,8,792
9997,2020-05-01T00:00:00Z,ID,Indonesia,SEARO,433,10551,8,800
9998,2020-05-02T00:00:00Z,ID,Indonesia,SEARO,292,10843,31,831
9999,2020-05-03T00:00:00Z,ID,Indonesia,SEARO,349,11192,14,845
10000,2020-05-04T00:00:00Z,ID,Indonesia,SEARO,395,11587,19,864
10001,2020-05-05T00:00:00Z,ID,Indonesia,SEARO,484,12071,8,872
10002,2020-05-06T00:00:00Z,ID,Indonesia,SEARO,367,12438,23,895
10003,2020-05-07T00:00:00Z,ID,Indonesia,SEARO,338,12776,35,930
10004,2020-05-08T00:00:00Z,ID,Indonesia,SEARO,336,13112,13,943
10005,2020-05-09T00:00:00Z,ID,Indonesia,SEARO,533,13645,16,959
10006,2020-05-10T00:00:00Z,ID,Indonesia,SEARO,387,14032,14,973
10007,2020-05-11T00:00:00Z,ID,Indonesia,SEARO,233,14265,18,991
10008,2020-05-12T00:00:00Z,ID,Indonesia,SEARO,484,14749,16,1007
10009,2020-05-13T00:00:00Z,ID,Indonesia,SEARO,689,15438,21,1028
10010,2020-05-14T00:00:00Z,ID,Indonesia,SEARO,568,16006,15,1043
10011,2020-05-15T00:00:00Z,ID,Indonesia,SEARO,490,16496,33,1076
10012,2020-05-16T00:00:00Z,ID,Indonesia,SEARO,529,17025,13,1089
10013,2020-05-17T00:00:00Z,ID,Indonesia,SEARO,489,17514,59,1148
10014,2020-05-18T00:00:00Z,ID,Indonesia,SEARO,496,18010,43,1191
10015,2020-05-19T00:00:00Z,ID,Indonesia,SEARO,486,18496,30,1221
10016,2020-05-20T00:00:00Z,ID,Indonesia,SEARO,693,19189,21,1242
10017,2020-05-21T00:00:00Z,ID,Indonesia,SEARO,973,20162,36,1278
10018,2020-05-22T00:00:00Z,ID,Indonesia,SEARO,634,20796,48,1326
10019,2020-05-23T00:00:00Z,ID,Indonesia,SEARO,949,21745,25,1351
10020,2020-05-24T00:00:00Z,ID,Indonesia,SEARO,526,22271,21,1372
10021,2020-05-25T00:00:00Z,ID,Indonesia,SEARO,479,22750,19,1391
10022,2020-05-26T00:00:00Z,ID,Indonesia,SEARO,415,23165,27,1418
10023,2020-05-27T00:00:00Z,ID,Indonesia,SEARO,686,23851,55,1473
10024,2020-05-28T00:00:00Z,ID,Indonesia,SEARO,687,24538,23,1496
10025,2020-05-29T00:00:00Z,ID,Indonesia,SEARO,678,25216,24,1520
10026,2020-05-30T00:00:00Z,ID,Indonesia,SEARO,557,25773,53,1573
10027,2020-05-31T00:00:00Z,ID,Indonesia,SEARO,700,26473,40,1613
10028,2020-06-01T00:00:00Z,ID,Indonesia,SEARO,0,26473,0,1613
10029,2020-06-02T00:00:00Z,ID,Indonesia,SEARO,467,26940,28,1641
10030,2020-06-03T00:00:00Z,ID,Indonesia,SEARO,609,27549,22,1663
10031,2020-06-04T00:00:00Z,ID,Indonesia,SEARO,684,28233,35,1698
10032,2020-06-05T00:00:00Z,ID,Indonesia,SEARO,585,28818,23,1721
10033,2020-06-06T00:00:00Z,ID,Indonesia,SEARO,703,29521,49,1770
10034,2020-06-07T00:00:00Z,ID,Indonesia,SEARO,993,30514,31,1801
10035,2020-06-08T00:00:00Z,ID,Indonesia,SEARO,672,31186,50,1851
10036,2020-06-09T00:00:00Z,ID,Indonesia,SEARO,847,32033,32,1883
10037,2020-06-10T00:00:00Z,ID,Indonesia,SEARO,1043,33076,40,1923
10038,2020-06-11T00:00:00Z,ID,Indonesia,SEARO,1240,34316,36,1959
10039,2020-06-12T00:00:00Z,ID,Indonesia,SEARO,979,35295,41,2000
10040,2020-06-13T00:00:00Z,ID,Indonesia,SEARO,1111,36406,48,2048
10041,2020-06-14T00:00:00Z,ID,Indonesia,SEARO,1014,37420,43,2091
10042,2020-06-15T00:00:00Z,ID,Indonesia,SEARO,857,38277,43,2134
10043,2020-06-16T00:00:00Z,ID,Indonesia,SEARO,1017,39294,64,2198
10044,2020-06-17T00:00:00Z,ID,Indonesia,SEARO,1106,40400,33,2231
10045,2020-06-18T00:00:00Z,ID,Indonesia,SEARO,1031,41431,45,2276
10046,2020-06-19T00:00:00Z,ID,Indonesia,SEARO,1331,42762,63,2339
10047,2020-06-20T00:00:00Z,ID,Indonesia,SEARO,1041,43803,34,2373
12940,2020-03-07T00:00:00Z,MV,Maldives,SEARO,2,2,0,0
12941,2020-03-08T00:00:00Z,MV,Maldives,SEARO,2,4,0,0
12942,2020-03-09T00:00:00Z,MV,Maldives,SEARO,0,4,0,0
12943,2020-03-10T00:00:00Z,MV,Maldives,SEARO,2,6,0,0
12944,2020-03-11T00:00:00Z,MV,Maldives,SEARO,2,8,0,0
12945,2020-03-12T00:00:00Z,MV,Maldives,SEARO,0,8,0,0
12946,2020-03-13T00:00:00Z,MV,Maldives,SEARO,0,8,0,0
12947,2020-03-14T00:00:00Z,MV,Maldives,SEARO,1,9,0,0
12948,2020-03-15T00:00:00Z,MV,Maldives,SEARO,4,13,0,0
12949,2020-03-16T00:00:00Z,MV,Maldives,SEARO,0,13,0,0
12950,2020-03-17T00:00:00Z,MV,Maldives,SEARO,0,13,0,0
12951,2020-03-18T00:00:00Z,MV,Maldives,SEARO,0,13,0,0
12952,2020-03-19T00:00:00Z,MV,Maldives,SEARO,0,13,0,0
12953,2020-03-20T00:00:00Z,MV,Maldives,SEARO,0,13,0,0
12954,2020-03-21T00:00:00Z,MV,Maldives,SEARO,0,13,0,0
12955,2020-03-22T00:00:00Z,MV,Maldives,SEARO,0,13,0,0
12956,2020-03-23T00:00:00Z,MV,Maldives,SEARO,0,13,0,0
12957,2020-03-24T00:00:00Z,MV,Maldives,SEARO,0,13,0,0
12958,2020-03-25T00:00:00Z,MV,Maldives,SEARO,0,13,0,0
12959,2020-03-26T00:00:00Z,MV,Maldives,SEARO,0,13,0,0
12960,2020-03-27T00:00:00Z,MV,Maldives,SEARO,0,13,0,0
12961,2020-03-28T00:00:00Z,MV,Maldives,SEARO,0,13,0,0
12962,2020-03-29T00:00:00Z,MV,Maldives,SEARO,3,16,0,0
12963,2020-03-30T00:00:00Z,MV,Maldives,SEARO,1,17,0,0
12964,2020-03-31T00:00:00Z,MV,Maldives,SEARO,0,17,0,0
12965,2020-04-01T00:00:00Z,MV,Maldives,SEARO,1,18,0,0
12966,2020-04-02T00:00:00Z,MV,Maldives,SEARO,1,19,0,0
12967,2020-04-03T00:00:00Z,MV,Maldives,SEARO,0,19,0,0
12968,2020-04-04T00:00:00Z,MV,Maldives,SEARO,0,19,0,0
12969,2020-04-05T00:00:00Z,MV,Maldives,SEARO,0,19,0,0
12970,2020-04-06T00:00:00Z,MV,Maldives,SEARO,0,19,0,0
12971,2020-04-07T00:00:00Z,MV,Maldives,SEARO,0,19,0,0
12972,2020-04-08T00:00:00Z,MV,Maldives,SEARO,0,19,0,0
12973,2020-04-09T00:00:00Z,MV,Maldives,SEARO,0,19,0,0
12974,2020-04-10T00:00:00Z,MV,Maldives,SEARO,0,19,0,0
12975,2020-04-11T00:00:00Z,MV,Maldives,SEARO,0,19,0,0
12976,2020-04-12T00:00:00Z,MV,Maldives,SEARO,1,20,0,0
12977,2020-04-13T00:00:00Z,MV,Maldives,SEARO,0,20,0,0
12978,2020-04-14T00:00:00Z,MV,Maldives,SEARO,0,20,0,0
12979,2020-04-15T00:00:00Z,MV,Maldives,SEARO,1,21,0,0
12980,2020-04-16T00:00:00Z,MV,Maldives,SEARO,2,23,0,0
12981,2020-04-17T00:00:00Z,MV,Maldives,SEARO,5,28,0,0
12982,2020-04-18T00:00:00Z,MV,Maldives,SEARO,6,34,0,0
12983,2020-04-19T00:00:00Z,MV,Maldives,SEARO,17,51,0,0
12984,2020-04-20T00:00:00Z,MV,Maldives,SEARO,9,60,0,0
12985,2020-04-21T00:00:00Z,MV,Maldives,SEARO,23,83,0,0
12986,2020-04-22T00:00:00Z,MV,Maldives,SEARO,2,85,0,0
12987,2020-04-23T00:00:00Z,MV,Maldives,SEARO,9,94,0,0
12988,2020-04-24T00:00:00Z,MV,Maldives,SEARO,22,116,0,0
12989,2020-04-25T00:00:00Z,MV,Maldives,SEARO,21,137,0,0
12990,2020-04-26T00:00:00Z,MV,Maldives,SEARO,51,188,0,0
12991,2020-04-27T00:00:00Z,MV,Maldives,SEARO,26,214,0,0
12992,2020-04-28T00:00:00Z,MV,Maldives,SEARO,31,245,0,0
12993,2020-04-29T00:00:00Z,MV,Maldives,SEARO,11,256,0,0
12994,2020-04-30T00:00:00Z,MV,Maldives,SEARO,140,396,0,0
12995,2020-05-01T00:00:00Z,MV,Maldives,SEARO,72,468,1,1
12996,2020-05-02T00:00:00Z,MV,Maldives,SEARO,23,491,0,1
12997,2020-05-03T00:00:00Z,MV,Maldives,SEARO,28,519,0,1
12998,2020-05-04T00:00:00Z,MV,Maldives,SEARO,8,527,0,1
12999,2020-05-05T00:00:00Z,MV,Maldives,SEARO,30,557,0,1
13000,2020-05-06T00:00:00Z,MV,Maldives,SEARO,61,618,1,2
13001,2020-05-07T00:00:00Z,MV,Maldives,SEARO,0,618,0,2
13002,2020-05-08T00:00:00Z,MV,Maldives,SEARO,30,648,1,3
13003,2020-05-09T00:00:00Z,MV,Maldives,SEARO,96,744,0,3
13004,2020-05-10T00:00:00Z,MV,Maldives,SEARO,41,785,0,3
13005,2020-05-11T00:00:00Z,MV,Maldives,SEARO,50,835,0,3
13006,2020-05-12T00:00:00Z,MV,Maldives,SEARO,62,897,0,3
13007,2020-05-13T00:00:00Z,MV,Maldives,SEARO,7,904,0,3
13008,2020-05-14T00:00:00Z,MV,Maldives,SEARO,64,968,1,4
13009,2020-05-15T00:00:00Z,MV,Maldives,SEARO,52,1020,0,4
13010,2020-05-16T00:00:00Z,MV,Maldives,SEARO,58,1078,0,4
13011,2020-05-17T00:00:00Z,MV,Maldives,SEARO,0,1078,0,4
13012,2020-05-18T00:00:00Z,MV,Maldives,SEARO,16,1094,0,4
13013,2020-05-19T00:00:00Z,MV,Maldives,SEARO,49,1143,0,4
13014,2020-05-20T00:00:00Z,MV,Maldives,SEARO,43,1186,0,4
13015,2020-05-21T00:00:00Z,MV,Maldives,SEARO,30,1216,0,4
13016,2020-05-22T00:00:00Z,MV,Maldives,SEARO,0,1216,0,4
13017,2020-05-23T00:00:00Z,MV,Maldives,SEARO,58,1274,0,4
13018,2020-05-24T00:00:00Z,MV,Maldives,SEARO,39,1313,0,4
13019,2020-05-25T00:00:00Z,MV,Maldives,SEARO,82,1395,0,4
13020,2020-05-26T00:00:00Z,MV,Maldives,SEARO,0,1395,0,4
13021,2020-05-27T00:00:00Z,MV,Maldives,SEARO,62,1457,1,5
13022,2020-05-28T00:00:00Z,MV,Maldives,SEARO,0,1457,0,5
13023,2020-05-29T00:00:00Z,MV,Maldives,SEARO,56,1513,0,5
13024,2020-05-30T00:00:00Z,MV,Maldives,SEARO,120,1633,0,5
13025,2020-05-31T00:00:00Z,MV,Maldives,SEARO,39,1672,0,5
13026,2020-06-01T00:00:00Z,MV,Maldives,SEARO,101,1773,0,5
13027,2020-06-02T00:00:00Z,MV,Maldives,SEARO,56,1829,1,6
13028,2020-06-03T00:00:00Z,MV,Maldives,SEARO,12,1841,1,7
13029,2020-06-04T00:00:00Z,MV,Maldives,SEARO,9,1850,0,7
13030,2020-06-05T00:00:00Z,MV,Maldives,SEARO,22,1872,0,7
13031,2020-06-06T00:00:00Z,MV,Maldives,SEARO,11,1883,0,7
13032,2020-06-07T00:00:00Z,MV,Maldives,SEARO,18,1901,1,8
13033,2020-06-08T00:00:00Z,MV,Maldives,SEARO,2,1903,0,8
13034,2020-06-09T00:00:00Z,MV,Maldives,SEARO,13,1916,0,8
13035,2020-06-10T00:00:00Z,MV,Maldives,SEARO,26,1942,0,8
13036,2020-06-11T00:00:00Z,MV,Maldives,SEARO,20,1962,0,8
13037,2020-06-12T00:00:00Z,MV,Maldives,SEARO,14,1976,0,8
13038,2020-06-13T00:00:00Z,MV,Maldives,SEARO,27,2003,0,8
13039,2020-06-14T00:00:00Z,MV,Maldives,SEARO,10,2013,0,8
13040,2020-06-15T00:00:00Z,MV,Maldives,SEARO,22,2035,0,8
13041,2020-06-16T00:00:00Z,MV,Maldives,SEARO,30,2065,0,8
13042,2020-06-17T00:00:00Z,MV,Maldives,SEARO,29,2094,0,8
13043,2020-06-18T00:00:00Z,MV,Maldives,SEARO,26,2120,0,8
13044,2020-06-19T00:00:00Z,MV,Maldives,SEARO,17,2137,0,8
13045,2020-06-20T00:00:00Z,MV,Maldives,SEARO,13,2150,0,8
14360,2020-03-24T00:00:00Z,MM,Myanmar,SEARO,2,2,0,0
14361,2020-03-25T00:00:00Z,MM,Myanmar,SEARO,1,3,0,0
14362,2020-03-26T00:00:00Z,MM,Myanmar,SEARO,0,3,0,0
14363,2020-03-27T00:00:00Z,MM,Myanmar,SEARO,2,5,0,0
14364,2020-03-28T00:00:00Z,MM,Myanmar,SEARO,0,5,0,0
14365,2020-03-29T00:00:00Z,MM,Myanmar,SEARO,3,8,0,0
14366,2020-03-30T00:00:00Z,MM,Myanmar,SEARO,2,10,0,0
14367,2020-03-31T00:00:00Z,MM,Myanmar,SEARO,4,14,0,0
14368,2020-04-01T00:00:00Z,MM,Myanmar,SEARO,1,15,1,1
14369,2020-04-02T00:00:00Z,MM,Myanmar,SEARO,1,16,0,1
14370,2020-04-03T00:00:00Z,MM,Myanmar,SEARO,4,20,0,1
14371,2020-04-04T00:00:00Z,MM,Myanmar,SEARO,0,20,0,1
14372,2020-04-05T00:00:00Z,MM,Myanmar,SEARO,1,21,0,1
14373,2020-04-06T00:00:00Z,MM,Myanmar,SEARO,0,21,0,1
14374,2020-04-07T00:00:00Z,MM,Myanmar,SEARO,1,22,0,1
14375,2020-04-08T00:00:00Z,MM,Myanmar,SEARO,0,22,2,3
14376,2020-04-09T00:00:00Z,MM,Myanmar,SEARO,0,22,0,3
14377,2020-04-10T00:00:00Z,MM,Myanmar,SEARO,5,27,0,3
14378,2020-04-11T00:00:00Z,MM,Myanmar,SEARO,1,28,0,3
14379,2020-04-12T00:00:00Z,MM,Myanmar,SEARO,10,38,0,3
14380,2020-04-13T00:00:00Z,MM,Myanmar,SEARO,3,41,1,4
14381,2020-04-14T00:00:00Z,MM,Myanmar,SEARO,21,62,0,4
14382,2020-04-15T00:00:00Z,MM,Myanmar,SEARO,12,74,0,4
14383,2020-04-16T00:00:00Z,MM,Myanmar,SEARO,11,85,0,4
14384,2020-04-17T00:00:00Z,MM,Myanmar,SEARO,0,85,0,4
14385,2020-04-18T00:00:00Z,MM,Myanmar,SEARO,9,94,1,5
14386,2020-04-19T00:00:00Z,MM,Myanmar,SEARO,13,107,0,5
14387,2020-04-20T00:00:00Z,MM,Myanmar,SEARO,4,111,0,5
14388,2020-04-21T00:00:00Z,MM,Myanmar,SEARO,8,119,0,5
14389,2020-04-22T00:00:00Z,MM,Myanmar,SEARO,2,121,0,5
14390,2020-04-23T00:00:00Z,MM,Myanmar,SEARO,6,127,0,5
14391,2020-04-24T00:00:00Z,MM,Myanmar,SEARO,12,139,0,5
14392,2020-04-25T00:00:00Z,MM,Myanmar,SEARO,5,144,0,5
14393,2020-04-26T00:00:00Z,MM,Myanmar,SEARO,2,146,0,5
14394,2020-04-27T00:00:00Z,MM,Myanmar,SEARO,0,146,0,5
14395,2020-04-28T00:00:00Z,MM,Myanmar,SEARO,0,146,0,5
14396,2020-04-29T00:00:00Z,MM,Myanmar,SEARO,4,150,0,5
14397,2020-04-30T00:00:00Z,MM,Myanmar,SEARO,0,150,1,6
14398,2020-05-01T00:00:00Z,MM,Myanmar,SEARO,1,151,0,6
14399,2020-05-02T00:00:00Z,MM,Myanmar,SEARO,0,151,0,6
14400,2020-05-03T00:00:00Z,MM,Myanmar,SEARO,0,151,0,6
14401,2020-05-04T00:00:00Z,MM,Myanmar,SEARO,4,155,0,6
14402,2020-05-05T00:00:00Z,MM,Myanmar,SEARO,6,161,0,6
14403,2020-05-06T00:00:00Z,MM,Myanmar,SEARO,0,161,0,6
14404,2020-05-07T00:00:00Z,MM,Myanmar,SEARO,1,162,0,6
14405,2020-05-08T00:00:00Z,MM,Myanmar,SEARO,14,176,0,6
14406,2020-05-09T00:00:00Z,MM,Myanmar,SEARO,1,177,0,6
14407,2020-05-10T00:00:00Z,MM,Myanmar,SEARO,1,178,0,6
14408,2020-05-11T00:00:00Z,MM,Myanmar,SEARO,2,180,0,6
14409,2020-05-12T00:00:00Z,MM,Myanmar,SEARO,0,180,0,6
14410,2020-05-13T00:00:00Z,MM,Myanmar,SEARO,0,180,0,6
14411,2020-05-14T00:00:00Z,MM,Myanmar,SEARO,1,181,0,6
14412,2020-05-15T00:00:00Z,MM,Myanmar,SEARO,0,181,0,6
14413,2020-05-16T00:00:00Z,MM,Myanmar,SEARO,1,182,0,6
14414,2020-05-17T00:00:00Z,MM,Myanmar,SEARO,2,184,0,6
14415,2020-05-18T00:00:00Z,MM,Myanmar,SEARO,4,188,0,6
14416,2020-05-19T00:00:00Z,MM,Myanmar,SEARO,3,191,0,6
14417,2020-05-20T00:00:00Z,MM,Myanmar,SEARO,2,193,0,6
14418,2020-05-21T00:00:00Z,MM,Myanmar,SEARO,6,199,0,6
14419,2020-05-22T00:00:00Z,MM,Myanmar,SEARO,0,199,0,6
14420,2020-05-23T00:00:00Z,MM,Myanmar,SEARO,2,201,0,6
14421,2020-05-24T00:00:00Z,MM,Myanmar,SEARO,0,201,0,6
14422,2020-05-25T00:00:00Z,MM,Myanmar,SEARO,0,201,0,6
14423,2020-05-26T00:00:00Z,MM,Myanmar,SEARO,5,206,0,6
14424,2020-05-27T00:00:00Z,MM,Myanmar,SEARO,0,206,0,6
14425,2020-05-28T00:00:00Z,MM,Myanmar,SEARO,0,206,0,6
14426,2020-05-29T00:00:00Z,MM,Myanmar,SEARO,0,206,0,6
14427,2020-05-30T00:00:00Z,MM,Myanmar,SEARO,18,224,0,6
14428,2020-05-31T00:00:00Z,MM,Myanmar,SEARO,0,224,0,6
14429,2020-06-01T00:00:00Z,MM,Myanmar,SEARO,0,224,0,6
14430,2020-06-02T00:00:00Z,MM,Myanmar,SEARO,4,228,0,6
14431,2020-06-03T00:00:00Z,MM,Myanmar,SEARO,5,233,0,6
14432,2020-06-04T00:00:00Z,MM,Myanmar,SEARO,1,234,0,6
14433,2020-06-05T00:00:00Z,MM,Myanmar,SEARO,2,236,0,6
14434,2020-06-06T00:00:00Z,MM,Myanmar,SEARO,0,236,0,6
14435,2020-06-07T00:00:00Z,MM,Myanmar,SEARO,4,240,0,6
14436,2020-06-08T00:00:00Z,MM,Myanmar,SEARO,2,242,0,6
14437,2020-06-09T00:00:00Z,MM,Myanmar,SEARO,2,244,0,6
14438,2020-06-10T00:00:00Z,MM,Myanmar,SEARO,2,246,0,6
14439,2020-06-11T00:00:00Z,MM,Myanmar,SEARO,2,248,0,6
14440,2020-06-12T00:00:00Z,MM,Myanmar,SEARO,13,261,0,6
14441,2020-06-13T00:00:00Z,MM,Myanmar,SEARO,0,261,0,6
14442,2020-06-14T00:00:00Z,MM,Myanmar,SEARO,0,261,0,6
14443,2020-06-15T00:00:00Z,MM,Myanmar,SEARO,1,262,0,6
14444,2020-06-16T00:00:00Z,MM,Myanmar,SEARO,0,262,0,6
14445,2020-06-17T00:00:00Z,MM,Myanmar,SEARO,0,262,0,6
14446,2020-06-18T00:00:00Z,MM,Myanmar,SEARO,1,263,0,6
14447,2020-06-19T00:00:00Z,MM,Myanmar,SEARO,23,286,0,6
14448,2020-06-20T00:00:00Z,MM,Myanmar,SEARO,0,286,0,6
14548,2020-01-23T00:00:00Z,NP,Nepal,SEARO,1,1,0,0
14549,2020-01-24T00:00:00Z,NP,Nepal,SEARO,0,1,0,0
14550,2020-01-25T00:00:00Z,NP,Nepal,SEARO,0,1,0,0
14551,2020-01-26T00:00:00Z,NP,Nepal,SEARO,0,1,0,0
14552,2020-01-27T00:00:00Z,NP,Nepal,SEARO,0,1,0,0
14553,2020-01-28T00:00:00Z,NP,Nepal,SEARO,0,1,0,0
14554,2020-01-29T00:00:00Z,NP,Nepal,SEARO,0,1,0,0
14555,2020-01-30T00:00:00Z,NP,Nepal,SEARO,0,1,0,0
14556,2020-01-31T00:00:00Z,NP,Nepal,SEARO,0,1,0,0
14557,2020-02-01T00:00:00Z,NP,Nepal,SEARO,0,1,0,0
14558,2020-02-02T00:00:00Z,NP,Nepal,SEARO,0,1,0,0
14559,2020-02-03T00:00:00Z,NP,Nepal,SEARO,0,1,0,0
14560,2020-02-04T00:00:00Z,NP,Nepal,SEARO,0,1,0,0
14561,2020-02-05T00:00:00Z,NP,Nepal,SEARO,0,1,0,0
14562,2020-02-06T00:00:00Z,NP,Nepal,SEARO,0,1,0,0
14563,2020-02-07T00:00:00Z,NP,Nepal,SEARO,0,1,0,0
14564,2020-02-08T00:00:00Z,NP,Nepal,SEARO,0,1,0,0
14565,2020-02-09T00:00:00Z,NP,Nepal,SEARO,0,1,0,0
14566,2020-02-10T00:00:00Z,NP,Nepal,SEARO,0,1,0,0
14567,2020-02-11T00:00:00Z,NP,Nepal,SEARO,0,1,0,0
14568,2020-02-12T00:00:00Z,NP,Nepal,SEARO,0,1,0,0
14569,2020-02-13T00:00:00Z,NP,Nepal,SEARO,0,1,0,0
14570,2020-02-14T00:00:00Z,NP,Nepal,SEARO,0,1,0,0
14571,2020-02-15T00:00:00Z,NP,Nepal,SEARO,0,1,0,0
14572,2020-02-16T00:00:00Z,NP,Nepal,SEARO,0,1,0,0
14573,2020-02-17T00:00:00Z,NP,Nepal,SEARO,0,1,0,0
14574,2020-02-18T00:00:00Z,NP,Nepal,SEARO,0,1,0,0
14575,2020-02-19T00:00:00Z,NP,Nepal,SEARO,0,1,0,0
14576,2020-02-20T00:00:00Z,NP,Nepal,SEARO,0,1,0,0
14577,2020-02-21T00:00:00Z,NP,Nepal,SEARO,0,1,0,0
14578,2020-02-22T00:00:00Z,NP,Nepal,SEARO,0,1,0,0
14579,2020-02-23T00:00:00Z,NP,Nepal,SEARO,0,1,0,0
14580,2020-02-24T00:00:00Z,NP,Nepal,SEARO,0,1,0,0
14581,2020-02-25T00:00:00Z,NP,Nepal,SEARO,0,1,0,0
14582,2020-02-26T00:00:00Z,NP,Nepal,SEARO,0,1,0,0
14583,2020-02-27T00:00:00Z,NP,Nepal,SEARO,0,1,0,0
14584,2020-02-28T00:00:00Z,NP,Nepal,SEARO,0,1,0,0
14585,2020-02-29T00:00:00Z,NP,Nepal,SEARO,0,1,0,0
14586,2020-03-01T00:00:00Z,NP,Nepal,SEARO,0,1,0,0
14587,2020-03-02T00:00:00Z,NP,Nepal,SEARO,0,1,0,0
14588,2020-03-03T00:00:00Z,NP,Nepal,SEARO,0,1,0,0
14589,2020-03-04T00:00:00Z,NP,Nepal,SEARO,0,1,0,0
14590,2020-03-05T00:00:00Z,NP,Nepal,SEARO,0,1,0,0
14591,2020-03-06T00:00:00Z,NP,Nepal,SEARO,0,1,0,0
14592,2020-03-07T00:00:00Z,NP,Nepal,SEARO,0,1,0,0
14593,2020-03-08T00:00:00Z,NP,Nepal,SEARO,0,1,0,0
14594,2020-03-09T00:00:00Z,NP,Nepal,SEARO,0,1,0,0
14595,2020-03-10T00:00:00Z,NP,Nepal,SEARO,0,1,0,0
14596,2020-03-11T00:00:00Z,NP,Nepal,SEARO,0,1,0,0
14597,2020-03-12T00:00:00Z,NP,Nepal,SEARO,0,1,0,0
14598,2020-03-13T00:00:00Z,NP,Nepal,SEARO,0,1,0,0
14599,2020-03-14T00:00:00Z,NP,Nepal,SEARO,0,1,0,0
14600,2020-03-15T00:00:00Z,NP,Nepal,SEARO,0,1,0,0
14601,2020-03-16T00:00:00Z,NP,Nepal,SEARO,0,1,0,0
14602,2020-03-17T00:00:00Z,NP,Nepal,SEARO,0,1,0,0
14603,2020-03-18T00:00:00Z,NP,Nepal,SEARO,0,1,0,0
14604,2020-03-19T00:00:00Z,NP,Nepal,SEARO,0,1,0,0
14605,2020-03-20T00:00:00Z,NP,Nepal,SEARO,0,1,0,0
14606,2020-03-21T00:00:00Z,NP,Nepal,SEARO,0,1,0,0
14607,2020-03-22T00:00:00Z,NP,Nepal,SEARO,0,1,0,0
14608,2020-03-23T00:00:00Z,NP,Nepal,SEARO,0,1,0,0
14609,2020-03-24T00:00:00Z,NP,Nepal,SEARO,1,2,0,0
14610,2020-03-25T00:00:00Z,NP,Nepal,SEARO,0,2,0,0
14611,2020-03-26T00:00:00Z,NP,Nepal,SEARO,1,3,0,0
14612,2020-03-27T00:00:00Z,NP,Nepal,SEARO,0,3,0,0
14613,2020-03-28T00:00:00Z,NP,Nepal,SEARO,0,3,0,0
14614,2020-03-29T00:00:00Z,NP,Nepal,SEARO,2,5,0,0
14615,2020-03-30T00:00:00Z,NP,Nepal,SEARO,0,5,0,0
14616,2020-03-31T00:00:00Z,NP,Nepal,SEARO,0,5,0,0
14617,2020-04-01T00:00:00Z,NP,Nepal,SEARO,0,5,0,0
14618,2020-04-02T00:00:00Z,NP,Nepal,SEARO,0,5,0,0
14619,2020-04-03T00:00:00Z,NP,Nepal,SEARO,1,6,0,0
14620,2020-04-04T00:00:00Z,NP,Nepal,SEARO,0,6,0,0
14621,2020-04-05T00:00:00Z,NP,Nepal,SEARO,3,9,0,0
14622,2020-04-06T00:00:00Z,NP,Nepal,SEARO,0,9,0,0
14623,2020-04-07T00:00:00Z,NP,Nepal,SEARO,0,9,0,0
14624,2020-04-08T00:00:00Z,NP,Nepal,SEARO,0,9,0,0
14625,2020-04-09T00:00:00Z,NP,Nepal,SEARO,0,9,0,0
14626,2020-04-10T00:00:00Z,NP,Nepal,SEARO,0,9,0,0
14627,2020-04-11T00:00:00Z,NP,Nepal,SEARO,0,9,0,0
14628,2020-04-12T00:00:00Z,NP,Nepal,SEARO,3,12,0,0
14629,2020-04-13T00:00:00Z,NP,Nepal,SEARO,2,14,0,0
14630,2020-04-14T00:00:00Z,NP,Nepal,SEARO,2,16,0,0
14631,2020-04-15T00:00:00Z,NP,Nepal,SEARO,0,16,0,0
14632,2020-04-16T00:00:00Z,NP,Nepal,SEARO,0,16,0,0
14633,2020-04-17T00:00:00Z,NP,Nepal,SEARO,0,16,0,0
14634,2020-04-18T00:00:00Z,NP,Nepal,SEARO,14,30,0,0
14635,2020-04-19T00:00:00Z,NP,Nepal,SEARO,1,31,0,0
14636,2020-04-20T00:00:00Z,NP,Nepal,SEARO,0,31,0,0
14637,2020-04-21T00:00:00Z,NP,Nepal,SEARO,1,32,0,0
14638,2020-04-22T00:00:00Z,NP,Nepal,SEARO,10,42,0,0
14639,2020-04-23T00:00:00Z,NP,Nepal,SEARO,3,45,0,0
14640,2020-04-24T00:00:00Z,NP,Nepal,SEARO,3,48,0,0
14641,2020-04-25T00:00:00Z,NP,Nepal,SEARO,1,49,0,0
14642,2020-04-26T00:00:00Z,NP,Nepal,SEARO,2,51,0,0
14643,2020-04-27T00:00:00Z,NP,Nepal,SEARO,1,52,0,0
14644,2020-04-28T00:00:00Z,NP,Nepal,SEARO,0,52,0,0
14645,2020-04-29T00:00:00Z,NP,Nepal,SEARO,5,57,0,0
14646,2020-04-30T00:00:00Z,NP,Nepal,SEARO,0,57,0,0
14647,2020-05-01T00:00:00Z,NP,Nepal,SEARO,2,59,0,0
14648,2020-05-02T00:00:00Z,NP,Nepal,SEARO,0,59,0,0
14649,2020-05-03T00:00:00Z,NP,Nepal,SEARO,10,69,0,0
14650,2020-05-04T00:00:00Z,NP,Nepal,SEARO,6,75,0,0
14651,2020-05-05T00:00:00Z,NP,Nepal,SEARO,7,82,0,0
14652,2020-05-06T00:00:00Z,NP,Nepal,SEARO,17,99,0,0
14653,2020-05-07T00:00:00Z,NP,Nepal,SEARO,0,99,0,0
14654,2020-05-08T00:00:00Z,NP,Nepal,SEARO,3,102,0,0
14655,2020-05-09T00:00:00Z,NP,Nepal,SEARO,7,109,0,0
14656,2020-05-10T00:00:00Z,NP,Nepal,SEARO,1,110,0,0
14657,2020-05-11T00:00:00Z,NP,Nepal,SEARO,11,121,0,0
14658,2020-05-12T00:00:00Z,NP,Nepal,SEARO,70,191,0,0
14659,2020-05-13T00:00:00Z,NP,Nepal,SEARO,52,243,0,0
14660,2020-05-14T00:00:00Z,NP,Nepal,SEARO,6,249,0,0
14661,2020-05-15T00:00:00Z,NP,Nepal,SEARO,9,258,0,0
14662,2020-05-16T00:00:00Z,NP,Nepal,SEARO,23,281,1,1
14663,2020-05-17T00:00:00Z,NP,Nepal,SEARO,14,295,1,2
14664,2020-05-18T00:00:00Z,NP,Nepal,SEARO,62,357,0,2
14665,2020-05-19T00:00:00Z,NP,Nepal,SEARO,45,402,0,2
14666,2020-05-20T00:00:00Z,NP,Nepal,SEARO,25,427,0,2
14667,2020-05-21T00:00:00Z,NP,Nepal,SEARO,27,454,1,3
14668,2020-05-22T00:00:00Z,NP,Nepal,SEARO,62,516,0,3
14669,2020-05-23T00:00:00Z,NP,Nepal,SEARO,68,584,0,3
14670,2020-05-24T00:00:00Z,NP,Nepal,SEARO,19,603,0,3
14671,2020-05-25T00:00:00Z,NP,Nepal,SEARO,79,682,1,4
14672,2020-05-26T00:00:00Z,NP,Nepal,SEARO,90,772,0,4
14673,2020-05-27T00:00:00Z,NP,Nepal,SEARO,114,886,0,4
14674,2020-05-28T00:00:00Z,NP,Nepal,SEARO,156,1042,1,5
14675,2020-05-29T00:00:00Z,NP,Nepal,SEARO,170,1212,1,6
14676,2020-05-30T00:00:00Z,NP,Nepal,SEARO,189,1401,0,6
14677,2020-05-31T00:00:00Z,NP,Nepal,SEARO,171,1572,2,8
14678,2020-06-01T00:00:00Z,NP,Nepal,SEARO,0,1572,0,8
14679,2020-06-02T00:00:00Z,NP,Nepal,SEARO,239,1811,0,8
14680,2020-06-03T00:00:00Z,NP,Nepal,SEARO,288,2099,0,8
14681,2020-06-04T00:00:00Z,NP,Nepal,SEARO,201,2300,1,9
14682,2020-06-05T00:00:00Z,NP,Nepal,SEARO,334,2634,1,10
14683,2020-06-06T00:00:00Z,NP,Nepal,SEARO,278,2912,1,11
14684,2020-06-07T00:00:00Z,NP,Nepal,SEARO,323,3235,2,13
14685,2020-06-08T00:00:00Z,NP,Nepal,SEARO,213,3448,0,13
14686,2020-06-09T00:00:00Z,NP,Nepal,SEARO,314,3762,1,14
14687,2020-06-10T00:00:00Z,NP,Nepal,SEARO,323,4085,1,15
14688,2020-06-11T00:00:00Z,NP,Nepal,SEARO,279,4364,0,15
14689,2020-06-12T00:00:00Z,NP,Nepal,SEARO,250,4614,0,15
14690,2020-06-13T00:00:00Z,NP,Nepal,SEARO,448,5062,1,16
14691,2020-06-14T00:00:00Z,NP,Nepal,SEARO,273,5335,2,18
14692,2020-06-15T00:00:00Z,NP,Nepal,SEARO,425,5760,1,19
14693,2020-06-16T00:00:00Z,NP,Nepal,SEARO,451,6211,0,19
14694,2020-06-17T00:00:00Z,NP,Nepal,SEARO,380,6591,0,19
14695,2020-06-18T00:00:00Z,NP,Nepal,SEARO,586,7177,1,20
14696,2020-06-19T00:00:00Z,NP,Nepal,SEARO,671,7848,2,22
14697,2020-06-20T00:00:00Z,NP,Nepal,SEARO,426,8274,0,22
19978,2020-01-27T00:00:00Z,LK,Sri Lanka,SEARO,1,1,0,0
19979,2020-01-28T00:00:00Z,LK,Sri Lanka,SEARO,0,1,0,0
19980,2020-01-29T00:00:00Z,LK,Sri Lanka,SEARO,0,1,0,0
19981,2020-01-30T00:00:00Z,LK,Sri Lanka,SEARO,0,1,0,0
19982,2020-01-31T00:00:00Z,LK,Sri Lanka,SEARO,0,1,0,0
19983,2020-02-01T00:00:00Z,LK,Sri Lanka,SEARO,0,1,0,0
19984,2020-02-02T00:00:00Z,LK,Sri Lanka,SEARO,0,1,0,0
19985,2020-02-03T00:00:00Z,LK,Sri Lanka,SEARO,0,1,0,0
19986,2020-02-04T00:00:00Z,LK,Sri Lanka,SEARO,0,1,0,0
19987,2020-02-05T00:00:00Z,LK,Sri Lanka,SEARO,0,1,0,0
19988,2020-02-06T00:00:00Z,LK,Sri Lanka,SEARO,0,1,0,0
19989,2020-02-07T00:00:00Z,LK,Sri Lanka,SEARO,0,1,0,0
19990,2020-02-08T00:00:00Z,LK,Sri Lanka,SEARO,0,1,0,0
19991,2020-02-09T00:00:00Z,LK,Sri Lanka,SEARO,0,1,0,0
19992,2020-02-10T00:00:00Z,LK,Sri Lanka,SEARO,0,1,0,0
19993,2020-02-11T00:00:00Z,LK,Sri Lanka,SEARO,0,1,0,0
19994,2020-02-12T00:00:00Z,LK,Sri Lanka,SEARO,0,1,0,0
19995,2020-02-13T00:00:00Z,LK,Sri Lanka,SEARO,0,1,0,0
19996,2020-02-14T00:00:00Z,LK,Sri Lanka,SEARO,0,1,0,0
19997,2020-02-15T00:00:00Z,LK,Sri Lanka,SEARO,0,1,0,0
19998,2020-02-16T00:00:00Z,LK,Sri Lanka,SEARO,0,1,0,0
19999,2020-02-17T00:00:00Z,LK,Sri Lanka,SEARO,0,1,0,0
20000,2020-02-18T00:00:00Z,LK,Sri Lanka,SEARO,0,1,0,0
20001,2020-02-19T00:00:00Z,LK,Sri Lanka,SEARO,0,1,0,0
20002,2020-02-20T00:00:00Z,LK,Sri Lanka,SEARO,0,1,0,0
20003,2020-02-21T00:00:00Z,LK,Sri Lanka,SEARO,0,1,0,0
20004,2020-02-22T00:00:00Z,LK,Sri Lanka,SEARO,0,1,0,0
20005,2020-02-23T00:00:00Z,LK,Sri Lanka,SEARO,0,1,0,0
20006,2020-02-24T00:00:00Z,LK,Sri Lanka,SEARO,0,1,0,0
20007,2020-02-25T00:00:00Z,LK,Sri Lanka,SEARO,0,1,0,0
20008,2020-02-26T00:00:00Z,LK,Sri Lanka,SEARO,0,1,0,0
20009,2020-02-27T00:00:00Z,LK,Sri Lanka,SEARO,0,1,0,0
20010,2020-02-28T00:00:00Z,LK,Sri Lanka,SEARO,0,1,0,0
20011,2020-02-29T00:00:00Z,LK,Sri Lanka,SEARO,0,1,0,0
20012,2020-03-01T00:00:00Z,LK,Sri Lanka,SEARO,0,1,0,0
20013,2020-03-02T00:00:00Z,LK,Sri Lanka,SEARO,0,1,0,0
20014,2020-03-03T00:00:00Z,LK,Sri Lanka,SEARO,0,1,0,0
20015,2020-03-04T00:00:00Z,LK,Sri Lanka,SEARO,0,1,0,0
20016,2020-03-05T00:00:00Z,LK,Sri Lanka,SEARO,0,1,0,0
20017,2020-03-06T00:00:00Z,LK,Sri Lanka,SEARO,0,1,0,0
20018,2020-03-07T00:00:00Z,LK,Sri Lanka,SEARO,0,1,0,0
20019,2020-03-08T00:00:00Z,LK,Sri Lanka,SEARO,0,1,0,0
20020,2020-03-09T00:00:00Z,LK,Sri Lanka,SEARO,0,1,0,0
20021,2020-03-10T00:00:00Z,LK,Sri Lanka,SEARO,0,1,0,0
20022,2020-03-11T00:00:00Z,LK,Sri Lanka,SEARO,1,2,0,0
20023,2020-03-12T00:00:00Z,LK,Sri Lanka,SEARO,1,3,0,0
20024,2020-03-13T00:00:00Z,LK,Sri Lanka,SEARO,0,3,0,0
20025,2020-03-14T00:00:00Z,LK,Sri Lanka,SEARO,3,6,0,0
20026,2020-03-15T00:00:00Z,LK,Sri Lanka,SEARO,5,11,0,0
20027,2020-03-16T00:00:00Z,LK,Sri Lanka,SEARO,8,19,0,0
20028,2020-03-17T00:00:00Z,LK,Sri Lanka,SEARO,10,29,0,0
20029,2020-03-18T00:00:00Z,LK,Sri Lanka,SEARO,13,42,0,0
20030,2020-03-19T00:00:00Z,LK,Sri Lanka,SEARO,17,59,0,0
20031,2020-03-20T00:00:00Z,LK,Sri Lanka,SEARO,0,59,0,0
20032,2020-03-21T00:00:00Z,LK,Sri Lanka,SEARO,13,72,0,0
20033,2020-03-22T00:00:00Z,LK,Sri Lanka,SEARO,0,72,0,0
20034,2020-03-23T00:00:00Z,LK,Sri Lanka,SEARO,22,94,0,0
20035,2020-03-24T00:00:00Z,LK,Sri Lanka,SEARO,3,97,0,0
20036,2020-03-25T00:00:00Z,LK,Sri Lanka,SEARO,5,102,0,0
20037,2020-03-26T00:00:00Z,LK,Sri Lanka,SEARO,0,102,0,0
20038,2020-03-27T00:00:00Z,LK,Sri Lanka,SEARO,4,106,0,0
20039,2020-03-28T00:00:00Z,LK,Sri Lanka,SEARO,0,106,0,0
20040,2020-03-29T00:00:00Z,LK,Sri Lanka,SEARO,9,115,1,1
20041,2020-03-30T00:00:00Z,LK,Sri Lanka,SEARO,5,120,0,1
20042,2020-03-31T00:00:00Z,LK,Sri Lanka,SEARO,2,122,1,2
20043,2020-04-01T00:00:00Z,LK,Sri Lanka,SEARO,21,143,0,2
20044,2020-04-02T00:00:00Z,LK,Sri Lanka,SEARO,5,148,1,3
20045,2020-04-03T00:00:00Z,LK,Sri Lanka,SEARO,3,151,1,4
20046,2020-04-04T00:00:00Z,LK,Sri Lanka,SEARO,8,159,1,5
20047,2020-04-05T00:00:00Z,LK,Sri Lanka,SEARO,7,166,0,5
20048,2020-04-06T00:00:00Z,LK,Sri Lanka,SEARO,10,176,0,5
20049,2020-04-07T00:00:00Z,LK,Sri Lanka,SEARO,4,180,1,6
20050,2020-04-08T00:00:00Z,LK,Sri Lanka,SEARO,6,186,0,6
20051,2020-04-09T00:00:00Z,LK,Sri Lanka,SEARO,3,189,1,7
20052,2020-04-10T00:00:00Z,LK,Sri Lanka,SEARO,1,190,0,7
20053,2020-04-11T00:00:00Z,LK,Sri Lanka,SEARO,7,197,0,7
20054,2020-04-12T00:00:00Z,LK,Sri Lanka,SEARO,2,199,0,7
20055,2020-04-13T00:00:00Z,LK,Sri Lanka,SEARO,11,210,0,7
20056,2020-04-14T00:00:00Z,LK,Sri Lanka,SEARO,8,218,0,7
20057,2020-04-15T00:00:00Z,LK,Sri Lanka,SEARO,15,233,0,7
20058,2020-04-16T00:00:00Z,LK,Sri Lanka,SEARO,5,238,0,7
20059,2020-04-17T00:00:00Z,LK,Sri Lanka,SEARO,0,238,0,7
20060,2020-04-18T00:00:00Z,LK,Sri Lanka,SEARO,6,244,0,7
20061,2020-04-19T00:00:00Z,LK,Sri Lanka,SEARO,10,254,0,7
20062,2020-04-20T00:00:00Z,LK,Sri Lanka,SEARO,17,271,0,7
20063,2020-04-21T00:00:00Z,LK,Sri Lanka,SEARO,33,304,0,7
20064,2020-04-22T00:00:00Z,LK,Sri Lanka,SEARO,6,310,0,7
20065,2020-04-23T00:00:00Z,LK,Sri Lanka,SEARO,20,330,0,7
20066,2020-04-24T00:00:00Z,LK,Sri Lanka,SEARO,38,368,0,7
20067,2020-04-25T00:00:00Z,LK,Sri Lanka,SEARO,52,420,0,7
20068,2020-04-26T00:00:00Z,LK,Sri Lanka,SEARO,40,460,0,7
20069,2020-04-27T00:00:00Z,LK,Sri Lanka,SEARO,63,523,0,7
20070,2020-04-28T00:00:00Z,LK,Sri Lanka,SEARO,65,588,0,7
20071,2020-04-29T00:00:00Z,LK,Sri Lanka,SEARO,31,619,0,7
20072,2020-04-30T00:00:00Z,LK,Sri Lanka,SEARO,30,649,0,7
20073,2020-05-01T00:00:00Z,LK,Sri Lanka,SEARO,16,665,0,7
20074,2020-05-02T00:00:00Z,LK,Sri Lanka,SEARO,25,690,0,7
20075,2020-05-03T00:00:00Z,LK,Sri Lanka,SEARO,15,705,0,7
20076,2020-05-04T00:00:00Z,LK,Sri Lanka,SEARO,13,718,0,7
20077,2020-05-05T00:00:00Z,LK,Sri Lanka,SEARO,37,755,1,8
20078,2020-05-06T00:00:00Z,LK,Sri Lanka,SEARO,16,771,1,9
20079,2020-05-07T00:00:00Z,LK,Sri Lanka,SEARO,26,797,0,9
20080,2020-05-08T00:00:00Z,LK,Sri Lanka,SEARO,27,824,0,9
20081,2020-05-09T00:00:00Z,LK,Sri Lanka,SEARO,11,835,0,9
20082,2020-05-10T00:00:00Z,LK,Sri Lanka,SEARO,12,847,0,9
20083,2020-05-11T00:00:00Z,LK,Sri Lanka,SEARO,16,863,0,9
20084,2020-05-12T00:00:00Z,LK,Sri Lanka,SEARO,6,869,0,9
20085,2020-05-13T00:00:00Z,LK,Sri Lanka,SEARO,24,893,0,9
20086,2020-05-14T00:00:00Z,LK,Sri Lanka,SEARO,23,916,0,9
20087,2020-05-15T00:00:00Z,LK,Sri Lanka,SEARO,9,925,0,9
20088,2020-05-16T00:00:00Z,LK,Sri Lanka,SEARO,24,949,0,9
20089,2020-05-17T00:00:00Z,LK,Sri Lanka,SEARO,21,970,0,9
20090,2020-05-18T00:00:00Z,LK,Sri Lanka,SEARO,16,986,0,9
20091,2020-05-19T00:00:00Z,LK,Sri Lanka,SEARO,34,1020,0,9
20092,2020-05-20T00:00:00Z,LK,Sri Lanka,SEARO,7,1027,0,9
20093,2020-05-21T00:00:00Z,LK,Sri Lanka,SEARO,18,1045,0,9
20094,2020-05-22T00:00:00Z,LK,Sri Lanka,SEARO,15,1060,0,9
20095,2020-05-23T00:00:00Z,LK,Sri Lanka,SEARO,25,1085,0,9
20096,2020-05-24T00:00:00Z,LK,Sri Lanka,SEARO,33,1118,0,9
20097,2020-05-25T00:00:00Z,LK,Sri Lanka,SEARO,64,1182,0,9
20098,2020-05-26T00:00:00Z,LK,Sri Lanka,SEARO,96,1278,1,10
20099,2020-05-27T00:00:00Z,LK,Sri Lanka,SEARO,147,1425,0,10
20100,2020-05-28T00:00:00Z,LK,Sri Lanka,SEARO,78,1503,0,10
20101,2020-05-29T00:00:00Z,LK,Sri Lanka,SEARO,37,1540,0,10
20102,2020-05-30T00:00:00Z,LK,Sri Lanka,SEARO,26,1566,0,10
20103,2020-05-31T00:00:00Z,LK,Sri Lanka,SEARO,64,1630,0,10
20104,2020-06-01T00:00:00Z,LK,Sri Lanka,SEARO,3,1633,0,10
20105,2020-06-02T00:00:00Z,LK,Sri Lanka,SEARO,10,1643,1,11
20106,2020-06-03T00:00:00Z,LK,Sri Lanka,SEARO,40,1683,0,11
20107,2020-06-04T00:00:00Z,LK,Sri Lanka,SEARO,66,1749,0,11
20108,2020-06-05T00:00:00Z,LK,Sri Lanka,SEARO,48,1797,0,11
20109,2020-06-06T00:00:00Z,LK,Sri Lanka,SEARO,4,1801,0,11
20110,2020-06-07T00:00:00Z,LK,Sri Lanka,SEARO,13,1814,0,11
20111,2020-06-08T00:00:00Z,LK,Sri Lanka,SEARO,21,1835,0,11
20112,2020-06-09T00:00:00Z,LK,Sri Lanka,SEARO,22,1857,0,11
20113,2020-06-10T00:00:00Z,LK,Sri Lanka,SEARO,2,1859,0,11
20114,2020-06-11T00:00:00Z,LK,Sri Lanka,SEARO,10,1869,0,11
20115,2020-06-12T00:00:00Z,LK,Sri Lanka,SEARO,8,1877,0,11
20116,2020-06-13T00:00:00Z,LK,Sri Lanka,SEARO,3,1880,0,11
20117,2020-06-14T00:00:00Z,LK,Sri Lanka,SEARO,4,1884,0,11
20118,2020-06-15T00:00:00Z,LK,Sri Lanka,SEARO,5,1889,0,11
20119,2020-06-16T00:00:00Z,LK,Sri Lanka,SEARO,16,1905,0,11
20120,2020-06-17T00:00:00Z,LK,Sri Lanka,SEARO,10,1915,0,11
20121,2020-06-18T00:00:00Z,LK,Sri Lanka,SEARO,9,1924,0,11
20122,2020-06-19T00:00:00Z,LK,Sri Lanka,SEARO,23,1947,0,11
20123,2020-06-20T00:00:00Z,LK,Sri Lanka,SEARO,3,1950,0,11
20721,2020-01-13T00:00:00Z,TH,Thailand,SEARO,1,1,0,0
20722,2020-01-14T00:00:00Z,TH,Thailand,SEARO,0,1,0,0
20723,2020-01-15T00:00:00Z,TH,Thailand,SEARO,0,1,0,0
20724,2020-01-16T00:00:00Z,TH,Thailand,SEARO,0,1,0,0
20725,2020-01-17T00:00:00Z,TH,Thailand,SEARO,1,2,0,0
20726,2020-01-18T00:00:00Z,TH,Thailand,SEARO,0,2,0,0
20727,2020-01-19T00:00:00Z,TH,Thailand,SEARO,0,2,0,0
20728,2020-01-20T00:00:00Z,TH,Thailand,SEARO,0,2,0,0
20729,2020-01-21T00:00:00Z,TH,Thailand,SEARO,0,2,0,0
20730,2020-01-22T00:00:00Z,TH,Thailand,SEARO,2,4,0,0
20731,2020-01-23T00:00:00Z,TH,Thailand,SEARO,0,4,0,0
20732,2020-01-24T00:00:00Z,TH,Thailand,SEARO,0,4,0,0
20733,2020-01-25T00:00:00Z,TH,Thailand,SEARO,0,4,0,0
20734,2020-01-26T00:00:00Z,TH,Thailand,SEARO,1,5,0,0
20735,2020-01-27T00:00:00Z,TH,Thailand,SEARO,3,8,0,0
20736,2020-01-28T00:00:00Z,TH,Thailand,SEARO,6,14,0,0
20737,2020-01-29T00:00:00Z,TH,Thailand,SEARO,0,14,0,0
20738,2020-01-30T00:00:00Z,TH,Thailand,SEARO,0,14,0,0
20739,2020-01-31T00:00:00Z,TH,Thailand,SEARO,5,19,0,0
20740,2020-02-01T00:00:00Z,TH,Thailand,SEARO,0,19,0,0
20741,2020-02-02T00:00:00Z,TH,Thailand,SEARO,0,19,0,0
20742,2020-02-03T00:00:00Z,TH,Thailand,SEARO,0,19,0,0
20743,2020-02-04T00:00:00Z,TH,Thailand,SEARO,6,25,0,0
20744,2020-02-05T00:00:00Z,TH,Thailand,SEARO,0,25,0,0
20745,2020-02-06T00:00:00Z,TH,Thailand,SEARO,0,25,0,0
20746,2020-02-07T00:00:00Z,TH,Thailand,SEARO,0,25,0,0
20747,2020-02-08T00:00:00Z,TH,Thailand,SEARO,7,32,0,0
20748,2020-02-09T00:00:00Z,TH,Thailand,SEARO,0,32,0,0
20749,2020-02-10T00:00:00Z,TH,Thailand,SEARO,0,32,0,0
20750,2020-02-11T00:00:00Z,TH,Thailand,SEARO,1,33,0,0
20751,2020-02-12T00:00:00Z,TH,Thailand,SEARO,0,33,0,0
20752,2020-02-13T00:00:00Z,TH,Thailand,SEARO,0,33,0,0
20753,2020-02-14T00:00:00Z,TH,Thailand,SEARO,0,33,0,0
20754,2020-02-15T00:00:00Z,TH,Thailand,SEARO,1,34,0,0
20755,2020-02-16T00:00:00Z,TH,Thailand,SEARO,0,34,0,0
20756,2020-02-17T00:00:00Z,TH,Thailand,SEARO,1,35,0,0
20757,2020-02-18T00:00:00Z,TH,Thailand,SEARO,0,35,0,0
20758,2020-02-19T00:00:00Z,TH,Thailand,SEARO,0,35,0,0
20759,2020-02-20T00:00:00Z,TH,Thailand,SEARO,0,35,0,0
20760,2020-02-21T00:00:00Z,TH,Thailand,SEARO,0,35,0,0
20761,2020-02-22T00:00:00Z,TH,Thailand,SEARO,0,35,0,0
20762,2020-02-23T00:00:00Z,TH,Thailand,SEARO,0,35,0,0
20763,2020-02-24T00:00:00Z,TH,Thailand,SEARO,0,35,0,0
20764,2020-02-25T00:00:00Z,TH,Thailand,SEARO,2,37,0,0
20765,2020-02-26T00:00:00Z,TH,Thailand,SEARO,3,40,0,0
20766,2020-02-27T00:00:00Z,TH,Thailand,SEARO,0,40,0,0
20767,2020-02-28T00:00:00Z,TH,Thailand,SEARO,1,41,0,0
20768,2020-02-29T00:00:00Z,TH,Thailand,SEARO,1,42,0,0
20769,2020-03-01T00:00:00Z,TH,Thailand,SEARO,0,42,1,1
20770,2020-03-02T00:00:00Z,TH,Thailand,SEARO,1,43,0,1
20771,2020-03-03T00:00:00Z,TH,Thailand,SEARO,0,43,0,1
20772,2020-03-04T00:00:00Z,TH,Thailand,SEARO,0,43,0,1
20773,2020-03-05T00:00:00Z,TH,Thailand,SEARO,4,47,0,1
20774,2020-03-06T00:00:00Z,TH,Thailand,SEARO,1,48,0,1
20775,2020-03-07T00:00:00Z,TH,Thailand,SEARO,2,50,0,1
20776,2020-03-08T00:00:00Z,TH,Thailand,SEARO,0,50,0,1
20777,2020-03-09T00:00:00Z,TH,Thailand,SEARO,0,50,0,1
20778,2020-03-10T00:00:00Z,TH,Thailand,SEARO,3,53,0,1
20779,2020-03-11T00:00:00Z,TH,Thailand,SEARO,6,59,0,1
20780,2020-03-12T00:00:00Z,TH,Thailand,SEARO,11,70,0,1
20781,2020-03-13T00:00:00Z,TH,Thailand,SEARO,5,75,0,1
20782,2020-03-14T00:00:00Z,TH,Thailand,SEARO,0,75,0,1
20783,2020-03-15T00:00:00Z,TH,Thailand,SEARO,39,114,0,1
20784,2020-03-16T00:00:00Z,TH,Thailand,SEARO,33,147,0,1
20785,2020-03-17T00:00:00Z,TH,Thailand,SEARO,30,177,0,1
20786,2020-03-18T00:00:00Z,TH,Thailand,SEARO,35,212,0,1
20787,2020-03-19T00:00:00Z,TH,Thailand,SEARO,110,322,0,1
20788,2020-03-20T00:00:00Z,TH,Thailand,SEARO,0,322,0,1
20789,2020-03-21T00:00:00Z,TH,Thailand,SEARO,89,411,0,1
20790,2020-03-22T00:00:00Z,TH,Thailand,SEARO,188,599,0,1
20791,2020-03-23T00:00:00Z,TH,Thailand,SEARO,122,721,0,1
20792,2020-03-24T00:00:00Z,TH,Thailand,SEARO,106,827,3,4
20793,2020-03-25T00:00:00Z,TH,Thailand,SEARO,107,934,0,4
20794,2020-03-26T00:00:00Z,TH,Thailand,SEARO,111,1045,0,4
20795,2020-03-27T00:00:00Z,TH,Thailand,SEARO,91,1136,1,5
20796,2020-03-28T00:00:00Z,TH,Thailand,SEARO,0,1136,0,5
20797,2020-03-29T00:00:00Z,TH,Thailand,SEARO,252,1388,2,7
20798,2020-03-30T00:00:00Z,TH,Thailand,SEARO,136,1524,2,9
20799,2020-03-31T00:00:00Z,TH,Thailand,SEARO,127,1651,1,10
20800,2020-04-01T00:00:00Z,TH,Thailand,SEARO,120,1771,2,12
20801,2020-04-02T00:00:00Z,TH,Thailand,SEARO,104,1875,3,15
20802,2020-04-03T00:00:00Z,TH,Thailand,SEARO,103,1978,4,19
20803,2020-04-04T00:00:00Z,TH,Thailand,SEARO,89,2067,1,20
20804,2020-04-05T00:00:00Z,TH,Thailand,SEARO,102,2169,3,23
20805,2020-04-06T00:00:00Z,TH,Thailand,SEARO,51,2220,3,26
20806,2020-04-07T00:00:00Z,TH,Thailand,SEARO,38,2258,1,27
20807,2020-04-08T00:00:00Z,TH,Thailand,SEARO,111,2369,3,30
20808,2020-04-09T00:00:00Z,TH,Thailand,SEARO,54,2423,2,32
20809,2020-04-10T00:00:00Z,TH,Thailand,SEARO,50,2473,1,33
20810,2020-04-11T00:00:00Z,TH,Thailand,SEARO,45,2518,2,35
20811,2020-04-12T00:00:00Z,TH,Thailand,SEARO,33,2551,3,38
20812,2020-04-13T00:00:00Z,TH,Thailand,SEARO,28,2579,2,40
20813,2020-04-14T00:00:00Z,TH,Thailand,SEARO,34,2613,1,41
20814,2020-04-15T00:00:00Z,TH,Thailand,SEARO,30,2643,2,43
20815,2020-04-16T00:00:00Z,TH,Thailand,SEARO,29,2672,3,46
20816,2020-04-17T00:00:00Z,TH,Thailand,SEARO,28,2700,1,47
20817,2020-04-18T00:00:00Z,TH,Thailand,SEARO,33,2733,0,47
20818,2020-04-19T00:00:00Z,TH,Thailand,SEARO,32,2765,0,47
20819,2020-04-20T00:00:00Z,TH,Thailand,SEARO,27,2792,0,47
20820,2020-04-21T00:00:00Z,TH,Thailand,SEARO,19,2811,1,48
20821,2020-04-22T00:00:00Z,TH,Thailand,SEARO,15,2826,1,49
20822,2020-04-23T00:00:00Z,TH,Thailand,SEARO,13,2839,1,50
20823,2020-04-24T00:00:00Z,TH,Thailand,SEARO,15,2854,0,50
20824,2020-04-25T00:00:00Z,TH,Thailand,SEARO,53,2907,1,51
20825,2020-04-26T00:00:00Z,TH,Thailand,SEARO,15,2922,0,51
20826,2020-04-27T00:00:00Z,TH,Thailand,SEARO,9,2931,1,52
20827,2020-04-28T00:00:00Z,TH,Thailand,SEARO,7,2938,2,54
20828,2020-04-29T00:00:00Z,TH,Thailand,SEARO,9,2947,0,54
20829,2020-04-30T00:00:00Z,TH,Thailand,SEARO,7,2954,0,54
20830,2020-05-01T00:00:00Z,TH,Thailand,SEARO,6,2960,0,54
20831,2020-05-02T00:00:00Z,TH,Thailand,SEARO,6,2966,0,54
20832,2020-05-03T00:00:00Z,TH,Thailand,SEARO,3,2969,0,54
20833,2020-05-04T00:00:00Z,TH,Thailand,SEARO,18,2987,0,54
20834,2020-05-05T00:00:00Z,TH,Thailand,SEARO,1,2988,0,54
20835,2020-05-06T00:00:00Z,TH,Thailand,SEARO,1,2989,1,55
20836,2020-05-07T00:00:00Z,TH,Thailand,SEARO,3,2992,0,55
20837,2020-05-08T00:00:00Z,TH,Thailand,SEARO,8,3000,0,55
20838,2020-05-09T00:00:00Z,TH,Thailand,SEARO,4,3004,1,56
20839,2020-05-10T00:00:00Z,TH,Thailand,SEARO,5,3009,0,56
20840,2020-05-11T00:00:00Z,TH,Thailand,SEARO,6,3015,0,56
20841,2020-05-12T00:00:00Z,TH,Thailand,SEARO,2,3017,0,56
20842,2020-05-13T00:00:00Z,TH,Thailand,SEARO,0,3017,0,56
20843,2020-05-14T00:00:00Z,TH,Thailand,SEARO,1,3018,0,56
20844,2020-05-15T00:00:00Z,TH,Thailand,SEARO,7,3025,0,56
20845,2020-05-16T00:00:00Z,TH,Thailand,SEARO,0,3025,0,56
20846,2020-05-17T00:00:00Z,TH,Thailand,SEARO,3,3028,0,56
20847,2020-05-18T00:00:00Z,TH,Thailand,SEARO,3,3031,0,56
20848,2020-05-19T00:00:00Z,TH,Thailand,SEARO,2,3033,0,56
20849,2020-05-20T00:00:00Z,TH,Thailand,SEARO,1,3034,0,56
20850,2020-05-21T00:00:00Z,TH,Thailand,SEARO,3,3037,0,56
20851,2020-05-22T00:00:00Z,TH,Thailand,SEARO,0,3037,0,56
20852,2020-05-23T00:00:00Z,TH,Thailand,SEARO,3,3040,0,56
20853,2020-05-24T00:00:00Z,TH,Thailand,SEARO,0,3040,0,56
20854,2020-05-25T00:00:00Z,TH,Thailand,SEARO,2,3042,1,57
20855,2020-05-26T00:00:00Z,TH,Thailand,SEARO,3,3045,0,57
20856,2020-05-27T00:00:00Z,TH,Thailand,SEARO,9,3054,0,57
20857,2020-05-28T00:00:00Z,TH,Thailand,SEARO,11,3065,0,57
20858,2020-05-29T00:00:00Z,TH,Thailand,SEARO,11,3076,0,57
20859,2020-05-30T00:00:00Z,TH,Thailand,SEARO,1,3077,0,57
20860,2020-05-31T00:00:00Z,TH,Thailand,SEARO,4,3081,0,57
20861,2020-06-01T00:00:00Z,TH,Thailand,SEARO,1,3082,0,57
20862,2020-06-02T00:00:00Z,TH,Thailand,SEARO,1,3083,1,58
20863,2020-06-03T00:00:00Z,TH,Thailand,SEARO,1,3084,0,58
20864,2020-06-04T00:00:00Z,TH,Thailand,SEARO,17,3101,0,58
20865,2020-06-05T00:00:00Z,TH,Thailand,SEARO,1,3102,0,58
20866,2020-06-06T00:00:00Z,TH,Thailand,SEARO,2,3104,0,58
20867,2020-06-07T00:00:00Z,TH,Thailand,SEARO,8,3112,0,58
20868,2020-06-08T00:00:00Z,TH,Thailand,SEARO,7,3119,0,58
20869,2020-06-09T00:00:00Z,TH,Thailand,SEARO,2,3121,0,58
20870,2020-06-10T00:00:00Z,TH,Thailand,SEARO,4,3125,0,58
20871,2020-06-11T00:00:00Z,TH,Thailand,SEARO,0,3125,0,58
20872,2020-06-12T00:00:00Z,TH,Thailand,SEARO,4,3129,0,58
20873,2020-06-13T00:00:00Z,TH,Thailand,SEARO,5,3134,0,58
20874,2020-06-14T00:00:00Z,TH,Thailand,SEARO,1,3135,0,58
20875,2020-06-15T00:00:00Z,TH,Thailand,SEARO,0,3135,0,58
20876,2020-06-16T00:00:00Z,TH,Thailand,SEARO,0,3135,0,58
20877,2020-06-17T00:00:00Z,TH,Thailand,SEARO,0,3135,0,58
20878,2020-06-18T00:00:00Z,TH,Thailand,SEARO,6,3141,0,58
20879,2020-06-19T00:00:00Z,TH,Thailand,SEARO,5,3146,0,58
20880,2020-06-20T00:00:00Z,TH,Thailand,SEARO,1,3147,0,58
21023,2020-03-20T00:00:00Z,TL,Timor-Leste,SEARO,1,1,0,0
21024,2020-03-21T00:00:00Z,TL,Timor-Leste,SEARO,0,1,0,0
21025,2020-03-22T00:00:00Z,TL,Timor-Leste,SEARO,0,1,0,0
21026,2020-03-23T00:00:00Z,TL,Timor-Leste,SEARO,0,1,0,0
21027,2020-03-24T00:00:00Z,TL,Timor-Leste,SEARO,0,1,0,0
21028,2020-03-25T00:00:00Z,TL,Timor-Leste,SEARO,0,1,0,0
21029,2020-03-26T00:00:00Z,TL,Timor-Leste,SEARO,0,1,0,0
21030,2020-03-27T00:00:00Z,TL,Timor-Leste,SEARO,0,1,0,0
21031,2020-03-28T00:00:00Z,TL,Timor-Leste,SEARO,0,1,0,0
21032,2020-03-29T00:00:00Z,TL,Timor-Leste,SEARO,0,1,0,0
21033,2020-03-30T00:00:00Z,TL,Timor-Leste,SEARO,0,1,0,0
21034,2020-03-31T00:00:00Z,TL,Timor-Leste,SEARO,0,1,0,0
21035,2020-04-01T00:00:00Z,TL,Timor-Leste,SEARO,0,1,0,0
21036,2020-04-02T00:00:00Z,TL,Timor-Leste,SEARO,0,1,0,0
21037,2020-04-03T00:00:00Z,TL,Timor-Leste,SEARO,0,1,0,0
21038,2020-04-04T00:00:00Z,TL,Timor-Leste,SEARO,0,1,0,0
21039,2020-04-05T00:00:00Z,TL,Timor-Leste,SEARO,0,1,0,0
21040,2020-04-06T00:00:00Z,TL,Timor-Leste,SEARO,0,1,0,0
21041,2020-04-07T00:00:00Z,TL,Timor-Leste,SEARO,0,1,0,0
21042,2020-04-08T00:00:00Z,TL,Timor-Leste,SEARO,0,1,0,0
21043,2020-04-09T00:00:00Z,TL,Timor-Leste,SEARO,0,1,0,0
21044,2020-04-10T00:00:00Z,TL,Timor-Leste,SEARO,0,1,0,0
21045,2020-04-11T00:00:00Z,TL,Timor-Leste,SEARO,1,2,0,0
21046,2020-04-12T00:00:00Z,TL,Timor-Leste,SEARO,0,2,0,0
21047,2020-04-13T00:00:00Z,TL,Timor-Leste,SEARO,2,4,0,0
21048,2020-04-14T00:00:00Z,TL,Timor-Leste,SEARO,2,6,0,0
21049,2020-04-15T00:00:00Z,TL,Timor-Leste,SEARO,0,6,0,0
21050,2020-04-16T00:00:00Z,TL,Timor-Leste,SEARO,12,18,0,0
21051,2020-04-17T00:00:00Z,TL,Timor-Leste,SEARO,0,18,0,0
21052,2020-04-18T00:00:00Z,TL,Timor-Leste,SEARO,0,18,0,0
21053,2020-04-19T00:00:00Z,TL,Timor-Leste,SEARO,1,19,0,0
21054,2020-04-20T00:00:00Z,TL,Timor-Leste,SEARO,3,22,0,0
21055,2020-04-21T00:00:00Z,TL,Timor-Leste,SEARO,1,23,0,0
21056,2020-04-22T00:00:00Z,TL,Timor-Leste,SEARO,0,23,0,0
21057,2020-04-23T00:00:00Z,TL,Timor-Leste,SEARO,0,23,0,0
21058,2020-04-24T00:00:00Z,TL,Timor-Leste,SEARO,1,24,0,0
21059,2020-04-25T00:00:00Z,TL,Timor-Leste,SEARO,0,24,0,0
21060,2020-04-26T00:00:00Z,TL,Timor-Leste,SEARO,0,24,0,0
21061,2020-04-27T00:00:00Z,TL,Timor-Leste,SEARO,0,24,0,0
21062,2020-04-28T00:00:00Z,TL,Timor-Leste,SEARO,0,24,0,0
21063,2020-04-29T00:00:00Z,TL,Timor-Leste,SEARO,0,24,0,0
21064,2020-04-30T00:00:00Z,TL,Timor-Leste,SEARO,0,24,0,0
21065,2020-05-01T00:00:00Z,TL,Timor-Leste,SEARO,0,24,0,0
21066,2020-05-02T00:00:00Z,TL,Timor-Leste,SEARO,0,24,0,0
21067,2020-05-03T00:00:00Z,TL,Timor-Leste,SEARO,0,24,0,0
21068,2020-05-04T00:00:00Z,TL,Timor-Leste,SEARO,0,24,0,0
21069,2020-05-05T00:00:00Z,TL,Timor-Leste,SEARO,0,24,0,0
21070,2020-05-06T00:00:00Z,TL,Timor-Leste,SEARO,0,24,0,0
21071,2020-05-07T00:00:00Z,TL,Timor-Leste,SEARO,0,24,0,0
21072,2020-05-08T00:00:00Z,TL,Timor-Leste,SEARO,0,24,0,0
21073,2020-05-09T00:00:00Z,TL,Timor-Leste,SEARO,0,24,0,0
21074,2020-05-10T00:00:00Z,TL,Timor-Leste,SEARO,0,24,0,0
21075,2020-05-11T00:00:00Z,TL,Timor-Leste,SEARO,0,24,0,0
21076,2020-05-12T00:00:00Z,TL,Timor-Leste,SEARO,0,24,0,0
21077,2020-05-13T00:00:00Z,TL,Timor-Leste,SEARO,0,24,0,0
21078,2020-05-14T00:00:00Z,TL,Timor-Leste,SEARO,0,24,0,0
21079,2020-05-15T00:00:00Z,TL,Timor-Leste,SEARO,0,24,0,0
21080,2020-05-16T00:00:00Z,TL,Timor-Leste,SEARO,0,24,0,0
21081,2020-05-17T00:00:00Z,TL,Timor-Leste,SEARO,0,24,0,0
21082,2020-05-18T00:00:00Z,TL,Timor-Leste,SEARO,0,24,0,0
21083,2020-05-19T00:00:00Z,TL,Timor-Leste,SEARO,0,24,0,0
21084,2020-05-20T00:00:00Z,TL,Timor-Leste,SEARO,0,24,0,0
21085,2020-05-21T00:00:00Z,TL,Timor-Leste,SEARO,0,24,0,0
21086,2020-05-22T00:00:00Z,TL,Timor-Leste,SEARO,0,24,0,0
21087,2020-05-23T00:00:00Z,TL,Timor-Leste,SEARO,0,24,0,0
21088,2020-05-24T00:00:00Z,TL,Timor-Leste,SEARO,0,24,0,0
21089,2020-05-25T00:00:00Z,TL,Timor-Leste,SEARO,0,24,0,0
21090,2020-05-26T00:00:00Z,TL,Timor-Leste,SEARO,0,24,0,0
21091,2020-05-27T00:00:00Z,TL,Timor-Leste,SEARO,0,24,0,0
21092,2020-05-28T00:00:00Z,TL,Timor-Leste,SEARO,0,24,0,0
21093,2020-05-29T00:00:00Z,TL,Timor-Leste,SEARO,0,24,0,0
21094,2020-05-30T00:00:00Z,TL,Timor-Leste,SEARO,0,24,0,0
21095,2020-05-31T00:00:00Z,TL,Timor-Leste,SEARO,0,24,0,0
21096,2020-06-01T00:00:00Z,TL,Timor-Leste,SEARO,0,24,0,0
21097,2020-06-02T00:00:00Z,TL,Timor-Leste,SEARO,0,24,0,0
21098,2020-06-03T00:00:00Z,TL,Timor-Leste,SEARO,0,24,0,0
21099,2020-06-04T00:00:00Z,TL,Timor-Leste,SEARO,0,24,0,0
21100,2020-06-05T00:00:00Z,TL,Timor-Leste,SEARO,0,24,0,0
21101,2020-06-06T00:00:00Z,TL,Timor-Leste,SEARO,0,24,0,0
21102,2020-06-07T00:00:00Z,TL,Timor-Leste,SEARO,0,24,0,0
21103,2020-06-08T00:00:00Z,TL,Timor-Leste,SEARO,0,24,0,0
21104,2020-06-09T00:00:00Z,TL,Timor-Leste,SEARO,0,24,0,0
21105,2020-06-10T00:00:00Z,TL,Timor-Leste,SEARO,0,24,0,0
21106,2020-06-11T00:00:00Z,TL,Timor-Leste,SEARO,0,24,0,0
21107,2020-06-12T00:00:00Z,TL,Timor-Leste,SEARO,0,24,0,0
21108,2020-06-13T00:00:00Z,TL,Timor-Leste,SEARO,0,24,0,0
21109,2020-06-14T00:00:00Z,TL,Timor-Leste,SEARO,0,24,0,0
21110,2020-06-15T00:00:00Z,TL,Timor-Leste,SEARO,0,24,0,0
21111,2020-06-16T00:00:00Z,TL,Timor-Leste,SEARO,0,24,0,0
21112,2020-06-17T00:00:00Z,TL,Timor-Leste,SEARO,0,24,0,0
21113,2020-06-18T00:00:00Z,TL,Timor-Leste,SEARO,0,24,0,0
21114,2020-06-19T00:00:00Z,TL,Timor-Leste,SEARO,0,24,0,0
21115,2020-06-20T00:00:00Z,TL,Timor-Leste,SEARO,0,24,0,0
